name,ATPRank,games,wins,loses,players_odds,indoors_win,indoors_loss,outdoors_win,outdoors_loss,ratio_win,players_indoors_win_ratio,players_outdoors_win_ratio
 Hajek J.,79,2,1,1,2.915,0,0,1,1,0.5,,0.5
Abdulla M.,1349,1,0,1,,0,0,0,1,0.0,,0.0
Abel M.,411,1,0,1,,0,0,0,1,0.0,,0.0
Acasuso J.,256,271,141,130,2.3588582261029414,8,15,133,115,0.5202952029520295,0.34782608695652173,0.5362903225806451
Adaktusson J.,265,1,0,1,,0,0,0,1,0.0,,0.0
Agassi A.,39,118,85,33,1.7003970256024097,12,5,73,28,0.7203389830508474,0.7058823529411765,0.7227722772277227
Ager J.,295,1,0,1,,0,0,0,1,0.0,,0.0
Agostinelli B.,1171,1,0,1,,0,0,0,1,0.0,,0.0
Aguilar J.,191,6,1,5,,0,1,1,4,0.16666666666666666,0.0,0.2
Ahouda A.,727,4,1,3,16.166666666666668,0,0,1,3,0.25,,0.25
Al Ghareeb M.,514,7,1,6,,0,0,1,6,0.14285714285714285,,0.14285714285714285
Al Mutawa J.,0,2,0,2,,0,0,0,2,0.0,,0.0
Al-Ghareeb M.,431,1,0,1,,0,0,0,1,0.0,,0.0
Alawadhi O.,0,1,0,1,,0,0,0,1,0.0,,0.0
Albot R.,93,158,64,94,2.983949468085106,21,21,43,73,0.4050632911392405,0.5,0.3706896551724138
Alcaide G.,238,1,0,1,,0,0,0,1,0.0,,0.0
Alcaraz C.,406,2,1,1,3.08,0,0,1,1,0.5,,0.5
Aldi F.,238,8,1,7,5.675,0,1,1,6,0.125,0.0,0.14285714285714285
Ali Mutawa J.M.,0,2,0,2,,0,0,0,2,0.0,,0.0
Allegro Y.,0,4,1,3,,0,0,1,3,0.25,,0.25
Almagro N.,661,654,384,270,2.279300826519207,29,36,355,234,0.5871559633027523,0.4461538461538462,0.6027164685908319
Almagro N. ,27,1,0,1,,0,1,0,0,0.0,0.0,
Altamirano C.,345,2,0,2,,0,0,0,2,0.0,,0.0
Altmaier D.,124,12,5,7,3.0434285714285716,0,2,5,5,0.4166666666666667,0.0,0.5
Alund M.,131,17,7,10,5.695857142857143,3,1,4,9,0.4117647058823529,0.75,0.3076923076923077
Alves T.,138,29,7,22,4.595428571428571,0,0,7,22,0.2413793103448276,,0.2413793103448276
Amritraj P.,308,27,11,16,2.9333928571428567,0,2,11,14,0.4074074074074074,0.0,0.44
Ancic I.,68,3,2,1,2.875,0,0,2,1,0.6666666666666666,,0.6666666666666666
Ancic M.,422,272,174,98,2.168427785200738,52,31,122,67,0.6397058823529411,0.6265060240963856,0.6455026455026455
Andersen J.F.,190,3,1,2,,0,1,1,1,0.3333333333333333,0.0,0.5
Anderson A.,1564,1,0,1,,0,0,0,1,0.0,,0.0
Anderson K.,86,562,331,231,2.374030303030303,47,36,284,195,0.5889679715302492,0.5662650602409639,0.592901878914405
Anderson O.,813,1,0,1,,0,0,0,1,0.0,,0.0
Andreev A.,666,3,0,3,,0,3,0,0,0.0,0.0,
Andreev I.,416,423,214,209,2.157216102585663,23,32,191,177,0.5059101654846335,0.41818181818181815,0.5190217391304348
Andreev I. ,35,1,0,1,,0,1,0,0,0.0,0.0,
Andreozzi G.,113,36,11,25,3.1559,0,0,11,25,0.3055555555555556,,0.3055555555555556
Androic T.,363,2,0,2,,0,1,0,1,0.0,0.0,0.0
Andujar P.,57,349,143,206,3.2575472346272756,10,25,133,181,0.40974212034383956,0.2857142857142857,0.42356687898089174
Aragone J.,289,2,0,2,,0,0,0,2,0.0,,0.0
Aragone JC,265,1,0,1,,0,0,0,1,0.0,,0.0
Aranguren J.M.,257,2,0,2,,0,0,0,2,0.0,,0.0
Arazi H.,138,34,15,19,2.5354833333333335,1,4,14,15,0.4411764705882353,0.2,0.4827586206896552
Arevalo M.,220,2,0,2,,0,0,0,2,0.0,,0.0
Arguello F.,181,17,1,16,4.176666666666667,0,0,1,16,0.058823529411764705,,0.058823529411764705
Armando H.,205,24,9,15,3.4746428571428574,0,0,9,15,0.375,,0.375
Arnaboldi A.,219,13,4,9,3.8268055555555556,0,0,4,9,0.3076923076923077,,0.3076923076923077
Arthurs W.,195,88,39,49,2.5110034502587695,6,7,33,42,0.4431818181818182,0.46153846153846156,0.44
Artunedo Martinavarro A.,340,1,0,1,,0,1,0,0,0.0,0.0,
Arvidsson I.,507,1,0,1,,0,0,0,1,0.0,,0.0
Ascione T.,238,66,19,47,2.9863593350383626,2,12,17,35,0.2878787878787879,0.14285714285714285,0.3269230769230769
Auckland J.,414,3,2,1,5.5,2,1,0,0,0.6666666666666666,0.6666666666666666,
Auger-Aliassime F.,21,108,61,47,1.9225078479246598,16,12,45,35,0.5648148148148148,0.5714285714285714,0.5625
Authom M.,156,2,0,2,,0,0,0,2,0.0,,0.0
Avidzba A.,498,2,1,1,2.54,1,1,0,0,0.5,0.5,
Awadhy O.,0,2,0,2,,0,0,0,2,0.0,,0.0
Azzaro L.,295,3,0,3,,0,0,0,3,0.0,,0.0
Baccanello P.,310,5,1,4,3.385375,1,1,0,3,0.2,0.5,0.0
Bachinger M.,125,85,31,54,3.0619901960784315,14,16,17,38,0.36470588235294116,0.4666666666666667,0.3090909090909091
Baghdatis M.,135,596,324,272,2.300156133828996,81,54,243,218,0.5436241610738255,0.6,0.527114967462039
Bagnis F.,135,66,19,47,3.355425531914894,3,5,16,42,0.2878787878787879,0.375,0.27586206896551724
Bahrouzyan O.,808,4,0,4,,0,0,0,4,0.0,,0.0
Bai Y.,222,8,2,6,7.1416666666666675,0,0,2,6,0.25,,0.25
Baker B.,312,55,20,35,3.394171428571428,2,5,18,30,0.36363636363636365,0.2857142857142857,0.375
Baker J.,295,19,3,16,3.7651041666666667,0,0,3,16,0.15789473684210525,,0.15789473684210525
Balazs A.,88,28,16,12,3.3762499999999998,0,1,16,11,0.5714285714285714,0.0,0.5925925925925926
Baldi F.,149,3,0,3,,0,0,0,3,0.0,,0.0
Ball C.,158,20,8,12,3.9672916666666667,0,0,8,12,0.4,,0.4
Balleret B.,348,11,3,8,7.366071428571429,1,1,2,7,0.2727272727272727,0.5,0.2222222222222222
Baluda V.,466,1,0,1,,0,1,0,0,0.0,0.0,
Bangoura S.,313,1,0,1,,0,0,0,1,0.0,,0.0
Barrere G.,103,32,10,22,3.2763636363636364,5,9,5,13,0.3125,0.35714285714285715,0.2777777777777778
Barrientos N.,293,3,0,3,,0,0,0,3,0.0,,0.0
Barrios Vera M.T.,300,2,1,1,3.0,1,1,0,0,0.5,0.5,
Barton M.,198,8,4,4,5.3125,0,0,4,4,0.5,,0.5
Basic M.,99,47,21,26,3.3742692307692312,12,6,9,20,0.44680851063829785,0.6666666666666666,0.3103448275862069
Basilashvili N.,39,195,90,105,2.9679072276159655,18,21,72,84,0.46153846153846156,0.46153846153846156,0.46153846153846156
Basso A.,416,1,0,1,,0,0,0,1,0.0,,0.0
Bastl G.,227,37,12,25,3.3622916666666667,4,12,8,13,0.32432432432432434,0.25,0.38095238095238093
Bautista Agut R.,13,245,159,86,2.1580869404365517,21,17,138,69,0.6489795918367347,0.5526315789473685,0.6666666666666666
Bautista R.,18,223,134,89,2.7149262116384367,33,21,101,68,0.600896860986547,0.6111111111111112,0.5976331360946746
Bautista R. ,315,1,0,1,,0,1,0,0,0.0,0.0,
Beck A.,338,99,38,61,3.2543333333333333,5,8,33,53,0.3838383838383838,0.38461538461538464,0.38372093023255816
Beck A. ,33,1,0,1,,0,1,0,0,0.0,0.0,
Beck K.,143,134,50,84,3.1329942602040814,15,21,35,63,0.373134328358209,0.4166666666666667,0.35714285714285715
Becker B.,163,369,153,216,3.0785530816688045,46,50,107,166,0.4146341463414634,0.4791666666666667,0.39194139194139194
Becker B. ,43,1,0,1,,0,1,0,0,0.0,0.0,
Bedene A.,53,248,113,135,2.869628516708493,17,22,96,113,0.45564516129032256,0.4358974358974359,0.45933014354066987
Bega A.,351,1,0,1,,0,0,0,1,0.0,,0.0
Behrend T.,152,52,16,36,3.0011392045454546,2,3,14,33,0.3076923076923077,0.4,0.2978723404255319
Belic L.,766,3,0,3,,0,0,0,3,0.0,,0.0
Bellier A.,714,2,0,2,,0,0,0,2,0.0,,0.0
Bellotti R.,204,1,0,1,,0,0,0,1,0.0,,0.0
Bellucci T.,278,378,179,199,2.6814473385540802,22,24,157,175,0.47354497354497355,0.4782608695652174,0.47289156626506024
Belyaev I.,334,1,0,1,,0,1,0,0,0.0,0.0,
Bemelmans R.,171,72,23,49,3.5064809782608695,9,16,14,33,0.3194444444444444,0.36,0.2978723404255319
Benchetrit E.,217,6,1,5,2.9749999999999996,0,0,1,5,0.16666666666666666,,0.16666666666666666
Benneteau A.,75,1,0,1,,0,0,0,1,0.0,,0.0
Benneteau J.,60,545,265,280,2.7194898262178437,83,66,182,214,0.48623853211009177,0.5570469798657718,0.4595959595959596
Benneteau J. ,48,1,0,1,,0,1,0,0,0.0,0.0,
Berankis R.,66,200,84,116,3.0113425697865353,33,27,51,89,0.42,0.55,0.36428571428571427
Berdych T.,98,910,592,318,1.9906093542158336,113,71,479,247,0.6505494505494506,0.6141304347826086,0.6597796143250688
Berdych T. ,19,2,1,1,1.9900000000000002,1,1,0,0,0.5,0.5,
Bergs Z.,528,2,1,1,5.0,1,1,0,0,0.5,0.5,
Berlocq C.,177,312,127,185,3.166681993869119,12,18,115,167,0.40705128205128205,0.4,0.4078014184397163
Berrer M.,154,231,88,143,3.2357591240875916,33,36,55,107,0.38095238095238093,0.4782608695652174,0.3395061728395062
Berrettini M.,10,116,69,47,2.141793092815294,9,8,60,39,0.5948275862068966,0.5294117647058824,0.6060606060606061
Berrettini M. ,8,3,1,2,4.35,1,2,0,0,0.3333333333333333,0.3333333333333333,
Berta D.,0,2,0,2,,0,0,0,2,0.0,,0.0
Bester P.,225,5,0,5,,0,0,0,5,0.0,,0.0
Betov S.,514,1,0,1,,0,1,0,0,0.0,0.0,
Bhambri Y.,100,36,13,23,4.051571906354515,2,4,11,19,0.3611111111111111,0.3333333333333333,0.36666666666666664
Biryukov M.,310,2,0,2,,0,2,0,0,0.0,0.0,
Bjorkman J.,173,168,75,93,2.712570525365046,20,21,55,72,0.44642857142857145,0.4878048780487805,0.4330708661417323
Blake J.,100,439,269,170,2.0175511140819964,50,36,219,134,0.6127562642369021,0.5813953488372093,0.6203966005665722
Blake J. ,41,1,0,1,,0,1,0,0,0.0,0.0,
Blake T.,715,1,0,1,,0,0,0,1,0.0,,0.0
Blancaneaux G.,331,1,0,1,,0,0,0,1,0.0,,0.0
Blanch U.,244,1,0,1,,0,0,0,1,0.0,,0.0
Blanco G.,347,27,8,19,3.199803921568628,0,0,8,19,0.2962962962962963,,0.2962962962962963
Bloomfield R.,332,15,4,11,4.334848484848485,0,1,4,10,0.26666666666666666,0.0,0.2857142857142857
Boeker M.,246,4,1,3,,0,0,1,3,0.25,,0.25
Bogaerts R.,1149,1,0,1,,0,0,0,1,0.0,,0.0
Bogdanovic A.,403,30,8,22,3.069438311688312,1,1,7,21,0.26666666666666666,0.5,0.25
Bogomolov A.,85,152,61,91,3.1993653483992466,16,17,45,74,0.40131578947368424,0.48484848484848486,0.37815126050420167
Bohane A.,1416,1,0,1,,0,0,0,1,0.0,,0.0
Bohli S.,401,20,2,18,2.9703125000000004,1,8,1,10,0.1,0.1111111111111111,0.09090909090909091
Bohli S. ,148,1,0,1,,0,1,0,0,0.0,0.0,
Bolelli S.,187,268,113,155,3.4104321342374444,20,33,93,122,0.4216417910447761,0.37735849056603776,0.4325581395348837
Bolelli S. ,94,1,0,1,,0,1,0,0,0.0,0.0,
Bolt A.,137,24,7,17,3.4651960784313727,0,0,7,17,0.2916666666666667,,0.2916666666666667
Bonzi B.,180,7,3,4,5.170416666666666,1,1,2,3,0.42857142857142855,0.5,0.4
Bopanna R.,0,20,5,15,3.83125,1,4,4,11,0.25,0.2,0.26666666666666666
Borvanov R.,357,1,0,1,,0,1,0,0,0.0,0.0,
Bossel A.,282,2,0,2,,0,0,0,2,0.0,,0.0
Bourgeois L.,369,2,0,2,,0,0,0,2,0.0,,0.0
Bourgue M.,156,4,1,3,8.58,0,1,1,2,0.25,0.0,0.3333333333333333
Boutter J.,489,6,1,5,,0,0,1,5,0.16666666666666666,,0.16666666666666666
Bowles C.,1401,1,0,1,,0,0,0,1,0.0,,0.0
Bozoljac I.,244,25,8,17,3.17828431372549,2,4,6,13,0.32,0.3333333333333333,0.3157894736842105
Bracciali D.,139,80,31,49,3.1948988005996997,8,12,23,37,0.3875,0.4,0.38333333333333336
Braga P.,368,1,0,1,,0,0,0,1,0.0,,0.0
Brands D.,180,151,58,93,3.040438596491228,16,24,42,69,0.3841059602649007,0.4,0.3783783783783784
Britton D.,1461,3,0,3,,0,1,0,2,0.0,0.0,0.0
Brizzi A.,273,1,0,1,,0,0,0,1,0.0,,0.0
Broady L.,207,13,4,9,6.474375,2,1,2,8,0.3076923076923077,0.6666666666666666,0.2
Brooksby J.,394,3,1,2,7.125,0,0,1,2,0.3333333333333333,,0.3333333333333333
Brown D.,170,157,62,95,3.3435602716468598,11,14,51,81,0.39490445859872614,0.44,0.38636363636363635
Browne F.,181,3,1,2,,0,0,1,2,0.3333333333333333,,0.3333333333333333
Brugues-Davi A.,184,4,1,3,3.2833333333333337,1,1,0,2,0.25,0.5,0.0
Bryan B.,273,1,0,1,,0,1,0,0,0.0,0.0,
Brzezicki J.P.,196,23,6,17,2.9734999999999996,0,1,6,16,0.2608695652173913,0.0,0.2727272727272727
Bubka S.,146,17,5,12,4.6161666666666665,0,1,5,11,0.29411764705882354,0.0,0.3125
Bublik A.,49,70,31,39,3.1038296112489663,10,13,21,26,0.44285714285714284,0.43478260869565216,0.44680851063829785
Buchanan C.,172,2,0,2,,0,0,0,2,0.0,,0.0
Burgsmuller L.,263,66,18,48,3.0716453804347825,1,7,17,41,0.2727272727272727,0.125,0.29310344827586204
Burniol G.,505,2,0,2,,0,0,0,2,0.0,,0.0
Burquier G.,205,1,0,1,,0,1,0,0,0.0,0.0,
Cabal J.S.,0,2,0,2,,0,0,0,2,0.0,,0.0
Cachin P.,354,7,3,4,3.002083333333333,0,0,3,4,0.42857142857142855,,0.42857142857142855
Cacic N.,761,2,1,1,8.5,0,0,1,1,0.5,,0.5
Cadart R.,0,1,0,1,,0,1,0,0,0.0,0.0,
Cakl T.,283,12,3,9,3.925,2,4,1,5,0.25,0.3333333333333333,0.16666666666666666
Calatrava A.,188,39,12,27,3.064222222222222,1,2,11,25,0.3076923076923077,0.3333333333333333,0.3055555555555556
Calleri A.,148,228,116,112,2.1440294312169312,7,18,109,94,0.5087719298245614,0.28,0.5369458128078818
Canas G.,151,210,125,85,2.0569846864365586,15,16,110,69,0.5952380952380952,0.4838709677419355,0.6145251396648045
Capdeville P.,151,101,35,66,3.1536121323529414,3,7,32,59,0.3465346534653465,0.3,0.3516483516483517
Carballes Baena R.,103,114,52,62,3.1286333543505673,6,7,46,55,0.45614035087719296,0.46153846153846156,0.45544554455445546
Carlsen K.,304,110,46,64,2.7919409073579873,14,13,32,51,0.41818181818181815,0.5185185185185185,0.3855421686746988
Carraz G.,167,49,18,31,2.4203694581280786,5,8,13,23,0.3673469387755102,0.38461538461538464,0.3611111111111111
Carreno Busta P.,15,246,150,96,2.4032416666666667,24,17,126,79,0.6097560975609756,0.5853658536585366,0.6146341463414634
Carreno-Busta P.,53,108,42,66,2.9674350649350654,8,11,34,55,0.3888888888888889,0.42105263157894735,0.38202247191011235
Caruana L.,397,1,0,1,,0,0,0,1,0.0,,0.0
Caruso S.,82,38,14,24,4.033422619047619,5,7,9,17,0.3684210526315789,0.4166666666666667,0.34615384615384615
Catarina L.,554,2,0,2,,0,0,0,2,0.0,,0.0
Cecchinato M.,79,132,48,84,2.837247023809524,1,10,47,74,0.36363636363636365,0.09090909090909091,0.3884297520661157
Celikbilek A.,443,2,1,1,5.5,0,0,1,1,0.5,,0.5
Cermak F.,830,11,4,7,3.7941428571428575,0,2,4,5,0.36363636363636365,0.0,0.4444444444444444
Cerundolo F.,239,2,0,2,,0,0,0,2,0.0,,0.0
Cervantes I.,125,49,17,32,3.4191084558823532,4,4,13,28,0.3469387755102041,0.5,0.3170731707317073
Cervenak P.,204,9,5,4,4.22775,0,1,5,3,0.5555555555555556,0.0,0.625
Chadaj A.,230,2,1,1,4.375,0,0,1,1,0.5,,0.5
Chaen T.,625,1,0,1,,0,0,0,1,0.0,,0.0
Chaki R.,482,2,0,2,,0,0,0,2,0.0,,0.0
Chardy J.,65,552,271,281,2.6714726331958936,39,46,232,235,0.49094202898550726,0.4588235294117647,0.49678800856531047
Chardy J. ,31,2,1,1,2.015,1,1,0,0,0.5,0.5,
Chekov P.,17,1,0,1,,0,1,0,0,0.0,0.0,
Chela J.,38,5,3,2,1.6048333333333331,0,0,3,2,0.6,,0.6
Chela J.I.,83,385,201,184,2.3007899553634092,9,22,192,162,0.522077922077922,0.2903225806451613,0.5423728813559322
Chen T.,321,3,0,3,,0,2,0,1,0.0,0.0,0.0
Childs L.,408,3,0,3,,0,0,0,3,0.0,,0.0
Chiudinelli M.,366,124,41,83,3.365853597601599,5,24,36,59,0.33064516129032256,0.1724137931034483,0.37894736842105264
Chiudinelli M. ,73,4,3,1,8.546666666666667,3,1,0,0,0.75,0.75,
Choinski J.,429,1,0,1,,0,0,0,1,0.0,,0.0
Chrysochos P.,1360,1,0,1,,0,0,0,1,0.0,,0.0
Chung H.,139,138,71,67,2.7181269707799034,7,10,64,57,0.5144927536231884,0.4117647058823529,0.5289256198347108
Chvojka E.,233,2,0,2,,0,0,0,2,0.0,,0.0
Cilic M.,41,749,479,270,2.0386001204668482,103,58,376,212,0.6395193591455274,0.639751552795031,0.6394557823129252
Cilic M. ,13,3,2,1,1.3875000000000002,2,1,0,0,0.6666666666666666,0.6666666666666666,
Ciorcila P.,589,1,0,1,,0,0,0,1,0.0,,0.0
Cipolla F.,147,101,35,66,3.5959393939393935,7,8,28,58,0.3465346534653465,0.4666666666666667,0.32558139534883723
Clarke J.,169,8,2,6,7.195,0,0,2,6,0.25,,0.25
Clayton A.,1281,1,0,1,,0,0,0,1,0.0,,0.0
Clemens T.,207,4,2,2,4.7575,2,2,0,0,0.5,0.5,
Clement A.,139,289,128,161,2.629635777559055,40,49,88,112,0.4429065743944637,0.449438202247191,0.44
Clezar G.,225,12,1,11,2.876818181818182,1,6,0,5,0.08333333333333333,0.14285714285714285,0.0
Condor F.,374,1,0,1,,0,0,0,1,0.0,,0.0
Cook L.,1445,1,0,1,,0,0,0,1,0.0,,0.0
Copil M.,82,127,47,80,3.0927593085106384,19,18,28,62,0.3700787401574803,0.5135135135135135,0.3111111111111111
Coppejans K.,172,8,0,8,,0,3,0,5,0.0,0.0,0.0
Coria F.,93,17,7,10,3.4850000000000003,0,3,7,7,0.4117647058823529,0.0,0.5
Coria G.,564,160,99,61,1.930382456140351,4,9,95,52,0.61875,0.3076923076923077,0.6462585034013606
Coric B.,24,278,149,129,2.420389157692108,21,24,128,105,0.5359712230215827,0.4666666666666667,0.5493562231759657
Corretja A.,153,37,13,24,2.45438127090301,4,5,9,19,0.35135135135135137,0.4444444444444444,0.32142857142857145
Corrie E.,330,1,0,1,,0,0,0,1,0.0,,0.0
Costa A.,249,75,34,41,2.1792079326923077,3,6,31,35,0.4533333333333333,0.3333333333333333,0.4696969696969697
Couacaud E.,214,1,0,1,,0,1,0,0,0.0,0.0,
Cox D.,214,5,0,5,,0,0,0,5,0.0,,0.0
Crabb J.,409,1,0,1,,0,1,0,0,0.0,0.0,
Cressy M.,168,2,1,1,12.285,0,0,1,1,0.5,,0.5
Crivoi V.,206,41,12,29,3.044545454545455,2,5,10,24,0.2926829268292683,0.2857142857142857,0.29411764705882354
Cruciat A.,183,3,1,2,2.6125,0,0,1,2,0.3333333333333333,,0.3333333333333333
Crugnola M.,237,3,0,3,,0,0,0,3,0.0,,0.0
Cuadrado C.,225,5,3,2,3.1875,0,0,3,2,0.6,,0.6
Cuevas P.,63,392,198,194,2.347382179675994,34,25,164,169,0.5051020408163265,0.576271186440678,0.4924924924924925
Cuevas P. ,50,2,1,1,3.625,1,1,0,0,0.5,0.5,
Dabul B.,164,42,15,27,3.5455185185185187,2,2,13,25,0.35714285714285715,0.5,0.34210526315789475
Dailey Z.,868,1,0,1,,0,1,0,0,0.0,0.0,
Dancevic F.,422,137,52,85,2.7350657239819007,7,12,45,73,0.3795620437956204,0.3684210526315789,0.3813559322033898
Daniel M.,147,78,19,59,3.9075589836660614,0,5,19,54,0.24358974358974358,0.0,0.2602739726027397
Daniel T.,115,113,41,72,3.075441429062178,2,9,39,63,0.36283185840707965,0.18181818181818182,0.38235294117647056
Darcis S.,179,214,92,122,3.292840355805244,22,23,70,99,0.42990654205607476,0.4888888888888889,0.41420118343195267
Dasnieres de Veigy J.,158,6,1,5,3.06,0,1,1,4,0.16666666666666666,0.0,0.2
Davidovich Fokina A.,63,33,16,17,2.6915625,8,4,8,13,0.48484848484848486,0.6666666666666666,0.38095238095238093
Davletshin V.,620,1,0,1,,0,1,0,0,0.0,0.0,
Davydenko N.,92,670,415,255,2.083673202614379,97,63,318,192,0.6194029850746269,0.60625,0.6235294117647059
Davydenko N. ,7,4,3,1,1.26,3,1,0,0,0.75,0.75,
Davydenko P.,658,3,1,2,6.375,0,1,1,1,0.3333333333333333,0.0,0.5
De Bakker T.,224,134,54,80,3.354891509433962,6,15,48,65,0.40298507462686567,0.2857142857142857,0.4247787610619469
De Chaunac S.,144,10,5,5,3.5629999999999997,0,1,5,4,0.5,0.0,0.5555555555555556
De Greef A.,115,8,3,5,4.028333333333333,0,0,3,5,0.375,,0.375
De Heart R.,241,3,1,2,10.86,0,0,1,2,0.3333333333333333,,0.3333333333333333
De Loore J.,351,2,0,2,,0,1,0,1,0.0,0.0,0.0
De Minaur A.,25,123,72,51,2.3209582988124824,13,7,59,44,0.5853658536585366,0.65,0.5728155339805825
De Paula F.,458,1,0,1,,0,0,0,1,0.0,,0.0
De Schepper K.,186,88,27,61,3.1835740740740746,10,21,17,40,0.3068181818181818,0.3225806451612903,0.2982456140350877
De Voest R.,338,28,7,21,2.9865,2,5,5,16,0.25,0.2857142857142857,0.23809523809523808
Decoud S.,215,8,4,4,5.29125,0,0,4,4,0.5,,0.5
Deen Heshaam A.,1557,1,0,1,,0,1,0,0,0.0,0.0,
Deheart R.,270,2,0,2,,0,2,0,0,0.0,0.0,
Del Bonis F.,10,13,6,7,2.945952380952381,0,1,6,6,0.46153846153846156,0.0,0.5
Del Potro J.,75,3,2,1,1.7675,0,0,2,1,0.6666666666666666,,0.6666666666666666
Del Potro J. M.,30,3,2,1,2.3125,0,0,2,1,0.6666666666666666,,0.6666666666666666
Del Potro J.M.,12,580,411,169,1.9850548375829549,90,38,321,131,0.7086206896551724,0.703125,0.7101769911504425
Delbonis F.,78,261,119,142,2.6188975914309385,16,18,103,124,0.4559386973180077,0.47058823529411764,0.45374449339207046
Delgado J.,447,9,3,6,3.5389166666666667,0,0,3,6,0.3333333333333333,,0.3333333333333333
Delgado R.,143,26,9,17,3.4495089285714284,2,2,7,15,0.34615384615384615,0.5,0.3181818181818182
Delic A.,178,72,24,48,3.122891304347826,1,6,23,42,0.3333333333333333,0.14285714285714285,0.35384615384615387
Delic M.,326,10,2,8,3.923125,0,2,2,6,0.2,0.0,0.25
Dell'Acqua M.,472,5,1,4,3.785,0,0,1,4,0.2,,0.2
Dellien H.,104,35,12,23,4.144204545454546,4,4,8,19,0.34285714285714286,0.5,0.2962962962962963
Demoliner M.,1184,2,1,1,5.0,0,0,1,1,0.5,,0.5
Dent T.,92,172,86,86,2.3956011904761905,15,22,71,64,0.5,0.40540540540540543,0.5259259259259259
Desein N.,170,3,0,3,,0,0,0,3,0.0,,0.0
Dev Varman S.,1035,3,0,3,,0,1,0,2,0.0,0.0,0.0
Devilder N.,286,70,23,47,3.72508398656215,2,6,21,41,0.32857142857142857,0.25,0.3387096774193548
Devvarman S.,177,115,48,67,3.815975378787879,4,8,44,59,0.41739130434782606,0.3333333333333333,0.42718446601941745
Di Mauro A.,257,2,1,1,5.6,0,0,1,1,0.5,,0.5
Diaz Acosta F.,471,1,0,1,,0,0,0,1,0.0,,0.0
Diez S.,181,9,2,7,3.5464285714285717,0,0,2,7,0.2222222222222222,,0.2222222222222222
Dimitrov G.,20,522,314,208,2.2291746794871794,68,42,246,166,0.6015325670498084,0.6181818181818182,0.5970873786407767
Djere L.,54,106,52,54,2.647286324786325,4,11,48,43,0.49056603773584906,0.26666666666666666,0.5274725274725275
Djokovic M.,878,4,0,4,,0,1,0,3,0.0,0.0,0.0
Djokovic N.,1,1070,891,179,1.6894710748502237,120,40,771,139,0.8327102803738318,0.75,0.8472527472527472
Djokovic N. ,2,8,6,2,1.3808333333333334,6,2,0,0,0.75,0.75,
Dlouhy L.,180,67,20,47,3.5684217171717174,4,9,16,38,0.29850746268656714,0.3076923076923077,0.2962962962962963
Do M.Q.,1422,1,0,1,,0,1,0,0,0.0,0.0,
Dodig I.,412,245,115,130,2.9733427704752278,33,30,82,100,0.46938775510204084,0.5238095238095238,0.45054945054945056
Dolgopolov A.,89,3,0,3,,0,0,0,3,0.0,,0.0
Dolgopolov O.,54,412,215,197,2.3744098391764314,19,29,196,168,0.5218446601941747,0.3958333333333333,0.5384615384615384
Domingues J.,169,11,5,6,3.617,1,1,4,5,0.45454545454545453,0.5,0.4444444444444444
Donaldson J.,192,110,48,62,2.8177755376344082,1,6,47,56,0.43636363636363634,0.14285714285714285,0.4563106796116505
Donati M.,282,2,1,1,12.5,0,0,1,1,0.5,,0.5
Donski A.,1529,1,0,1,,0,1,0,0,0.0,0.0,
Donskoy E.,121,155,49,106,3.0514033018867925,14,31,35,75,0.3161290322580645,0.3111111111111111,0.3181818181818182
Dorsch B.,236,3,0,3,,0,1,0,2,0.0,0.0,0.0
Draper S.,787,4,0,4,,0,0,0,4,0.0,,0.0
Dubrivnyy A.,424,1,0,1,,0,1,0,0,0.0,0.0,
Duckworth J.,97,79,25,54,3.7239814814814816,0,3,25,51,0.31645569620253167,0.0,0.32894736842105265
Duclos P.L.,244,4,1,3,,0,0,1,3,0.25,,0.25
Dupuis A.,221,69,30,39,2.4469219924812027,10,8,20,31,0.43478260869565216,0.5555555555555556,0.39215686274509803
Dustov F.,108,7,0,7,,0,0,0,7,0.0,,0.0
Dutra Da Silva R.,114,2,1,1,,0,0,1,1,0.5,,0.5
Dutra Silva R.,138,80,22,58,4.560757575757576,5,5,17,53,0.275,0.5,0.24285714285714285
Dzumhur D.,115,216,100,116,3.4158891304347825,29,26,71,90,0.46296296296296297,0.5272727272727272,0.4409937888198758
Eaton C.,661,2,1,1,3.7199999999999998,0,0,1,1,0.5,,0.5
Ebden M.,116,191,69,122,3.107838768115942,8,16,61,106,0.3612565445026178,0.3333333333333333,0.3652694610778443
Ebelthite C.,254,1,0,1,,0,0,0,1,0.0,,0.0
Echagaray B.,358,4,0,4,,0,0,0,4,0.0,,0.0
Economidis K.,142,10,1,9,3.5375,0,2,1,7,0.1,0.0,0.125
Edmund K.,47,221,111,110,2.4417620802620807,19,10,92,100,0.502262443438914,0.6551724137931034,0.4791666666666667
Ehrat S.,386,2,0,2,,0,0,0,2,0.0,,0.0
Eitzinger R.,263,9,3,6,4.062,1,2,2,4,0.3333333333333333,0.3333333333333333,0.3333333333333333
El Aarej M.,589,2,0,2,,0,0,0,2,0.0,,0.0
El Amrani R.,667,9,3,6,6.256666666666666,0,0,3,6,0.3333333333333333,,0.3333333333333333
El Aynaoui Y.,0,32,10,22,3.8730277777777777,0,1,10,21,0.3125,0.0,0.3225806451612903
Eleskovic E.,483,10,2,8,4.569642857142857,0,4,2,4,0.2,0.0,0.3333333333333333
Elgin M.,949,10,3,7,5.3741666666666665,3,7,0,0,0.3,0.3,
Elias G.,127,67,23,44,3.205849342770475,5,7,18,37,0.34328358208955223,0.4166666666666667,0.32727272727272727
Elseneer G.,181,22,6,16,2.6276833333333336,0,1,6,15,0.2727272727272727,0.0,0.2857142857142857
Elsner D.,339,11,3,8,2.713357142857143,0,0,3,8,0.2727272727272727,,0.2727272727272727
Emmrich M.,994,1,0,1,,0,0,0,1,0.0,,0.0
Enqvist T.,157,50,19,31,2.204254668930391,6,10,13,21,0.38,0.375,0.38235294117647056
Eriksson M.,536,4,0,4,,0,1,0,3,0.0,0.0,0.0
Eschauer W.,218,35,9,26,3.5226250000000006,0,4,9,22,0.2571428571428571,0.0,0.2903225806451613
Escobar G.,364,2,0,2,,0,0,0,2,0.0,,0.0
Escobedo E.,185,44,15,29,2.613817733990148,2,2,13,27,0.3409090909090909,0.5,0.325
Escude N.,67,23,15,8,2.3322857142857143,1,2,14,6,0.6521739130434783,0.3333333333333333,0.7
Estrella Burgos V.,198,109,45,64,3.6988715277777775,0,4,45,60,0.41284403669724773,0.0,0.42857142857142855
Estrella V.,243,1,0,1,,0,0,0,1,0.0,,0.0
Eubanks C.,221,17,4,13,3.7804807692307696,1,1,3,12,0.23529411764705882,0.5,0.2
Evans B.,318,21,6,15,3.48,1,1,5,14,0.2857142857142857,0.5,0.2631578947368421
Evans D.,31,126,62,64,2.973202764976959,12,10,50,54,0.49206349206349204,0.5454545454545454,0.4807692307692308
Eysseric J.,290,4,0,4,,0,0,0,4,0.0,,0.0
Fabbiano T.,134,85,27,58,3.4384018567639254,2,10,25,48,0.3176470588235294,0.16666666666666666,0.3424657534246575
Falla A.,310,253,96,157,3.213841039279869,11,22,85,135,0.3794466403162055,0.3333333333333333,0.38636363636363635
Falla A. ,98,1,0,1,,0,1,0,0,0.0,0.0,
Farah R.,210,9,3,6,7.066333333333334,0,1,3,5,0.3333333333333333,0.0,0.375
Faurel J.C.,148,9,2,7,3.5816666666666666,1,1,1,6,0.2222222222222222,0.5,0.14285714285714285
Federer R.,3,1129,972,157,1.427204742936299,167,29,805,128,0.8609388839681134,0.8520408163265306,0.8628081457663451
Federer R. ,3,9,6,3,1.3475,6,3,0,0,0.6666666666666666,0.6666666666666666,
Ferreira W.,107,27,12,15,2.098933333333333,1,2,11,13,0.4444444444444444,0.3333333333333333,0.4583333333333333
Ferreiro F.,185,5,2,3,4.1,0,0,2,3,0.4,,0.4
Ferrer D.,144,1003,669,334,2.149093961545801,89,62,580,272,0.6669990029910269,0.5894039735099338,0.6807511737089202
Ferrer D. ,18,2,1,1,1.345,1,1,0,0,0.5,0.5,
Ferrero J.,3,2,0,2,,0,0,0,2,0.0,,0.0
Ferrero J.C.,161,393,237,156,2.134764876090267,23,26,214,130,0.6030534351145038,0.46938775510204084,0.622093023255814
Ferrero J.C. ,22,1,0,1,,0,1,0,0,0.0,0.0,
Ficovich J.P.,244,1,0,1,,0,0,0,1,0.0,,0.0
Fidirko N.,934,1,0,1,,0,1,0,0,0.0,0.0,
Fischer M.,335,21,2,19,2.5163157894736843,0,5,2,14,0.09523809523809523,0.0,0.125
Fish A.,56,1,0,1,,0,1,0,0,0.0,0.0,
Fish M.,581,397,233,164,2.266483528941051,37,32,196,132,0.5869017632241813,0.5362318840579711,0.5975609756097561
Fitz S.,326,1,0,1,,0,0,0,1,0.0,,0.0
Flanagan I.,866,3,2,1,,0,0,2,1,0.6666666666666666,,0.6666666666666666
Fleishman Z.,437,18,5,13,3.9625454545454546,0,2,5,11,0.2777777777777778,0.0,0.3125
Fleming C.,110,2,0,2,,0,0,0,2,0.0,,0.0
Fognini F.,15,643,340,303,2.7687043967240097,37,41,303,262,0.5287713841368584,0.47435897435897434,0.536283185840708
Fogues F.,333,3,1,2,,0,0,1,2,0.3333333333333333,,0.3333333333333333
Forejtek J.,399,2,1,1,4.875,1,1,0,0,0.5,0.5,
Fornell M.,284,1,0,1,,0,0,0,1,0.0,,0.0
Fraile G.,930,7,0,7,,0,1,0,6,0.0,0.0,0.0
Fratangelo B.,117,53,19,34,3.3638390092879256,0,1,19,33,0.3584905660377358,0.0,0.36538461538461536
Friedl L.,0,3,2,1,4.0075,0,0,2,1,0.6666666666666666,,0.6666666666666666
Fritz T.,29,188,93,95,2.2784838709677424,11,13,82,82,0.4946808510638298,0.4583333333333333,0.5
Fruttero J.P.,205,1,0,1,,0,1,0,0,0.0,0.0,
Fucsovics M.,55,139,66,73,2.5930429292929293,15,15,51,58,0.4748201438848921,0.5,0.46788990825688076
Fyrstenberg M.,836,2,0,2,,0,0,0,2,0.0,,0.0
Gabashvili T.,229,304,109,195,3.2672439713449704,26,48,83,147,0.35855263157894735,0.35135135135135137,0.36086956521739133
Gaio F.,132,12,2,10,3.7263888888888888,0,1,2,9,0.16666666666666666,0.0,0.18181818181818182
Galan D.,153,3,2,1,18.23,0,0,2,1,0.6666666666666666,,0.6666666666666666
Galan D.E.,146,10,4,6,3.09375,0,0,4,6,0.4,,0.4
Galdon P.,305,1,0,1,,0,0,0,1,0.0,,0.0
Galimberti G.,189,5,1,4,2.835,0,2,1,2,0.2,0.0,0.3333333333333333
Gallardo M.,225,2,0,2,,0,0,0,2,0.0,,0.0
Gallardo Valles M.,346,1,0,1,,0,0,0,1,0.0,,0.0
Galovic V.,197,7,2,5,3.915,0,0,2,5,0.2857142857142857,,0.2857142857142857
Galvani S.,321,27,8,19,3.460764705882353,1,2,7,17,0.2962962962962963,0.3333333333333333,0.2916666666666667
Gambill J.M.,671,61,24,37,2.3445193498452013,7,6,17,31,0.39344262295081966,0.5384615384615384,0.3541666666666667
Gamonal H.,187,1,0,1,,0,0,0,1,0.0,,0.0
Gao X.,944,1,0,1,,0,0,0,1,0.0,,0.0
Garanganga T.,451,1,0,1,,0,0,0,1,0.0,,0.0
Garcia A.,213,28,7,21,3.2458125,1,3,6,18,0.25,0.25,0.25
Garcia-Lopez G.,165,648,297,351,2.7853716625378473,42,61,255,290,0.4583333333333333,0.4077669902912621,0.46788990825688076
Garcia-Lopez G. ,47,3,2,1,4.0,2,1,0,0,0.6666666666666666,0.6666666666666666,
Gard C.,250,1,0,1,,0,0,0,1,0.0,,0.0
Garin C.,22,86,49,37,2.4810921125206837,9,6,40,31,0.5697674418604651,0.6,0.5633802816901409
Garza D.,480,4,0,4,,0,0,0,4,0.0,,0.0
Gasquet R.,49,842,530,312,2.1100949441126935,124,71,406,241,0.6294536817102138,0.6358974358974359,0.6275115919629057
Gasquet R. ,57,3,2,1,1.53,2,1,0,0,0.6666666666666666,0.6666666666666666,
Gaston H.,161,7,3,4,6.513333333333334,0,2,3,2,0.42857142857142855,0.0,0.6
Gaudio G.,174,208,122,86,2.002777077304671,6,10,116,76,0.5865384615384616,0.375,0.6041666666666666
Gensse A.,155,4,1,3,,0,0,1,3,0.25,,0.25
Gerasimov E.,81,43,24,19,3.546180555555556,12,9,12,10,0.5581395348837209,0.5714285714285714,0.5454545454545454
Ghedin R.,319,3,0,3,,0,1,0,2,0.0,0.0,0.0
Ghem A.,221,7,2,5,3.515,0,0,2,5,0.2857142857142857,,0.2857142857142857
Giannessi A.,168,30,11,19,3.3094258373205743,1,4,10,15,0.36666666666666664,0.2,0.4
Gicquel M.,127,203,91,112,2.8130264797507785,29,28,62,84,0.4482758620689655,0.5087719298245614,0.4246575342465753
Gigounon G.,209,1,0,1,,0,0,0,1,0.0,,0.0
Gil F.,114,115,49,66,3.59930352393617,2,3,47,63,0.4260869565217391,0.4,0.42727272727272725
Gimelstob J.,549,70,24,46,3.1783569444444444,2,6,22,40,0.34285714285714286,0.25,0.3548387096774194
Gimeno D.,269,1,0,1,,0,0,0,1,0.0,,0.0
Gimeno-Traver D.,230,262,95,167,3.2885992179863153,7,15,88,152,0.36259541984732824,0.3181818181818182,0.36666666666666664
Gimeno-Traver D. ,77,1,0,1,,0,1,0,0,0.0,0.0,
Ginepri R.,204,303,145,158,2.43663834304558,35,35,110,123,0.47854785478547857,0.5,0.4721030042918455
Giraldo S.,232,326,141,185,2.8265544496487123,12,23,129,162,0.4325153374233129,0.34285714285714286,0.44329896907216493
Giron M.,91,28,12,16,3.552291666666667,5,4,7,12,0.42857142857142855,0.5555555555555556,0.3684210526315789
Giustino L.,157,6,1,5,4.775,0,0,1,5,0.16666666666666666,,0.16666666666666666
Goffin D.,14,426,251,175,2.4576481502561185,53,42,198,133,0.5892018779342723,0.5578947368421052,0.5981873111782477
Gojo B.,497,1,0,1,,0,0,0,1,0.0,,0.0
Gojowczyk P.,127,132,58,74,3.058716216216216,11,13,47,61,0.4393939393939394,0.4583333333333333,0.4351851851851852
Golding O.,491,3,0,3,,0,0,0,3,0.0,,0.0
Goldstein P.,97,94,42,52,2.9075320512820513,3,9,39,43,0.44680851063829785,0.25,0.47560975609756095
Golmard J.,252,9,4,5,2.411,0,0,4,5,0.4444444444444444,,0.4444444444444444
Golubev A.,154,158,51,107,3.346116914055342,17,23,34,84,0.3227848101265823,0.425,0.288135593220339
Gombos N.,105,38,12,26,3.33,6,12,6,14,0.3157894736842105,0.3333333333333333,0.3
Gomez A.,698,2,1,1,7.5,0,0,1,1,0.5,,0.5
Gomez E.,151,7,1,6,3.1875,0,1,1,5,0.14285714285714285,0.0,0.16666666666666666
Gomez L.,492,6,0,6,,0,0,0,6,0.0,,0.0
Gomez-Herrera C.,671,1,0,1,,0,0,0,1,0.0,,0.0
Gong M.X.,718,4,0,4,,0,0,0,4,0.0,,0.0
Gonzalez A.,163,46,12,34,3.7174754901960787,0,1,12,33,0.2608695652173913,0.0,0.26666666666666666
Gonzalez F.,221,374,245,129,2.1302951460040984,36,24,209,105,0.6550802139037433,0.6,0.6656050955414012
Gonzalez F. ,11,1,0,1,,0,1,0,0,0.0,0.0,
Gonzalez M.,163,86,28,58,3.4074014778325123,0,4,28,54,0.32558139534883723,0.0,0.34146341463414637
Gonzalez S.,0,9,1,8,4.95375,0,0,1,8,0.1111111111111111,,0.1111111111111111
Goodall J.,215,12,1,11,2.7760000000000002,0,0,1,11,0.08333333333333333,,0.08333333333333333
Goransson T.,800,2,0,2,,0,0,0,2,0.0,,0.0
Granollers G.,280,1,0,1,,0,0,0,1,0.0,,0.0
Granollers M.,100,445,201,244,3.1257637860082306,27,39,174,205,0.451685393258427,0.4090909090909091,0.45910290237467016
Granollers M. ,82,1,0,1,,0,1,0,0,0.0,0.0,
Granollers Pujol G.,331,1,0,1,,0,0,0,1,0.0,,0.0
Granollers-Pujol G.,265,2,0,2,,0,0,0,2,0.0,,0.0
Granollers-Pujol M.,291,1,0,1,,0,0,0,1,0.0,,0.0
Gray A.,0,1,0,1,,0,0,0,1,0.0,,0.0
Gregorc L.,195,13,6,7,5.029999999999999,0,0,6,7,0.46153846153846156,,0.46153846153846156
Gremelmayr D.,189,86,32,54,3.7177078965758215,4,9,28,45,0.37209302325581395,0.3076923076923077,0.3835616438356164
Greul S.,125,114,43,71,3.080455005055611,6,10,37,61,0.37719298245614036,0.375,0.37755102040816324
Greul S. ,56,1,0,1,,0,1,0,0,0.0,0.0,
Griekspoor T.,172,8,2,6,6.583333333333334,2,4,0,2,0.25,0.3333333333333333,0.0
Grigelis L.,243,1,0,1,,0,0,0,1,0.0,,0.0
Gromley C.,0,1,0,1,,0,0,0,1,0.0,,0.0
Grosjean S.,559,204,108,96,1.998986340408805,22,19,86,77,0.5294117647058824,0.5365853658536586,0.5276073619631901
Groth S.,201,93,36,57,3.299422514619882,2,5,34,52,0.3870967741935484,0.2857142857142857,0.3953488372093023
Gruber K.,633,1,0,1,,0,1,0,0,0.0,0.0,
Guccione A.,92,3,1,2,2.0625,0,0,1,2,0.3333333333333333,,0.3333333333333333
Guccione C.,613,85,32,53,2.7976395781637717,4,7,28,46,0.3764705882352941,0.36363636363636365,0.3783783783783784
Guez D.,193,18,2,16,4.336500000000001,2,10,0,6,0.1111111111111111,0.16666666666666666,0.0
Gulbis E.,224,451,221,230,2.2871577337840012,55,50,166,180,0.49002217294900224,0.5238095238095238,0.4797687861271676
Gunneswaran P.,134,26,7,19,3.5794736842105257,0,0,7,19,0.2692307692307692,,0.2692307692307692
Gutierrez-Ferrol S.,544,4,2,2,2.83,0,0,2,2,0.5,,0.5
Guzman J.,100,1,0,1,,0,0,0,1,0.0,,0.0
Guzman J.P.,132,20,6,14,2.7305256410256415,0,0,6,14,0.3,,0.3
Haas T.,248,505,306,199,2.1753309613319014,66,41,240,158,0.6059405940594059,0.616822429906542,0.6030150753768844
Haase R.,167,451,200,251,2.679049094180673,35,53,165,198,0.4434589800443459,0.3977272727272727,0.45454545454545453
Hadad A.,344,4,2,2,3.675,0,0,2,2,0.5,,0.5
Haehnel J.,675,26,8,18,4.054154411764706,7,5,1,13,0.3076923076923077,0.5833333333333334,0.07142857142857142
Haider-Mauer A.,254,3,1,2,,0,1,1,1,0.3333333333333333,0.0,0.5
Haider-Maurer A.,412,110,38,72,4.03062865497076,6,9,32,63,0.34545454545454546,0.4,0.3368421052631579
Hajek J.,111,96,26,70,3.5917892976588623,4,18,22,52,0.2708333333333333,0.18181818181818182,0.2972972972972973
Haji A.,0,1,0,1,,0,0,0,1,0.0,,0.0
Hajji A.,0,2,0,2,,0,0,0,2,0.0,,0.0
Halebian A.,644,1,0,1,,0,0,0,1,0.0,,0.0
Halys Q.,202,27,6,21,5.297261904761905,1,5,5,16,0.2222222222222222,0.16666666666666666,0.23809523809523808
Hamou M.,287,3,0,3,,0,0,0,3,0.0,,0.0
Hanescu V.,146,380,170,210,2.8486695477562423,15,31,155,179,0.4473684210526316,0.32608695652173914,0.46407185628742514
Hanescu V. ,36,1,0,1,,0,1,0,0,0.0,0.0,
Hanfmann Y.,101,30,15,15,3.5186666666666664,0,0,15,15,0.5,,0.5
Hank T.,567,3,0,3,,0,0,0,3,0.0,,0.0
Hantschk M.,177,1,0,1,,0,0,0,1,0.0,,0.0
Harboe P.,610,1,0,1,,0,0,0,1,0.0,,0.0
Harris A.,162,1,0,1,,0,0,0,1,0.0,,0.0
Harris L.,80,45,19,26,3.108477777777778,4,4,15,22,0.4222222222222222,0.5,0.40540540540540543
Harrison C.,208,8,2,6,3.8100000000000005,0,0,2,6,0.25,,0.25
Harrison R.,433,271,117,154,2.995251382604324,16,17,101,137,0.4317343173431734,0.48484848484848486,0.42436974789915966
Hartfield D.,137,46,17,29,3.3285947712418302,2,4,15,25,0.3695652173913043,0.3333333333333333,0.375
Healey N.,173,18,6,12,4.084,0,0,6,12,0.3333333333333333,,0.3333333333333333
Hellstrom M.,534,1,0,1,,0,0,0,1,0.0,,0.0
Hemery C.,130,10,2,8,3.22625,0,2,2,6,0.2,0.0,0.25
Hemmes F.,215,2,1,1,,0,0,1,1,0.5,,0.5
Henman T.,91,169,99,70,2.077968924889544,20,13,79,57,0.5857988165680473,0.6060606060606061,0.5808823529411765
Herbert P-H.,131,1,0,1,,0,0,0,1,0.0,,0.0
Herbert P.H,95,16,8,8,3.1100000000000003,1,3,7,5,0.5,0.25,0.5833333333333334
Herbert P.H.,85,174,78,96,2.7544385822510824,25,33,53,63,0.4482758620689655,0.43103448275862066,0.45689655172413796
Hernandez A.,240,2,0,2,,0,0,0,2,0.0,,0.0
Hernandez O.,125,181,61,120,3.35881450094162,3,8,58,112,0.3370165745856354,0.2727272727272727,0.3411764705882353
Hernandez O. ,75,1,0,1,,0,1,0,0,0.0,0.0,
Hernandez-Fernandez J,266,1,0,1,,0,0,0,1,0.0,,0.0
Hernandez-Fernandez J.,250,1,0,1,,0,0,0,1,0.0,,0.0
Hernych J.,324,190,78,112,3.0841269696969698,9,17,69,95,0.4105263157894737,0.34615384615384615,0.42073170731707316
Hernych J. ,59,2,1,1,6.55,1,1,0,0,0.5,0.5,
Heuberger I.,191,27,9,18,2.9859999999999998,4,6,5,12,0.3333333333333333,0.4,0.29411764705882354
Hewitt L.,308,457,300,157,2.2250675074025947,29,17,271,140,0.6564551422319475,0.6304347826086957,0.6593673965936739
Hilton M.,212,3,1,2,2.8125,0,0,1,2,0.3333333333333333,,0.3333333333333333
Hipfl M.,0,1,0,1,,0,0,0,1,0.0,,0.0
Hippensteel K.,207,4,1,3,,1,1,0,2,0.25,0.5,0.0
Hoang A.,126,15,5,10,3.3175,2,4,3,6,0.3333333333333333,0.3333333333333333,0.3333333333333333
Hocevar R.,248,5,0,5,,0,0,0,5,0.0,,0.0
Horansky F.,164,7,1,6,5.24,0,2,1,4,0.14285714285714285,0.0,0.2
Hormazabal G.,621,2,0,2,,0,0,0,2,0.0,,0.0
Horna L.,95,193,88,105,2.392210187283789,5,7,83,98,0.45595854922279794,0.4166666666666667,0.4585635359116022
Hossam K.,338,1,0,1,,0,0,0,1,0.0,,0.0
Hrbaty D.,154,231,122,109,2.2561158870627898,29,23,93,86,0.5281385281385281,0.5576923076923077,0.5195530726256983
Huesler M.A.,149,9,5,4,3.3994999999999997,1,1,4,3,0.5555555555555556,0.5,0.5714285714285714
Humbert U.,34,78,42,36,2.4120039682539685,17,11,25,25,0.5384615384615384,0.6071428571428571,0.5
Hurkacz H.,33,85,40,45,2.650777777777778,5,10,35,35,0.47058823529411764,0.3333333333333333,0.5
Huta Galung J.,248,30,5,25,3.7952,1,11,4,14,0.16666666666666666,0.08333333333333333,0.2222222222222222
Hutchins R.,0,1,0,1,,0,0,0,1,0.0,,0.0
Ianni S.,559,2,1,1,7.875,0,0,1,1,0.5,,0.5
Idmbarek Y.,738,2,0,2,,0,0,0,2,0.0,,0.0
Ignatik U.,421,1,0,1,,0,0,0,1,0.0,,0.0
Ilhan M.,334,73,20,53,3.8536179245283018,3,10,17,43,0.273972602739726,0.23076923076923078,0.2833333333333333
Ilkel C.,279,13,1,12,5.520833333333334,0,3,1,9,0.07692307692307693,0.0,0.1
Im K.T.,202,1,0,1,,0,1,0,0,0.0,0.0,
Inglot D.,941,2,0,2,,0,2,0,0,0.0,0.0,
Ionita V.,271,3,0,3,,0,0,0,3,0.0,,0.0
Isner J.,23,663,412,251,2.04920496350365,46,42,366,209,0.6214177978883861,0.5227272727272727,0.6365217391304347
Isner J. ,40,2,1,1,2.7,1,1,0,0,0.5,0.5,
Istomin D.,164,436,193,243,2.9657891919667705,44,50,149,193,0.4426605504587156,0.46808510638297873,0.43567251461988304
Ito T.,146,84,28,56,3.9345535714285713,4,6,24,50,0.3333333333333333,0.4,0.32432432432432434
Ito Y.,622,1,0,1,,0,0,0,1,0.0,,0.0
Ittogi T.,1511,1,0,1,,0,0,0,1,0.0,,0.0
Ivanisevic G.,415,14,4,10,2.8637708333333336,1,3,3,7,0.2857142857142857,0.25,0.3
Ivashka I.,141,46,18,28,2.652996031746032,7,7,11,21,0.391304347826087,0.5,0.34375
Iwabuchi S.,339,9,2,7,3.2600000000000007,0,2,2,5,0.2222222222222222,0.0,0.2857142857142857
Iwami T.,557,2,0,2,,0,0,0,2,0.0,,0.0
Janowicz J.,141,164,80,84,2.5077619047619044,27,20,53,64,0.4878048780487805,0.574468085106383,0.452991452991453
Janvier M.,204,5,0,5,,0,0,0,5,0.0,,0.0
Jarry N.,78,89,43,46,2.5989155712841256,4,4,39,42,0.48314606741573035,0.5,0.48148148148148145
Jasika O.,290,4,1,3,7.333333333333333,0,1,1,2,0.25,0.0,0.3333333333333333
Jaziri M.,260,207,80,127,3.694061098375361,8,19,72,108,0.3864734299516908,0.2962962962962963,0.4
Jeanpierre J.,154,5,3,2,3.15,0,0,3,2,0.6,,0.6
Jelenic P.,544,2,1,1,4.665,1,1,0,0,0.5,0.5,
Jenkins S.,202,20,5,15,4.703538461538461,0,3,5,12,0.25,0.0,0.29411764705882354
Jeong S.Y.,332,1,0,1,,0,1,0,0,0.0,0.0,
Johansson J.,131,109,65,44,1.944538318452381,32,14,33,30,0.5963302752293578,0.6956521739130435,0.5238095238095238
Johansson T.,87,216,116,100,2.348748539823009,40,23,76,77,0.5370370370370371,0.6349206349206349,0.49673202614379086
Johnson S.,71,333,167,166,2.390036957646537,16,21,151,145,0.5015015015015015,0.43243243243243246,0.5101351351351351
Jones A.,137,9,2,7,4.426666666666668,0,0,2,7,0.2222222222222222,,0.2222222222222222
Jones G.,373,7,1,6,5.215,0,1,1,5,0.14285714285714285,0.0,0.16666666666666666
Jones G.D.,1214,2,0,2,,0,0,0,2,0.0,,0.0
Jouan R.,230,5,1,4,7.265000000000001,1,2,0,2,0.2,0.3333333333333333,0.0
Jubb P.,431,2,0,2,,0,0,0,2,0.0,,0.0
Jun W.,360,1,0,1,,0,0,0,1,0.0,,0.0
Jun W.S.,252,7,1,6,3.797,0,0,1,6,0.14285714285714285,,0.14285714285714285
Junaid R.,334,2,0,2,,0,0,0,2,0.0,,0.0
Jung J.,127,24,7,17,3.2560924369747895,5,3,2,14,0.2916666666666667,0.625,0.125
Junqueira D.,144,43,11,32,4.469948275862069,0,1,11,31,0.2558139534883721,0.0,0.2619047619047619
Kachmazov A.,1491,1,0,1,,0,1,0,0,0.0,0.0,
Kadhe A.,612,3,0,3,,0,0,0,3,0.0,,0.0
Kamke T.,231,163,62,101,3.230465506228042,17,26,45,75,0.3803680981595092,0.3953488372093023,0.375
Karanusic R.,110,48,12,36,3.4128311688311683,2,10,10,26,0.25,0.16666666666666666,0.2777777777777778
Karatsev A.,114,12,3,9,3.737222222222223,3,8,0,1,0.25,0.2727272727272727,0.0
Karlovic I.,126,668,349,319,2.253574060834525,80,66,269,253,0.5224550898203593,0.547945205479452,0.5153256704980843
Karlovic I. ,38,1,0,1,,0,1,0,0,0.0,0.0,
Karlovskiy E.,218,1,0,1,,0,1,0,0,0.0,0.0,
Kavcic B.,176,120,40,80,3.794003205128205,5,13,35,67,0.3333333333333333,0.2777777777777778,0.3431372549019608
Kecmanovic M.,42,73,39,34,2.2822963800904974,7,7,32,27,0.5342465753424658,0.5,0.5423728813559322
Kendrick R.,546,96,29,67,3.0678138528138525,8,13,21,54,0.3020833333333333,0.38095238095238093,0.28
Kern R.,392,3,0,3,,0,0,0,3,0.0,,0.0
Ketola T.,225,3,1,2,2.8674999999999997,0,0,1,2,0.3333333333333333,,0.3333333333333333
Khachanov K.,19,229,127,102,2.394674369747899,30,27,97,75,0.5545851528384279,0.5263157894736842,0.563953488372093
Khaddari H.,513,1,0,1,,0,0,0,1,0.0,,0.0
Khalfan S.,1116,2,0,2,,0,0,0,2,0.0,,0.0
Kicker N.,84,45,19,26,3.380121457489879,1,2,18,24,0.4222222222222222,0.3333333333333333,0.42857142857142855
Kiefer N.,178,225,129,96,2.7108179603494627,22,17,107,79,0.5733333333333334,0.5641025641025641,0.5752688172043011
Kim K,181,1,0,1,,0,0,0,1,0.0,,0.0
Kim K.,151,120,39,81,3.1226875,4,13,35,68,0.325,0.23529411764705882,0.33980582524271846
Kimmich M.,313,3,0,3,,0,0,0,3,0.0,,0.0
Kindlmann D.,162,12,1,11,4.6925,0,1,1,10,0.08333333333333333,0.0,0.09090909090909091
King D.,162,11,3,8,4.4835416666666665,1,1,2,7,0.2727272727272727,0.5,0.2222222222222222
King E.,200,5,1,4,4.0125,0,0,1,4,0.2,,0.2
King K.,405,6,1,5,5.825,0,0,1,5,0.16666666666666666,,0.16666666666666666
King P.,404,5,1,4,3.6016666666666666,0,2,1,2,0.2,0.0,0.3333333333333333
King-Turner D.,376,6,0,6,,0,0,0,6,0.0,,0.0
Kirillov E.,378,2,0,2,,0,1,0,1,0.0,0.0,0.0
Kirkin E.,566,1,0,1,,0,0,0,1,0.0,,0.0
Klaasen R.,307,8,4,4,4.015000000000001,0,0,4,4,0.5,,0.5
Klahn B.,129,54,13,41,3.201735459662289,1,3,12,38,0.24074074074074073,0.25,0.24
Klec I.,416,8,1,7,,0,0,1,7,0.125,,0.125
Klein B.,235,13,3,10,4.3133333333333335,0,0,3,10,0.23076923076923078,,0.23076923076923078
Klein T.,839,1,0,1,,0,0,0,1,0.0,,0.0
Klizan M.,150,273,128,145,2.8860472440944878,34,28,94,117,0.46886446886446886,0.5483870967741935,0.44549763033175355
Kloer S.,495,1,0,1,,0,0,0,1,0.0,,0.0
Knittel B.,210,5,1,4,3.64,0,0,1,4,0.2,,0.2
Knowle J.,0,11,3,8,3.76,0,3,3,5,0.2727272727272727,0.0,0.375
Koellerer D.,109,51,19,32,3.7203584229390683,2,3,17,29,0.37254901960784315,0.4,0.3695652173913043
Koellerer D. ,74,1,0,1,,0,1,0,0,0.0,0.0,
Koepfer D.,61,24,11,13,3.1885000000000003,1,1,10,12,0.4583333333333333,0.5,0.45454545454545453
Kohlmann M.,1494,13,6,7,3.271875,1,2,5,5,0.46153846153846156,0.3333333333333333,0.5
Kohlschreiber P.,86,793,438,355,2.4660012063643157,75,72,363,283,0.5523329129886507,0.5102040816326531,0.5619195046439629
Kohlschreiber P. ,26,1,0,1,,0,1,0,0,0.0,0.0,
Kohlschreiber P..,24,2,1,1,1.2349999999999999,1,1,0,0,0.5,0.5,
Kokkinakis T.,203,65,25,40,3.444525,0,4,25,36,0.38461538461538464,0.0,0.4098360655737705
Kolar Z.,221,1,0,1,,0,0,0,1,0.0,,0.0
Kondo H.,589,1,0,1,,0,0,0,1,0.0,,0.0
Koning M.,793,1,0,1,,0,0,0,1,0.0,,0.0
Kontinen H.,253,3,1,2,3.3725,0,1,1,1,0.3333333333333333,0.0,0.5
Korda S.,213,7,3,4,6.239166666666667,0,1,3,3,0.42857142857142855,0.0,0.5
Korolev E.,181,159,68,91,2.698467032967033,14,17,54,74,0.4276729559748428,0.45161290322580644,0.421875
Korolev E. ,58,3,2,1,8.495000000000001,2,1,0,0,0.6666666666666666,0.6666666666666666,
Korteling S.,463,1,0,1,,0,0,0,1,0.0,,0.0
Kosakowski D.,366,3,1,2,3.25,0,0,1,2,0.3333333333333333,,0.3333333333333333
Kotov P.,286,1,0,1,,0,1,0,0,0.0,0.0,
Koubek S.,173,173,76,97,2.7493786630036627,27,20,49,77,0.4393063583815029,0.574468085106383,0.3888888888888889
Kovalik J.,125,46,14,32,3.1170535714285714,4,6,10,26,0.30434782608695654,0.4,0.2777777777777778
Kozlov S.,367,22,5,17,3.3767058823529412,0,2,5,15,0.22727272727272727,0.0,0.25
Krajan Z.,681,4,1,3,5.875,0,0,1,3,0.25,,0.25
Krajicek A.,274,36,12,24,3.9177083333333336,2,2,10,22,0.3333333333333333,0.5,0.3125
Krajinovic F.,30,150,75,75,3.0355765765765765,30,24,45,51,0.5,0.5555555555555556,0.46875
Kratochvil M.,1511,14,5,9,2.590525,0,1,5,8,0.35714285714285715,0.0,0.38461538461538464
Kravchuk K.,260,32,7,25,3.658714285714286,4,9,3,16,0.21875,0.3076923076923077,0.15789473684210525
Krawietz K.,277,5,1,4,4.1725,0,0,1,4,0.2,,0.2
Krstin P.,195,3,0,3,,0,2,0,1,0.0,0.0,0.0
Krueger M.,198,12,3,9,4.546666666666667,0,0,3,9,0.25,,0.25
Kubler J.,130,9,2,7,3.2325,0,0,2,7,0.2222222222222222,,0.2222222222222222
Kubot L.,614,200,82,118,3.1729163135593224,14,21,68,97,0.41,0.4,0.4121212121212121
Kucera K.,146,29,11,18,2.3985828877005346,2,5,9,13,0.3793103448275862,0.2857142857142857,0.4090909090909091
Kucera V.,19,2,1,1,3.0575,0,0,1,1,0.5,,0.5
Kudla D.,111,148,52,96,3.0321594551282045,5,12,47,84,0.35135135135135137,0.29411764705882354,0.35877862595419846
Kudryavtsev A.,179,20,5,15,4.472666666666667,0,3,5,12,0.25,0.0,0.29411764705882354
Kuerten G.,1141,60,27,33,2.3266075268817206,0,0,27,33,0.45,,0.45
Kuhn N.,276,6,2,4,3.4575,0,0,2,4,0.3333333333333333,,0.3333333333333333
Kukushkin M.,91,331,138,193,3.0765555555555557,50,45,88,148,0.4169184290030212,0.5263157894736842,0.3728813559322034
Kumantsov A.,347,2,0,2,,0,2,0,0,0.0,0.0,
Kunitsyn I.,167,227,85,142,2.9667922969918274,29,33,56,109,0.3744493392070485,0.46774193548387094,0.3393939393939394
Kunitsyn I. ,81,1,0,1,,0,1,0,0,0.0,0.0,
Kutac R.,638,1,0,1,,0,0,0,1,0.0,,0.0
Kutrovsky D.,438,3,2,1,4.2975,2,1,0,0,0.6666666666666666,0.6666666666666666,
Kutsenko V.,237,1,0,1,,0,0,0,1,0.0,,0.0
Kuzmanov D.,291,5,0,5,,0,5,0,0,0.0,0.0,
Kuznetsov A.,167,26,6,20,4.242982456140351,2,6,4,14,0.23076923076923078,0.25,0.2222222222222222
Kuznetsov Al.,311,21,5,16,2.74725,2,2,3,14,0.23809523809523808,0.5,0.17647058823529413
Kuznetsov An.,34,160,70,90,3.020200483091788,9,19,61,71,0.4375,0.32142857142857145,0.4621212121212121
Kwiatkowski T.S.,187,5,0,5,,0,0,0,5,0.0,,0.0
Kwon S.W.,82,28,13,15,2.403538461538462,3,2,10,13,0.4642857142857143,0.6,0.43478260869565216
Kypson P.,17,1,0,1,,0,0,0,1,0.0,,0.0
Kyrgios N.,23,236,148,88,2.0001919533169534,11,7,137,81,0.6271186440677966,0.6111111111111112,0.6284403669724771
Laaksonen H.,139,69,27,42,3.8014835164835166,6,13,21,29,0.391304347826087,0.3157894736842105,0.42
Labadze I.,166,54,21,33,3.8842202797202794,1,8,20,25,0.3888888888888889,0.1111111111111111,0.4444444444444444
Lacko L.,130,213,80,133,3.5782373120300752,19,29,61,104,0.3755868544600939,0.3958333333333333,0.3696969696969697
Lajola D.,719,1,0,1,,0,1,0,0,0.0,0.0,
Lajovic D.,26,274,119,155,2.8944518839793982,16,28,103,127,0.4343065693430657,0.36363636363636365,0.44782608695652176
Lama G.,289,1,0,1,,0,0,0,1,0.0,,0.0
Lamasine T.,270,7,2,5,3.5615000000000006,0,1,2,4,0.2857142857142857,0.0,0.3333333333333333
Lammer M.,327,19,5,14,4.528846153846153,1,3,4,11,0.2631578947368421,0.25,0.26666666666666666
Lammer M. ,167,2,1,1,3.25,1,1,0,0,0.5,0.5,
Langer N.,340,3,1,2,4.305,0,1,1,1,0.3333333333333333,0.0,0.5
Lapentti G.,641,26,7,19,3.365176470588236,0,1,7,18,0.2692307692307692,0.0,0.28
Lapentti N.,129,149,59,90,3.1327506019261637,5,9,54,81,0.3959731543624161,0.35714285714285715,0.4
Larkham T.,168,1,0,1,,0,0,0,1,0.0,,0.0
Larose S.,193,3,1,2,3.96875,0,0,1,2,0.3333333333333333,,0.3333333333333333
Lazarov A.,0,2,0,2,,0,2,0,0,0.0,0.0,
Lazov A.,438,1,0,1,,0,1,0,0,0.0,0.0,
Ledovskikh M.,417,17,4,13,3.3822727272727278,2,5,2,8,0.23529411764705882,0.2857142857142857,0.2
Lee D.H.,212,2,1,1,3.165,0,0,1,1,0.5,,0.5
Lee H.T.,115,162,73,89,2.807733116883117,5,10,68,79,0.4506172839506173,0.3333333333333333,0.46258503401360546
Lee M.,252,3,1,2,3.3925,0,0,1,2,0.3333333333333333,,0.3333333333333333
Lejnieks K.,664,2,1,1,5.5,1,1,0,0,0.5,0.5,
Lemke J.,456,1,0,1,,0,0,0,1,0.0,,0.0
Lenz J.,270,2,0,2,,0,1,0,1,0.0,0.0,0.0
Leshem E.,278,1,0,1,,0,0,0,1,0.0,,0.0
Lestienne C.,198,6,1,5,2.2409999999999997,1,3,0,2,0.16666666666666666,0.25,0.0
Levine I.,426,1,0,1,,0,0,0,1,0.0,,0.0
Levine J.,132,93,30,63,2.9655053763440864,5,7,25,56,0.3225806451612903,0.4166666666666667,0.30864197530864196
Levy H.,118,28,6,22,2.789666666666667,0,3,6,19,0.21428571428571427,0.0,0.24
Li Z.,231,10,0,10,,0,0,0,10,0.0,,0.0
Lin J.M.,0,1,0,1,,0,1,0,0,0.0,0.0,
Lindahl N.,244,9,1,8,4.645,1,1,0,7,0.1111111111111111,0.5,0.0
Lindell C.,326,10,2,8,5.358125,0,1,2,7,0.2,0.0,0.2222222222222222
Linzer M.,354,2,0,2,,0,0,0,2,0.0,,0.0
Lipsky S.,1004,1,0,1,,0,0,0,1,0.0,,0.0
Lisnard J.,134,5,1,4,2.474375,0,1,1,3,0.2,0.0,0.25
Lisnard J.R.,393,55,15,40,3.459585087719298,3,3,12,37,0.2727272727272727,0.5,0.24489795918367346
Ljubicic I.,53,457,286,171,2.2000259908218607,99,51,187,120,0.6258205689277899,0.66,0.6091205211726385
Ljubicic I. ,25,1,0,1,,0,1,0,0,0.0,0.0,
Llodra M.,192,327,157,170,2.7596494652406416,58,46,99,124,0.4801223241590214,0.5576923076923077,0.4439461883408072
Logtens P.,286,1,0,1,,0,0,0,1,0.0,,0.0
Lojda D.,169,1,0,1,,0,0,0,1,0.0,,0.0
Lokoli L.,285,5,0,5,,0,2,0,3,0.0,0.0,0.0
Londero J.I.,69,63,30,33,3.33390625,2,4,28,29,0.47619047619047616,0.3333333333333333,0.49122807017543857
Lopez F.,64,816,429,387,2.4450509035775547,71,79,358,308,0.5257352941176471,0.47333333333333333,0.5375375375375375
Lopez F. ,46,2,1,1,1.495,1,1,0,0,0.5,0.5,
Lopez M.,1014,35,12,23,3.208452380952381,0,1,12,22,0.34285714285714286,0.0,0.35294117647058826
Lopez Villasenor G.,518,2,0,2,,0,0,0,2,0.0,,0.0
Lopez-Jaen M.A.,264,3,1,2,6.785,0,0,1,2,0.3333333333333333,,0.3333333333333333
Lopez-Perez E.,196,1,0,1,,0,0,0,1,0.0,,0.0
Lorenzi P.,125,282,104,178,3.832903522039758,19,26,85,152,0.36879432624113473,0.4222222222222222,0.35864978902953587
Lu H.,1095,2,1,1,,0,0,1,1,0.5,,0.5
Lu Y.,80,4,0,4,,0,0,0,4,0.0,,0.0
Lu Y.H.,962,354,142,212,3.237826086956522,15,31,127,181,0.4011299435028249,0.32608695652173914,0.41233766233766234
Luczak P.,248,103,32,71,3.3370219435736677,2,5,30,66,0.3106796116504854,0.2857142857142857,0.3125
Luczak P. ,80,1,0,1,,0,1,0,0,0.0,0.0,
Luncanu P.A.,322,2,0,2,,0,1,0,1,0.0,0.0,0.0
Luque D.,596,1,0,1,,0,0,0,1,0.0,,0.0
Luz O.,544,1,0,1,,0,1,0,0,0.0,0.0,
Luzzi F.,111,17,5,12,3.274583333333333,0,0,5,12,0.29411764705882354,,0.29411764705882354
Maamoun K.,291,1,0,1,,0,0,0,1,0.0,,0.0
Machac T.,253,1,0,1,,0,0,0,1,0.0,,0.0
Machado R.,227,50,13,37,3.7417567567567573,0,1,13,36,0.26,0.0,0.2653061224489796
Mackin A.,270,9,0,9,,0,2,0,7,0.0,0.0,0.0
Maden Y.,131,26,9,17,3.8867973856209153,5,7,4,10,0.34615384615384615,0.4166666666666667,0.2857142857142857
Mager G.,91,14,6,8,3.878625,1,1,5,7,0.42857142857142855,0.5,0.4166666666666667
Mahut N.,191,386,175,211,2.8695190071556347,45,60,130,151,0.4533678756476684,0.42857142857142855,0.4626334519572954
Majchrzak K.,105,13,3,10,2.9505,0,1,3,9,0.23076923076923078,0.0,0.25
Malisse X.,113,353,175,178,2.278929356725146,27,37,148,141,0.49575070821529743,0.421875,0.5121107266435986
Mamiit C.,420,9,3,6,3.22175,1,2,2,4,0.3333333333333333,0.3333333333333333,0.3333333333333333
Mankad H.,255,3,0,3,,0,0,0,3,0.0,,0.0
Mannarino A.,35,438,202,236,2.8250622419815814,48,58,154,178,0.4611872146118721,0.4528301886792453,0.463855421686747
Mantilla F.,421,65,32,33,2.311008928571429,0,0,32,33,0.49230769230769234,,0.49230769230769234
Marach O.,464,41,15,26,3.2702820512820514,3,5,12,21,0.36585365853658536,0.375,0.36363636363636365
Marcaccio G.,406,5,2,3,5.125,0,0,2,3,0.4,,0.4
Marcan D.,377,2,0,2,,0,2,0,0,0.0,0.0,
March O.,0,1,0,1,,0,0,0,1,0.0,,0.0
Marchenko I.,216,122,47,75,3.33810780141844,16,21,31,54,0.38524590163934425,0.43243243243243246,0.36470588235294116
Marcora R.,174,4,2,2,2.9050000000000002,0,0,2,2,0.5,,0.5
Marin J.A.,259,27,7,20,3.010515873015873,0,0,7,20,0.25925925925925924,,0.25925925925925924
Marrai M.,414,1,0,1,,0,0,0,1,0.0,,0.0
Marray J.,263,11,4,7,3.4667857142857144,0,1,4,6,0.36363636363636365,0.0,0.4
Marrero D.,262,9,3,6,2.7800000000000002,0,0,3,6,0.3333333333333333,,0.3333333333333333
Marterer M.,337,74,25,49,2.712861224489796,2,8,23,41,0.33783783783783783,0.2,0.359375
Marti J.,211,13,2,11,4.254772727272727,1,3,1,8,0.15384615384615385,0.25,0.1111111111111111
Marti Y.,391,7,2,5,3.0335,0,0,2,5,0.2857142857142857,,0.2857142857142857
Martin A.,105,237,100,137,2.9784703703703705,5,12,95,125,0.4219409282700422,0.29411764705882354,0.4318181818181818
Martin A. ,119,1,0,1,,0,1,0,0,0.0,0.0,
Martin D.,725,1,0,1,,0,1,0,0,0.0,0.0,
Martin F.,0,2,0,2,,0,0,0,2,0.0,,0.0
Martin T.,96,25,10,15,2.1583,0,2,10,13,0.4,0.0,0.43478260869565216
Martinez P.,105,21,9,12,3.234166666666667,0,1,9,11,0.42857142857142855,0.0,0.45
Massa E.,240,17,7,10,2.59375,0,1,7,9,0.4117647058823529,0.0,0.4375
Massu N.,578,239,112,127,2.321817434715822,9,17,103,110,0.4686192468619247,0.34615384615384615,0.4835680751173709
Masur D.,349,5,1,4,4.171250000000001,0,1,1,3,0.2,0.0,0.25
Mathieu P.,44,3,0,3,,0,0,0,3,0.0,,0.0
Mathieu P.H.,252,479,227,252,2.5411108821553716,58,66,169,186,0.47390396659707723,0.46774193548387094,0.476056338028169
Mathieu P.H. ,32,1,0,1,,0,1,0,0,0.0,0.0,
Matkowski M.,0,1,0,1,,0,0,0,1,0.0,,0.0
Matos-Gil I.,512,2,0,2,,0,0,0,2,0.0,,0.0
Matosevic M.,169,155,62,93,3.4705241935483877,10,11,52,82,0.4,0.47619047619047616,0.3880597014925373
Matsui T.,536,4,2,2,,1,1,1,1,0.5,0.5,0.5
Matsukevitch D.,364,4,1,3,4.916666666666666,1,2,0,1,0.25,0.3333333333333333,0.0
Mayer F.,193,477,227,250,2.8272768310636733,27,41,200,209,0.4758909853249476,0.39705882352941174,0.4889975550122249
Mayer L.,120,357,165,192,2.911129319105691,13,23,152,169,0.46218487394957986,0.3611111111111111,0.4735202492211838
Mayer L. ,64,2,1,1,5.4,1,1,0,0,0.5,0.5,
Mayot H.,412,2,0,2,,0,1,0,1,0.0,0.0,0.0
Mazarakis V.,126,3,0,3,,0,0,0,3,0.0,,0.0
McClune M.,614,1,0,1,,0,0,0,1,0.0,,0.0
Mcclune M.,416,2,1,1,3.125,0,0,1,1,0.5,,0.5
Mcdonald M.,209,60,23,37,3.3565458937198067,3,5,20,32,0.38333333333333336,0.375,0.38461538461538464
Mcgee J.,272,3,0,3,,0,0,0,3,0.0,,0.0
Mecir M.,187,4,1,3,3.2816666666666667,1,2,0,1,0.25,0.3333333333333333,0.0
Medvedev D.,4,228,150,78,2.0093271794871796,44,18,106,60,0.6578947368421053,0.7096774193548387,0.6385542168674698
Medvedev D. ,4,3,0,3,,0,3,0,0,0.0,0.0,
Meffert D.,204,13,5,8,3.841375,3,3,2,5,0.38461538461538464,0.5,0.2857142857142857
Meister N.,625,1,0,1,,0,0,0,1,0.0,,0.0
Mektic N.,331,9,2,7,3.4292857142857143,0,3,2,4,0.2222222222222222,0.0,0.3333333333333333
Meligeni Rodrigues F,341,1,0,1,,0,0,0,1,0.0,,0.0
Mello R.,346,122,45,77,3.0564788083538086,1,9,44,68,0.36885245901639346,0.1,0.39285714285714285
Melzer G.,115,45,16,29,3.24167025862069,1,7,15,22,0.35555555555555557,0.125,0.40540540540540543
Melzer J.,426,577,305,272,2.54016035766775,68,54,237,218,0.5285961871750433,0.5573770491803278,0.5208791208791209
Menendez-Maceiras A.,139,24,6,18,3.321666666666667,2,5,4,13,0.25,0.2857142857142857,0.23529411764705882
Mergea F.,277,2,1,1,,0,0,1,1,0.5,,0.5
Mertens Y.,208,3,1,2,2.1525,1,2,0,0,0.3333333333333333,0.3333333333333333,
Mertinak M.,555,13,4,9,2.7765833333333334,0,1,4,8,0.3076923076923077,0.0,0.3333333333333333
Mertl J.,306,2,1,1,4.8100000000000005,0,0,1,1,0.5,,0.5
Mesaros K.,295,1,0,1,,0,1,0,0,0.0,0.0,
Michon A.,206,2,1,1,4.6,0,0,1,1,0.5,,0.5
Middelkoop M.,210,1,0,1,,0,0,0,1,0.0,,0.0
Miedler L.,258,3,0,3,,0,2,0,1,0.0,0.0,0.0
Millman J.,38,181,81,100,2.9581864197530865,13,14,68,86,0.44751381215469616,0.48148148148148145,0.44155844155844154
Millot V.,291,30,8,22,4.096704545454545,3,10,5,12,0.26666666666666666,0.23076923076923078,0.29411764705882354
Milojevic N.,144,8,4,4,4.02375,1,1,3,3,0.5,0.5,0.5
Mina G.,269,5,1,4,8.39125,0,0,1,4,0.2,,0.2
Minar I.,216,96,33,63,3.2516101694915256,1,7,32,56,0.34375,0.125,0.36363636363636365
Minar J.,303,3,0,3,,0,0,0,3,0.0,,0.0
Miranda I.,126,3,1,2,2.58,0,0,1,2,0.3333333333333333,,0.3333333333333333
Mirnegg M.,306,1,0,1,,0,0,0,1,0.0,,0.0
Mirnyi M.,260,180,85,95,2.233355514316013,30,20,55,75,0.4722222222222222,0.6,0.4230769230769231
Mitchell B.,231,5,0,5,,0,0,0,5,0.0,,0.0
Mmoh M.,178,28,9,19,3.0017543859649125,0,1,9,18,0.32142857142857145,0.0,0.3333333333333333
Moeller M.,0,1,0,1,,0,0,0,1,0.0,,0.0
Molleker R.,150,13,4,9,3.8038888888888893,0,0,4,9,0.3076923076923077,,0.3076923076923077
Molteni A.,280,2,0,2,,0,0,0,2,0.0,,0.0
Monaco J.,124,580,324,256,2.4381929371123103,30,28,294,228,0.5586206896551724,0.5172413793103449,0.5632183908045977
Monaco J. ,30,2,1,1,3.35,1,1,0,0,0.5,0.5,
Monfils G.,11,750,474,276,2.0529122560823065,123,60,351,216,0.632,0.6721311475409836,0.6190476190476191
Monfils G. ,16,2,1,1,1.135,1,1,0,0,0.5,0.5,
Montanes A.,312,454,216,238,3.223802080846662,12,23,204,215,0.47577092511013214,0.34285714285714286,0.48687350835322196
Montanes A. ,34,3,2,1,7.25,2,1,0,0,0.6666666666666666,0.6666666666666666,
Montcourt M.,123,15,5,10,3.9099999999999997,0,1,5,9,0.3333333333333333,0.0,0.35714285714285715
Monteiro J.,502,1,0,1,,0,0,0,1,0.0,,0.0
Monteiro T.,84,89,35,54,2.9525471698113206,4,5,31,49,0.39325842696629215,0.4444444444444444,0.3875
Moodie W.,157,93,40,53,2.829141328828829,6,13,34,40,0.43010752688172044,0.3157894736842105,0.4594594594594595
Moraing M.,223,1,0,1,,0,0,0,1,0.0,,0.0
Moraru G.,418,1,0,1,,0,0,0,1,0.0,,0.0
Moriya H.,178,11,2,9,6.046111111111111,1,2,1,7,0.18181818181818182,0.3333333333333333,0.125
Moroni G.,265,2,1,1,2.31,0,0,1,1,0.5,,0.5
Morrison J.,157,48,19,29,2.5806830065359474,4,5,15,24,0.3958333333333333,0.4444444444444444,0.38461538461538464
Moser F.,424,1,0,1,,0,1,0,0,0.0,0.0,
Motomura G.,273,7,2,5,3.3465,1,1,1,4,0.2857142857142857,0.5,0.2
Mott B.,287,1,0,1,,0,0,0,1,0.0,,0.0
Moutet C.,75,50,18,32,2.9069618055555555,2,7,16,25,0.36,0.2222222222222222,0.3902439024390244
Moya C.,514,304,189,115,1.9310221478115284,7,12,182,103,0.6217105263157895,0.3684210526315789,0.6385964912280702
Moyano D.,247,1,0,1,,0,0,0,1,0.0,,0.0
Mukund S.,263,1,0,1,,0,0,0,1,0.0,,0.0
Muller A.,304,2,0,2,,0,0,0,2,0.0,,0.0
Muller G.,127,397,200,197,2.7862812386675646,38,39,162,158,0.5037783375314862,0.4935064935064935,0.50625
Munar J.,109,73,30,43,2.8402635658914726,1,4,29,39,0.410958904109589,0.2,0.4264705882352941
Munoz De La Nava D.,138,8,1,7,2.1357142857142857,0,0,1,7,0.125,,0.125
Munoz de La Nava D.,182,1,0,1,,0,0,0,1,0.0,,0.0
Munoz de la Nava D.,200,1,0,1,,0,0,0,1,0.0,,0.0
Munoz-De La Nava D.,69,27,8,19,3.741184210526316,1,1,7,18,0.2962962962962963,0.5,0.28
Murray A.,115,838,637,201,1.7251994812330749,121,36,516,165,0.7601431980906921,0.7707006369426752,0.7577092511013216
Murray A. ,4,5,5,0,,5,0,0,0,1.0,1.0,
Musetti L.,143,8,5,3,2.557666666666667,0,0,5,3,0.625,,0.625
Muster T.,974,3,0,3,,0,2,0,1,0.0,0.0,0.0
Mutis O.,125,23,7,16,3.321066666666667,1,2,6,14,0.30434782608695654,0.3333333333333333,0.3
Myneni S.,192,2,0,2,,0,0,0,2,0.0,,0.0
Nadal R.,2,1143,952,191,1.4629077372919477,75,37,877,154,0.8328958880139983,0.6696428571428571,0.8506304558680893
Nadal R. ,1,3,2,1,1.585,2,1,0,0,0.6666666666666666,0.6666666666666666,
Nader M.,0,1,0,1,,0,0,0,1,0.0,,0.0
Nagal S.,130,8,1,7,5.413571428571428,0,1,1,6,0.125,0.0,0.14285714285714285
Nakashima B.,223,5,3,2,2.5833333333333335,0,0,3,2,0.6,,0.6
Nalbandian D.,124,396,266,130,1.8321200095057035,71,26,195,104,0.6717171717171717,0.7319587628865979,0.6521739130434783
Nam H.W.,467,2,0,2,,0,0,0,2,0.0,,0.0
Napolitano S.,187,3,1,2,4.25,0,0,1,2,0.3333333333333333,,0.3333333333333333
Nardi L.,917,1,0,1,,0,1,0,0,0.0,0.0,
Naso G.,200,14,3,11,3.251666666666667,0,0,3,11,0.21428571428571427,,0.21428571428571427
Nava E.,0,1,0,1,,0,0,0,1,0.0,,0.0
Navarro S.,209,1,0,1,,0,0,0,1,0.0,,0.0
Navarro-Pastor I.,310,100,35,65,3.5779748684979538,1,4,34,61,0.35,0.2,0.35789473684210527
Nedelko I.,508,2,0,2,,0,2,0,0,0.0,0.0,
Nedovyesov A.,115,23,4,19,3.895592105263158,0,3,4,16,0.17391304347826086,0.0,0.2
Nedovyesov O.,124,1,0,1,,0,1,0,0,0.0,0.0,
Nedunchezhiyan J.,314,1,0,1,,0,0,0,1,0.0,,0.0
Nestor D.,0,2,0,2,,0,0,0,2,0.0,,0.0
Nielsen F.,558,10,0,10,,0,3,0,7,0.0,0.0,0.0
Nielsen M.,309,3,0,3,,0,0,0,3,0.0,,0.0
Niemeyer F.,487,12,3,9,4.2375,1,3,2,6,0.25,0.25,0.25
Nieminen J.,145,572,294,278,2.616822130448951,89,68,205,210,0.513986013986014,0.5668789808917197,0.4939759036144578
Nieminen J. ,122,2,1,1,3.31,1,1,0,0,0.5,0.5,
Niki T.,340,1,0,1,,0,0,0,1,0.0,,0.0
Nikles J.,874,1,0,1,,0,0,0,1,0.0,,0.0
Niland C.,197,3,0,3,,0,0,0,3,0.0,,0.0
Nishikori K.,35,575,382,193,2.2850932591623034,68,31,314,162,0.6643478260869565,0.6868686868686869,0.6596638655462185
Nishioka Y.,51,124,58,66,3.3341021220159153,9,7,49,59,0.46774193548387094,0.5625,0.4537037037037037
Norman D.,263,37,10,27,2.963125,1,3,9,24,0.2702702702702703,0.25,0.2727272727272727
Norrie C.,70,103,47,56,2.5834194528875383,5,8,42,48,0.4563106796116505,0.38461538461538464,0.4666666666666667
Novak D.,92,36,10,26,3.399846153846154,3,10,7,16,0.2777777777777778,0.23076923076923078,0.30434782608695654
Novak J.,122,127,71,56,2.0874242788461537,7,10,64,46,0.5590551181102362,0.4117647058823529,0.5818181818181818
Novikov D.,219,16,5,11,3.8329999999999997,0,0,5,11,0.3125,,0.3125
Nunez E.,531,1,0,1,,0,0,0,1,0.0,,0.0
O Connell C.,116,2,1,1,12.285,0,0,1,1,0.5,,0.5
O'Connell C.,115,3,0,3,,0,0,0,3,0.0,,0.0
O'Neal J.,748,1,0,1,,0,0,0,1,0.0,,0.0
Odesnik W.,176,99,40,59,2.985725022104332,3,5,37,54,0.40404040404040403,0.375,0.4065934065934066
Ofner S.,159,15,8,7,4.433928571428572,1,2,7,5,0.5333333333333333,0.3333333333333333,0.5833333333333334
Ojeda Lara R.,206,6,3,3,3.591666666666667,0,0,3,3,0.5,,0.5
Okun N.,273,26,8,18,3.0820285714285713,0,3,8,15,0.3076923076923077,0.0,0.34782608695652173
Olaso G.,309,6,2,4,3.8287500000000003,0,1,2,3,0.3333333333333333,0.0,0.4
Olejniczak D.,202,3,0,3,,0,0,0,3,0.0,,0.0
Olivetti A.,793,14,5,9,3.593333333333333,5,5,0,4,0.35714285714285715,0.5,0.0
Olivo R.,297,52,23,29,3.529514106583072,4,3,19,26,0.4423076923076923,0.5714285714285714,0.4222222222222222
Opelka R.,33,90,46,44,2.410138339920949,12,6,34,38,0.5111111111111111,0.6666666666666666,0.4722222222222222
Ortega-Olmedo R.,310,1,0,1,,0,0,0,1,0.0,,0.0
Oswald P.,1059,4,1,3,3.6666666666666665,0,1,1,2,0.25,0.0,0.3333333333333333
Otte O.,141,11,4,7,3.738035714285714,3,5,1,2,0.36363636363636365,0.375,0.3333333333333333
Ouahab L.,617,15,5,10,3.8585000000000003,0,1,5,9,0.3333333333333333,0.0,0.35714285714285715
Ouanna J.,156,26,9,17,3.6122058823529413,3,5,6,12,0.34615384615384615,0.375,0.3333333333333333
Oudsema S.,261,5,1,4,,0,1,1,3,0.2,0.0,0.25
Ouyang B.,1098,1,0,1,,0,0,0,1,0.0,,0.0
Paes L.,0,1,0,1,,0,0,0,1,0.0,,0.0
Paire B.,28,456,220,236,2.6714733322966877,38,51,182,185,0.4824561403508772,0.42696629213483145,0.49591280653950953
Panfil G.,911,1,0,1,,0,0,0,1,0.0,,0.0
Parada F.,385,2,0,2,,0,0,0,2,0.0,,0.0
Parmar A.,230,10,3,7,4.3445833333333335,2,2,1,5,0.3,0.5,0.16666666666666666
Pasha N.,1187,1,0,1,,0,0,0,1,0.0,,0.0
Pashanski B.,166,72,24,48,3.2200872093023256,2,2,22,46,0.3333333333333333,0.5,0.3235294117647059
Patience O.,199,76,26,50,2.9276401952085185,1,3,25,47,0.34210526315789475,0.25,0.3472222222222222
Patino L.,809,1,0,1,,0,0,0,1,0.0,,0.0
Patriarca D.,284,1,0,1,,0,0,0,1,0.0,,0.0
Paul T.,55,53,25,28,2.754892857142857,3,5,22,23,0.4716981132075472,0.375,0.4888888888888889
Pavel A.,646,165,74,91,2.404459546165884,12,18,62,73,0.4484848484848485,0.4,0.45925925925925926
Pavic A.,449,13,3,10,3.3198333333333334,0,3,3,7,0.23076923076923078,0.0,0.3
Pavic M.,0,13,3,10,7.064,0,1,3,9,0.23076923076923078,0.0,0.25
Pavlasek A.,185,14,5,9,4.208444444444444,0,1,5,8,0.35714285714285715,0.0,0.38461538461538464
Pedroso A.,286,1,0,1,,0,0,0,1,0.0,,0.0
Peliwo F.,526,6,2,4,4.6875,0,0,2,4,0.3333333333333333,,0.3333333333333333
Pella G.,37,216,103,113,3.0555552663543297,14,15,89,98,0.47685185185185186,0.4827586206896552,0.47593582887700536
Pellegrino A.,292,2,1,1,3.625,0,0,1,1,0.5,,0.5
Perez D.,578,2,0,2,,0,0,0,2,0.0,,0.0
Peric T.,1255,1,0,1,,0,0,0,1,0.0,,0.0
Pescosolido S.,157,5,1,4,3.0191250000000003,0,0,1,4,0.2,,0.2
Petrovic D.,166,4,2,2,3.8325,0,1,2,1,0.5,0.0,0.6666666666666666
Petzschner P.,524,183,83,100,2.9098168431300957,25,23,58,77,0.453551912568306,0.5208333333333334,0.42962962962962964
Petzschner P. ,76,1,0,1,,0,1,0,0,0.0,0.0,
Peya A.,311,56,15,41,3.3688504504504504,4,7,11,34,0.26785714285714285,0.36363636363636365,0.24444444444444444
Phau B.,223,189,73,116,3.441720300348619,15,20,58,96,0.3862433862433862,0.42857142857142855,0.37662337662337664
Philippoussis M.,113,63,28,35,2.026239393939394,3,4,25,31,0.4444444444444444,0.42857142857142855,0.44642857142857145
Phillips T.,413,1,0,1,,0,0,0,1,0.0,,0.0
Piccari F.,234,1,0,1,,0,0,0,1,0.0,,0.0
Piros Z.,453,1,0,1,,0,0,0,1,0.0,,0.0
Pless K.,128,52,13,39,3.7187,3,6,10,33,0.25,0.3333333333333333,0.23255813953488372
Podlipnik H.,517,2,0,2,,0,0,0,2,0.0,,0.0
Poerschke L.,332,2,0,2,,0,2,0,0,0.0,0.0,
Polansky P.,172,50,11,39,3.702331002331003,0,3,11,36,0.22,0.0,0.23404255319148937
Polmans M.,116,11,3,8,3.77625,0,1,3,7,0.2727272727272727,0.0,0.3
Popko D.,172,1,0,1,,0,1,0,0,0.0,0.0,
Popp A.,241,43,15,28,2.4660083333333334,1,5,14,23,0.3488372093023256,0.16666666666666666,0.3783783783783784
Popp T.,222,2,0,2,,0,0,0,2,0.0,,0.0
Popyrin A.,109,42,14,28,2.705714285714286,2,7,12,21,0.3333333333333333,0.2222222222222222,0.36363636363636365
Portas A.,131,53,16,37,2.769052777777778,0,0,16,37,0.3018867924528302,,0.3018867924528302
Pospisil J.,213,8,1,7,,1,2,0,5,0.125,0.3333333333333333,0.0
Pospisil V.,74,250,110,140,2.8925811688311684,34,30,76,110,0.44,0.53125,0.40860215053763443
Pouille L.,22,229,125,104,2.7758000000000003,31,21,94,83,0.5458515283842795,0.5961538461538461,0.5310734463276836
Prashanth V.,557,1,0,1,,0,0,0,1,0.0,,0.0
Prinosil D.,368,1,0,1,,0,0,0,1,0.0,,0.0
Prodon E.,115,15,0,15,,0,1,0,14,0.0,0.0,0.0
Prpic A.,205,1,0,1,,0,0,0,1,0.0,,0.0
Prpic F.,310,9,2,7,3.36,1,2,1,5,0.2222222222222222,0.3333333333333333,0.16666666666666666
Przysiezny M.,315,78,19,59,3.4432309941520467,7,14,12,45,0.24358974358974358,0.3333333333333333,0.21052631578947367
Puerta M.,10,63,37,26,2.3651515151515152,4,7,33,19,0.5873015873015873,0.36363636363636365,0.6346153846153846
Puetz T.,183,3,1,2,2.39,0,0,1,2,0.3333333333333333,,0.3333333333333333
Purcell M.,216,2,0,2,,0,0,0,2,0.0,,0.0
Querrey S.,48,638,355,283,2.2948687911445367,48,38,307,245,0.5564263322884012,0.5581395348837209,0.5561594202898551
Querry S.,545,7,2,5,3.4875,0,1,2,4,0.2857142857142857,0.0,0.3333333333333333
Quigley E.,463,1,0,1,,0,0,0,1,0.0,,0.0
Quinzi G.,304,2,1,1,3.01,0,0,1,1,0.5,,0.5
Quiroz R.,244,3,1,2,3.625,0,0,1,2,0.3333333333333333,,0.3333333333333333
Qureshi A.,154,10,4,6,3.6064999999999996,0,1,4,5,0.4,0.0,0.4444444444444444
Qureshi A.U.H.,207,5,1,4,3.65625,0,1,1,3,0.2,0.0,0.25
Rachidi Y.,923,1,0,1,,0,0,0,1,0.0,,0.0
Raja P.,907,1,0,1,,0,1,0,0,0.0,0.0,
Ram A.,233,6,1,5,2.975,0,1,1,4,0.16666666666666666,0.0,0.2
Ram R.,235,147,55,92,3.2434816561844864,3,16,52,76,0.3741496598639456,0.15789473684210525,0.40625
Ramanathan R.,182,33,14,19,3.4165225563909773,0,3,14,16,0.42424242424242425,0.0,0.4666666666666667
Ramirez C.,476,3,0,3,,0,0,0,3,0.0,,0.0
Ramirez-Hidalgo R.,165,180,62,118,3.1444698657308514,2,6,60,112,0.34444444444444444,0.25,0.3488372093023256
Ramos A.,97,148,68,80,3.117757352941177,9,13,59,67,0.4594594594594595,0.4090909090909091,0.46825396825396826
Ramos-Vinolas A.,46,306,145,161,2.7868713990412104,14,22,131,139,0.4738562091503268,0.3888888888888889,0.48518518518518516
Raonic M.,17,526,353,173,1.927132279864838,64,34,289,139,0.6711026615969582,0.6530612244897959,0.6752336448598131
Rascon T.,484,1,0,1,,0,1,0,0,0.0,0.0,
Rastogi K.,480,5,1,4,,0,1,1,3,0.2,0.0,0.25
Rea S.,963,1,0,1,,0,0,0,1,0.0,,0.0
Recouderc L.,207,15,3,12,3.875166666666667,0,4,3,8,0.2,0.0,0.2727272727272727
Rehnquist B.,191,11,3,8,5.010357142857143,1,3,2,5,0.2727272727272727,0.25,0.2857142857142857
Reichel A.,1154,1,0,1,,0,1,0,0,0.0,0.0,
Reid M.,216,1,0,1,,0,0,0,1,0.0,,0.0
Reid T.,175,26,12,14,2.5475941558441555,0,0,12,14,0.46153846153846156,,0.46153846153846156
Reinberg E.,1032,1,0,1,,0,0,0,1,0.0,,0.0
Reister J.,759,48,14,34,3.064017857142857,0,4,14,30,0.2916666666666667,0.0,0.3181818181818182
Reix C.,502,2,1,1,10.75,1,1,0,0,0.5,0.5,
Renavand N.,364,2,1,1,5.0,1,1,0,0,0.5,0.5,
Rettenmaier T.,297,4,2,2,2.915,1,1,1,1,0.5,0.5,0.5
Reyes-Varela M.A.,502,2,0,2,,0,0,0,2,0.0,,0.0
Reynolds B.,133,98,28,70,3.205188923395445,1,11,27,59,0.2857142857142857,0.08333333333333333,0.313953488372093
Riba P.,228,85,24,61,3.2977732240437154,1,7,23,54,0.2823529411764706,0.125,0.2987012987012987
Riba-Madrid P.,78,2,0,2,,0,0,0,2,0.0,,0.0
Rieschick S.,253,4,1,3,3.685,1,1,0,2,0.25,0.5,0.0
Rinderknech A.,162,1,0,1,,0,0,0,1,0.0,,0.0
Rios F.,1285,1,0,1,,0,0,0,1,0.0,,0.0
Robert S.,661,113,38,75,3.8619481981981982,3,6,35,69,0.336283185840708,0.3333333333333333,0.33653846153846156
Robredo R.,6,3,1,2,3.665,1,2,0,0,0.3333333333333333,0.3333333333333333,
Robredo T.,167,683,411,272,2.2147809141249093,44,41,367,231,0.6017569546120058,0.5176470588235295,0.6137123745819398
Robredo T. ,15,3,2,1,2.6174999999999997,2,1,0,0,0.6666666666666666,0.6666666666666666,
Roca Batalla O.,314,2,1,1,2.5,0,0,1,1,0.5,,0.5
Rocha D.,999,2,1,1,,0,0,1,1,0.5,,0.5
Rochus C.,1502,186,63,123,3.4226736131934032,14,27,49,96,0.3387096774193548,0.34146341463414637,0.33793103448275863
Rochus C. ,88,1,0,1,,0,1,0,0,0.0,0.0,
Rochus O.,143,344,162,182,2.6918351428270264,36,38,126,144,0.47093023255813954,0.4864864864864865,0.4666666666666667
Rochus O. ,61,1,0,1,,0,1,0,0,0.0,0.0,
Roddick A.,22,550,412,138,1.6745213149446727,87,34,325,104,0.7490909090909091,0.71900826446281,0.7575757575757576
Rodionov J.,153,7,2,5,3.648,1,1,1,4,0.2857142857142857,0.5,0.2
Rodrigues M.,275,2,1,1,8.125,1,1,0,0,0.5,0.5,
Rodriguez B.,439,1,0,1,,0,0,0,1,0.0,,0.0
Roger-Vasselin E.,186,208,84,124,3.0001508363201914,21,29,63,95,0.40384615384615385,0.42,0.3987341772151899
Roitman S.,121,80,23,57,3.146904186795491,0,3,23,54,0.2875,0.0,0.2987012987012987
Rola B.,183,26,9,17,3.607810457516339,1,2,8,15,0.34615384615384615,0.3333333333333333,0.34782608695652173
Romboli F.,244,1,0,1,,0,0,0,1,0.0,,0.0
Rosenholm P.,371,3,1,2,13.0,1,2,0,0,0.3333333333333333,0.3333333333333333,
Roshardt R.,588,2,0,2,,0,0,0,2,0.0,,0.0
Rosol L.,176,257,110,147,3.2111842918985776,22,33,88,114,0.4280155642023346,0.4,0.43564356435643564
Rosset M.,140,12,4,8,2.9801875,2,4,2,4,0.3333333333333333,0.3333333333333333,0.3333333333333333
Roumane R.,431,1,0,1,,0,1,0,0,0.0,0.0,
Rubin N.,269,27,8,19,3.568059210526316,0,2,8,17,0.2962962962962963,0.0,0.32
Rublev A.,8,199,118,81,2.389578363674409,32,22,86,59,0.592964824120603,0.5925925925925926,0.593103448275862
Ruevski P.,210,1,0,1,,0,0,0,1,0.0,,0.0
Rufin G.,91,44,16,28,3.74977380952381,4,2,12,26,0.36363636363636365,0.6666666666666666,0.3157894736842105
Rusedski G.,136,109,57,52,2.3845805052790348,14,9,43,43,0.5229357798165137,0.6086956521739131,0.5
Russell M.,156,170,62,108,3.3725257009345793,15,18,47,90,0.36470588235294116,0.45454545454545453,0.34306569343065696
Ruud C.,27,97,50,47,2.34290273556231,9,8,41,39,0.5154639175257731,0.5294117647058824,0.5125
Ruusuvuori E.,98,15,6,9,1.7066666666666668,4,5,2,4,0.4,0.4444444444444444,0.3333333333333333
Ryderstedt M.,340,20,8,12,3.869702380952381,5,6,3,6,0.4,0.45454545454545453,0.3333333333333333
Sa A.,238,5,1,4,2.895833333333333,0,0,1,4,0.2,,0.2
Saavedra Corvalan C.,395,1,0,1,,0,0,0,1,0.0,,0.0
Sabau R.,163,36,9,27,2.9616444444444445,0,3,9,24,0.25,0.0,0.2727272727272727
Sabry S.,586,1,0,1,,0,0,0,1,0.0,,0.0
Sachko V.,529,1,0,1,,0,1,0,0,0.0,0.0,
Sadecky A.,401,3,1,2,4.5625,0,0,1,2,0.3333333333333333,,0.3333333333333333
Safin M.,65,290,171,119,1.836935885794996,45,23,126,96,0.5896551724137931,0.6617647058823529,0.5675675675675675
Safiullin R.,199,3,1,2,2.9699999999999998,1,2,0,0,0.3333333333333333,0.3333333333333333,
Safranek V.,225,2,0,2,,0,0,0,2,0.0,,0.0
Safwat M.,135,14,2,12,3.130909090909091,0,0,2,12,0.14285714285714285,,0.14285714285714285
Sakamoto P.,389,1,0,1,,0,1,0,0,0.0,0.0,
Sakharov G.,252,4,1,3,3.3766666666666665,0,0,1,3,0.25,,0.25
Salamanca C.,310,1,0,1,,0,0,0,1,0.0,,0.0
Salva B.,326,5,0,5,,0,0,0,5,0.0,,0.0
Salzenstein J.,495,22,6,16,2.7264999999999997,0,1,6,15,0.2727272727272727,0.0,0.2857142857142857
Samper-Montana J.,410,2,0,2,,0,0,0,2,0.0,,0.0
Sanchez D.,138,71,29,42,2.3861115384615386,0,2,29,40,0.4084507042253521,0.0,0.42028985507246375
Sanchez De Luna J.,304,2,0,2,,0,0,0,2,0.0,,0.0
Sanchez M.,624,2,0,2,,0,0,0,2,0.0,,0.0
Sanchez de Luna J.A.,494,1,0,1,,0,0,0,1,0.0,,0.0
Sandbichler A.,570,1,0,1,,0,0,0,1,0.0,,0.0
Sandgren T.,48,95,39,56,2.9315954415954417,2,8,37,48,0.4105263157894737,0.2,0.43529411764705883
Sanguinetti D.,253,126,49,77,2.7908991156239766,7,17,42,60,0.3888888888888889,0.2916666666666667,0.4117647058823529
Santillan A.,163,9,2,7,2.322857142857143,0,1,2,6,0.2222222222222222,0.0,0.25
Santopadre V.,145,1,0,1,,0,1,0,0,0.0,0.0,
Santoro F.,67,224,111,113,2.9695778278278278,24,30,87,83,0.4955357142857143,0.4444444444444444,0.5117647058823529
Saoudi S.,524,4,2,2,,0,0,2,2,0.5,,0.5
Saretta F.,543,63,26,37,2.562871031746032,2,1,24,36,0.4126984126984127,0.6666666666666666,0.4
Sargsian S.,391,57,20,37,2.7672030360531306,5,7,15,30,0.3508771929824561,0.4166666666666667,0.3333333333333333
Sarkissian A.,176,5,2,3,3.7291666666666665,0,0,2,3,0.4,,0.4
Sarmiento R.,705,1,0,1,,0,0,0,1,0.0,,0.0
Satral J.,226,3,1,2,7.375,0,0,1,2,0.3333333333333333,,0.3333333333333333
Saulnier C.,259,109,49,60,2.426158081373647,22,16,27,44,0.44954128440366975,0.5789473684210527,0.38028169014084506
Saville L.,221,8,2,6,4.648333333333333,0,0,2,6,0.25,,0.25
Savolt A.,592,2,0,2,,0,1,0,1,0.0,0.0,0.0
Schalken S.,202,52,24,28,2.0286397306397306,5,5,19,23,0.46153846153846156,0.5,0.4523809523809524
Scherrer J.C.,1121,4,1,3,2.86,0,0,1,3,0.25,,0.25
Schiessling T.,652,1,0,1,,0,0,0,1,0.0,,0.0
Schnur B.,121,16,4,12,2.8975,4,3,0,9,0.25,0.5714285714285714,0.0
Scholtz N.,662,1,0,1,,0,0,0,1,0.0,,0.0
Schoorel T.,108,6,1,5,4.3,0,3,1,2,0.16666666666666666,0.0,0.3333333333333333
Schuettler R.,113,276,113,163,2.6114724842767294,23,33,90,130,0.40942028985507245,0.4107142857142857,0.4090909090909091
Schuettler R. ,85,1,0,1,,0,1,0,0,0.0,0.0,
Schukin Y.,127,30,12,18,3.636777777777778,0,3,12,15,0.4,0.0,0.4444444444444444
Schuttler P.,350,1,0,1,,0,1,0,0,0.0,0.0,
Schwank E.,139,98,37,61,2.994187853107345,3,5,34,56,0.37755102040816324,0.375,0.37777777777777777
Schwartzman D.,9,297,162,135,2.9544753086419755,26,19,136,116,0.5454545454545454,0.5777777777777777,0.5396825396825397
Sekulic M.,68,1,0,1,,0,1,0,0,0.0,0.0,
Sela D.,146,289,120,169,3.0402112919132147,16,23,104,146,0.41522491349480967,0.41025641025641024,0.416
Seppi A.,103,731,354,377,2.838523559459948,73,82,281,295,0.4842681258549932,0.47096774193548385,0.4878472222222222
Seppi A. ,51,2,1,1,8.33,1,1,0,0,0.5,0.5,
Serdarusic N.,308,5,1,4,3.84125,0,1,1,3,0.2,0.0,0.25
Sergeyev I.,209,2,1,1,8.0,0,0,1,1,0.5,,0.5
Serra F.,450,289,122,167,2.939715453628497,18,36,104,131,0.42214532871972316,0.3333333333333333,0.4425531914893617
Serra F. ,71,2,1,1,3.7,1,1,0,0,0.5,0.5,
Setkic A.,165,3,0,3,,0,1,0,2,0.0,0.0,0.0
Settergren J.,383,1,0,1,,0,1,0,0,0.0,0.0,
Seyboth Wild T.,113,13,7,6,3.1533333333333333,6,2,1,4,0.5384615384615384,0.75,0.2
Shane R.,1410,1,0,1,,0,0,0,1,0.0,,0.0
Shapovalov D.,12,168,92,76,2.211659038901602,20,20,72,56,0.5476190476190477,0.5,0.5625
Sherwood D.,261,2,1,1,4.25,0,0,1,1,0.5,,0.5
Shi B.,0,1,0,1,,0,1,0,0,0.0,0.0,
Shyla Y.,366,1,0,1,,0,1,0,0,0.0,0.0,
Si Y.M.,0,1,0,1,,0,1,0,0,0.0,0.0,
Sidorenko A.,255,13,4,9,3.5175,2,4,2,5,0.3076923076923077,0.3333333333333333,0.2857142857142857
Sijsling I.,114,133,47,86,2.8353554443053817,21,22,26,64,0.3533834586466165,0.4883720930232558,0.28888888888888886
Silva D.,263,1,0,1,,0,0,0,1,0.0,,0.0
Silva F.,249,2,0,2,,0,0,0,2,0.0,,0.0
Silva F.F.,263,3,1,2,3.725,0,0,1,2,0.3333333333333333,,0.3333333333333333
Silva J.,228,7,1,6,,0,0,1,6,0.14285714285714285,,0.14285714285714285
Simmonds P.,428,3,0,3,,0,0,0,3,0.0,,0.0
Simon G.,62,833,479,354,2.299646198830409,129,87,350,267,0.575030012004802,0.5972222222222222,0.5672609400324149
Simon G. ,12,3,2,1,1.445,2,1,0,0,0.6666666666666666,0.6666666666666666,
Simonsson F.,674,1,0,1,,0,0,0,1,0.0,,0.0
Singh N.,817,1,0,1,,0,1,0,0,0.0,0.0,
Singh S.,373,1,0,1,,0,1,0,0,0.0,0.0,
Sinner J.,44,47,27,20,2.3158333333333334,16,8,11,12,0.574468085106383,0.6666666666666666,0.4782608695652174
Sirianni J.,254,17,6,11,3.2150757575757574,0,0,6,11,0.35294117647058826,,0.35294117647058826
Siriluethaiwattana P.,1194,2,0,2,,0,2,0,0,0.0,0.0,
Sitak A.,0,2,0,2,,0,0,0,2,0.0,,0.0
Skatov T.,438,1,0,1,,0,1,0,0,0.0,0.0,
Skoch D.,0,3,0,3,,0,0,0,3,0.0,,0.0
Skugor F.,351,27,7,20,3.166642857142857,0,3,7,17,0.25925925925925924,0.0,0.2916666666666667
Slabinsky A.,558,2,0,2,,0,0,0,2,0.0,,0.0
Slanar M.,232,3,1,2,4.5125,0,0,1,2,0.3333333333333333,,0.3333333333333333
Sluiter R.,866,96,39,57,2.7156606060606063,6,12,33,45,0.40625,0.3333333333333333,0.4230769230769231
Smeets R.,168,9,1,8,4.692857142857143,0,1,1,7,0.1111111111111111,0.0,0.125
Smethurst D.,234,1,0,1,,0,0,0,1,0.0,,0.0
Smit J.,711,1,0,1,,0,1,0,0,0.0,0.0,
Smith A.,0,1,0,1,,0,0,0,1,0.0,,0.0
Smith J.P.,308,25,5,20,2.8363157894736846,0,1,5,19,0.2,0.0,0.20833333333333334
Smyczek T.,281,128,43,85,3.056138166894665,5,8,38,77,0.3359375,0.38461538461538464,0.33043478260869563
Snobel P.,184,3,0,3,,0,1,0,2,0.0,0.0,0.0
Sock J.,310,290,162,128,2.3898500192901233,36,22,126,106,0.5586206896551724,0.6206896551724138,0.5431034482758621
Soderling R.,5,427,273,154,2.1152942998760844,99,38,174,116,0.639344262295082,0.7226277372262774,0.6
Soderlund C.,479,2,1,1,5.18,0,0,1,1,0.5,,0.5
Soeda G.,119,105,29,76,4.060342497670083,7,13,22,63,0.2761904761904762,0.35,0.25882352941176473
Sonego L.,32,81,37,44,2.759981572481572,7,6,30,38,0.4567901234567901,0.5384615384615384,0.4411764705882353
Sorensen L.,236,6,2,4,3.8674999999999997,0,0,2,4,0.3333333333333333,,0.3333333333333333
Sousa J.,77,380,172,208,3.2994736842105263,42,38,130,170,0.45263157894736844,0.525,0.43333333333333335
Sousa P.,110,25,7,18,3.44718487394958,0,2,7,16,0.28,0.0,0.30434782608695654
Souza J.,131,72,25,47,3.614277482269504,6,6,19,41,0.3472222222222222,0.5,0.31666666666666665
Spadea V.,361,250,118,132,2.440582315340909,19,27,99,105,0.472,0.41304347826086957,0.4852941176470588
Squillari F.,135,19,10,9,2.5066875,0,0,10,9,0.5263157894736842,,0.5263157894736842
Srichaphan P.,83,195,102,93,2.269010710194731,25,19,77,74,0.5230769230769231,0.5681818181818182,0.5099337748344371
Stadler S.,288,16,6,10,3.8275,2,2,4,8,0.375,0.5,0.3333333333333333
Stakhovsky S.,153,336,144,192,3.167959970348406,46,51,98,141,0.42857142857142855,0.4742268041237113,0.4100418410041841
Starace P.,176,333,146,187,2.8836261909391405,12,24,134,163,0.43843843843843844,0.3333333333333333,0.4511784511784512
Statham J.,360,8,2,6,5.410833333333333,0,0,2,6,0.25,,0.25
Statham R.,557,1,0,1,,0,0,0,1,0.0,,0.0
Stebe C-M.,177,2,1,1,3.415,0,0,1,1,0.5,,0.5
Stebe C.M.,147,69,26,43,3.7883765652951698,3,6,23,37,0.37681159420289856,0.3333333333333333,0.38333333333333336
Steckley R.,583,1,0,1,,0,0,0,1,0.0,,0.0
Stepanek M.,25,2,1,1,1.88,0,0,1,1,0.5,,0.5
Stepanek R.,102,558,319,239,2.652736570011189,82,47,237,192,0.5716845878136201,0.6356589147286822,0.5524475524475524
Stepanek R. ,14,4,3,1,3.0216666666666665,3,1,0,0,0.75,0.75,
Stoliarov A.,361,1,0,1,,0,1,0,0,0.0,0.0,
Stoppini A.,209,11,3,8,5.916666666666666,0,1,3,7,0.2727272727272727,0.0,0.3
Strode B.,393,1,0,1,,0,1,0,0,0.0,0.0,
Struff J-L.,106,1,0,1,,0,0,0,1,0.0,,0.0
Struff J.L.,36,282,129,153,2.614046967624259,35,34,94,119,0.4574468085106383,0.5072463768115942,0.4413145539906103
Struvay E.,336,2,0,2,,0,0,0,2,0.0,,0.0
Sugita Y.,100,122,45,77,3.081987012987013,6,12,39,65,0.36885245901639346,0.3333333333333333,0.375
Sultan-Khalfan A.,1497,1,0,1,,0,0,0,1,0.0,,0.0
Summerer T.,219,9,1,8,,0,1,1,7,0.1111111111111111,0.0,0.125
Sun P.,557,5,1,4,,0,0,1,4,0.2,,0.2
Suzuki T.,355,17,8,9,5.265694444444444,0,0,8,9,0.47058823529411764,,0.47058823529411764
Svajda Z.,1415,1,0,1,,0,0,0,1,0.0,,0.0
Sweeting R.,156,89,33,56,3.4786383928571425,1,9,32,47,0.3707865168539326,0.1,0.4050632911392405
Tabara M.,111,21,7,14,3.49125,1,1,6,13,0.3333333333333333,0.5,0.3157894736842105
Taberner C.,175,6,2,4,3.38125,1,2,1,2,0.3333333333333333,0.3333333333333333,0.3333333333333333
Tabilo A.,166,4,2,2,3.79,1,1,1,1,0.5,0.5,0.5
Tahiri M.,566,4,1,3,4.875,0,0,1,3,0.25,,0.25
Taino E.,255,4,1,3,2.263333333333333,0,1,1,2,0.25,0.0,0.3333333333333333
Takahashi Y.,262,1,0,1,,0,0,0,1,0.0,,0.0
Takeuchi K.,441,1,0,1,,0,1,0,0,0.0,0.0,
Tavares L.,246,3,1,2,3.75,0,0,1,2,0.3333333333333333,,0.3333333333333333
Tearney F.,447,2,0,2,,0,0,0,2,0.0,,0.0
Tecau H.,352,1,0,1,,0,0,0,1,0.0,,0.0
Teixeira M.,340,6,1,5,4.397,0,2,1,3,0.16666666666666666,0.0,0.25
Tenconi T.,147,1,0,1,,0,0,0,1,0.0,,0.0
Tepavac M.,201,1,0,1,,0,1,0,0,0.0,0.0,
Terachi T.,411,5,2,3,3.966666666666667,0,0,2,3,0.4,,0.4
Thiem D.,3,438,288,150,2.1006020833333334,44,33,244,117,0.6575342465753424,0.5714285714285714,0.6759002770083102
Thiem D. ,5,5,3,2,2.548333333333334,3,2,0,0,0.6,0.6,
Thomann N.,266,10,2,8,,1,4,1,4,0.2,0.2,0.2
Thompson C.,2159,1,0,1,,0,0,0,1,0.0,,0.0
Thompson J.,61,121,50,71,2.6077421672894507,7,7,43,64,0.4132231404958678,0.5,0.40186915887850466
Thron A.,901,2,0,2,,0,1,0,1,0.0,0.0,0.0
Tiafoe F.,64,153,66,87,2.6318312434691746,11,14,55,73,0.43137254901960786,0.44,0.4296875
Tipsarevic J.,251,481,243,238,2.367034664830119,52,49,191,189,0.5051975051975052,0.5148514851485149,0.5026315789473684
Tipsarevic J. ,39,2,1,1,2.14,1,1,0,0,0.5,0.5,
Tomic B.,197,347,168,179,2.6262890728917263,13,23,155,156,0.484149855907781,0.3611111111111111,0.4983922829581994
Topic J.,605,1,0,1,,0,0,0,1,0.0,,0.0
Torebko P.,384,2,0,2,,0,0,0,2,0.0,,0.0
Torpegaard M.,179,1,0,1,,0,0,0,1,0.0,,0.0
Travaglia S.,74,40,13,27,3.02735754985755,2,9,11,18,0.325,0.18181818181818182,0.3793103448275862
Trevisan M.,462,1,0,1,,0,0,0,1,0.0,,0.0
Trinker B.,417,3,1,2,6.75,0,0,1,2,0.3333333333333333,,0.3333333333333333
Troicki V.,196,520,268,252,2.635522784019975,61,51,207,201,0.5153846153846153,0.5446428571428571,0.5073529411764706
Troicki V. ,29,2,1,1,2.575,1,1,0,0,0.5,0.5,
Trongcharoenchaikul W.,1217,1,0,1,,0,1,0,0,0.0,0.0,
Trujillo G.,237,2,1,1,7.55,0,0,1,1,0.5,,0.5
Trungelliti M.,202,27,12,15,3.388151515151515,2,1,10,14,0.4444444444444444,0.6666666666666666,0.4166666666666667
Trusendi W.,386,1,0,1,,0,0,0,1,0.0,,0.0
Tseng C.H.,426,2,0,2,,0,0,0,2,0.0,,0.0
Tsitsipas S.,6,195,122,73,2.0699926412317446,26,18,96,55,0.6256410256410256,0.5909090909090909,0.6357615894039735
Tsitsipas S. ,6,5,4,1,2.6875,4,1,0,0,0.8,0.8,
Tsonga J.W.,33,654,441,213,1.979109656318812,136,57,305,156,0.6743119266055045,0.7046632124352331,0.6616052060737527
Tsonga J.W. ,9,1,0,1,,0,1,0,0,0.0,0.0,
Tuksar S.,166,5,0,5,,0,1,0,4,0.0,0.0,0.0
Tursunov D.,645,429,218,211,2.6261244693038615,55,41,163,170,0.5081585081585082,0.5729166666666666,0.4894894894894895
Tveit E.,925,1,0,1,,0,0,0,1,0.0,,0.0
Tyurnev E.,548,1,0,1,,0,1,0,0,0.0,0.0,
Uchiyama Y.,95,19,6,13,3.2801282051282055,0,2,6,11,0.3157894736842105,0.0,0.35294117647058826
Udomchoke D.,145,64,15,49,3.121100303951368,3,10,12,39,0.234375,0.23076923076923078,0.23529411764705882
Uebel L.,288,1,0,1,,0,0,0,1,0.0,,0.0
Ulihrach B.,145,43,13,30,3.2249886363636366,3,5,10,25,0.3023255813953488,0.375,0.2857142857142857
Ungur A.,203,33,6,27,5.313425925925925,0,1,6,26,0.18181818181818182,0.0,0.1875
Uppal V.,526,1,0,1,,0,0,0,1,0.0,,0.0
Urban F.,560,1,0,1,,0,0,0,1,0.0,,0.0
Vacek J.,342,23,7,16,3.354702380952381,0,0,7,16,0.30434782608695654,,0.30434782608695654
Vagnozzi S.,192,11,4,7,4.033333333333333,0,0,4,7,0.36363636363636365,,0.36363636363636365
Vahaly B.,164,16,3,13,2.6753333333333336,0,2,3,11,0.1875,0.0,0.21428571428571427
Vaisse M.,309,1,0,1,,0,0,0,1,0.0,,0.0
Valent R.,1088,1,0,1,,0,1,0,0,0.0,0.0,
Valkusz M.,323,1,0,1,,0,0,0,1,0.0,,0.0
Van D. Merwe I.,118,1,0,1,,0,1,0,0,0.0,0.0,
Van Der Merwe I.,155,10,6,4,3.0408333333333335,0,1,6,3,0.6,0.0,0.6666666666666666
Van Rijthoven T.,344,1,0,1,,0,0,0,1,0.0,,0.0
Van der Dium A.,995,1,0,1,,0,1,0,0,0.0,0.0,
Van der Merwe I.,286,3,1,2,2.425,0,0,1,2,0.3333333333333333,,0.3333333333333333
Vanek J.,155,106,35,71,3.379643270944742,3,10,32,61,0.330188679245283,0.23076923076923078,0.34408602150537637
Vanni L.,163,23,5,18,3.51764705882353,3,6,2,12,0.21739130434782608,0.3333333333333333,0.14285714285714285
Vardhan V.,313,2,0,2,,0,0,0,2,0.0,,0.0
Varillas J.P.,146,2,1,1,2.525,1,1,0,0,0.5,0.5,
Vasilevski A.,785,1,0,1,,0,1,0,0,0.0,0.0,
Vassallo-Arguello M.,102,121,46,75,3.1579785531370037,1,3,45,72,0.38016528925619836,0.25,0.38461538461538464
Vassallo-Arguello M. ,72,1,0,1,,0,1,0,0,0.0,0.0,
Vatutin A.,197,6,2,4,2.80875,0,1,2,3,0.3333333333333333,0.0,0.4
Vega Hernandez D.,440,1,0,1,,0,0,0,1,0.0,,0.0
Veger F.,836,1,0,1,,0,1,0,0,0.0,0.0,
Veic A.,228,32,10,22,4.394272727272727,2,6,8,16,0.3125,0.25,0.3333333333333333
Velotti A.,184,4,0,4,,0,0,0,4,0.0,,0.0
Vemic D.,178,18,8,10,3.1470000000000002,0,1,8,9,0.4444444444444444,0.0,0.47058823529411764
Ventura S.,139,97,38,59,2.8086339285714286,0,0,38,59,0.3917525773195876,,0.3917525773195876
Venus M.,0,11,1,10,5.3365,0,0,1,10,0.09090909090909091,,0.09090909090909091
Verdasco F.,61,931,530,401,2.1800966705886853,78,76,452,325,0.569280343716434,0.5064935064935064,0.5817245817245817
Verdasco F. ,8,4,3,1,1.7966666666666669,3,1,0,0,0.75,0.75,
Verdasco M.,53,2,1,1,1.79,0,0,1,1,0.5,,0.5
Verkerk M.,270,50,23,27,2.4057827272727272,2,3,21,24,0.46,0.4,0.4666666666666667
Veronelli D.,172,1,0,1,,0,0,0,1,0.0,,0.0
Vesely J.,66,240,111,129,2.387088442565187,5,16,106,113,0.4625,0.23809523809523808,0.4840182648401826
Vicente F.,268,45,12,33,2.886894265232975,0,1,12,32,0.26666666666666666,0.0,0.2727272727272727
Vicente M.,188,1,0,1,,0,0,0,1,0.0,,0.0
Vico U.,254,7,2,5,,1,2,1,3,0.2857142857142857,0.3333333333333333,0.25
Vik R.,378,54,19,35,3.310248161764706,4,8,15,27,0.35185185185185186,0.3333333333333333,0.35714285714285715
Vilella Martinez M.,196,1,0,1,,0,0,0,1,0.0,,0.0
Vinciguerra A.,572,16,6,10,3.5944444444444446,1,3,5,7,0.375,0.25,0.4166666666666667
Viola M.,218,15,4,11,3.7498863636363633,2,4,2,7,0.26666666666666666,0.3333333333333333,0.2222222222222222
Viola Mat.,148,2,0,2,,0,1,0,1,0.0,0.0,0.0
Vliegen K.,307,184,78,106,2.8080965489989462,19,21,59,85,0.42391304347826086,0.475,0.4097222222222222
Volandri F.,226,344,149,195,2.889173994118913,9,21,140,174,0.4331395348837209,0.3,0.445859872611465
Voltchkov V.,182,7,2,5,2.63905,1,1,1,4,0.2857142857142857,0.5,0.2
Vovk S.,1216,1,0,1,,0,1,0,0,0.0,0.0,
Vukic A.,193,2,0,2,,0,0,0,2,0.0,,0.0
Wachiramanowong K.,523,3,0,3,,0,3,0,0,0.0,0.0,
Wagh A.,0,1,0,1,,0,1,0,0,0.0,0.0,
Walter L.,287,1,0,1,,0,0,0,1,0.0,,0.0
Wang C.,553,2,1,1,9.0,0,0,1,1,0.5,,0.5
Wang J.,118,21,8,13,3.2606730769230765,1,1,7,12,0.38095238095238093,0.5,0.3684210526315789
Wang Y.,88,3,0,3,,0,0,0,3,0.0,,0.0
Wang Y. Jr,401,2,1,1,,0,0,1,1,0.5,,0.5
Wang Y.Jr.,484,1,0,1,,0,0,0,1,0.0,,0.0
Wang Y.T.,164,40,14,26,3.7534027777777776,5,7,9,19,0.35,0.4166666666666667,0.32142857142857145
Warburg S.,169,15,5,10,3.8320000000000003,2,4,3,6,0.3333333333333333,0.3333333333333333,0.3333333333333333
Ward A.,869,4,0,4,,0,0,0,4,0.0,,0.0
Ward J.,195,64,15,49,3.60675,1,2,14,47,0.234375,0.3333333333333333,0.22950819672131148
Washington M.,864,1,0,1,,0,0,0,1,0.0,,0.0
Waske A.,139,60,21,39,2.8128364153627317,3,5,18,34,0.35,0.375,0.34615384615384615
Wassen R.,542,2,1,1,,1,1,0,0,0.5,0.5,
Watanuki Y.,181,4,1,3,3.1849999999999996,0,0,1,3,0.25,,0.25
Wawrinka S.,20,795,506,289,2.202808943089431,75,61,431,228,0.6364779874213836,0.5514705882352942,0.65402124430956
Wawrinka S. ,21,3,2,1,2.985,2,1,0,0,0.6666666666666666,0.6666666666666666,
Weiner G.,230,21,7,14,2.616185897435898,0,2,7,12,0.3333333333333333,0.0,0.3684210526315789
Weintraub A.,0,6,1,5,4.022,0,0,1,5,0.16666666666666666,,0.16666666666666666
Wessels L.,0,2,1,1,9.5,0,0,1,1,0.5,,0.5
Wessels P.,200,30,12,18,2.9228529411764708,0,5,12,13,0.4,0.0,0.48
Westerhof B.,236,1,0,1,,0,0,0,1,0.0,,0.0
Whitehouse W.,373,10,4,6,3.222,0,0,4,6,0.4,,0.4
Whittington A.,210,5,2,3,3.5875000000000004,0,0,2,3,0.4,,0.4
Widom T.,232,10,5,5,3.8833333333333333,2,1,3,4,0.5,0.6666666666666666,0.42857142857142855
Williams R.,220,25,7,18,3.6675,1,1,6,17,0.28,0.5,0.2608695652173913
Willis M.,772,2,1,1,14.875,0,0,1,1,0.5,,0.5
Wilson B.,249,5,1,4,,1,2,0,2,0.2,0.3333333333333333,0.0
Witten J.,186,10,2,8,5.2275,0,2,2,6,0.2,0.0,0.25
Wolf J.J.,123,5,2,3,3.3208333333333333,0,1,2,2,0.4,0.0,0.5
Wolmarans F.,261,3,1,2,2.0425,0,0,1,2,0.3333333333333333,,0.3333333333333333
Wu D.,339,24,4,20,5.29425,0,0,4,20,0.16666666666666666,,0.16666666666666666
Wu Y.,415,7,1,6,2.4783333333333335,0,0,1,6,0.14285714285714285,,0.14285714285714285
Xu J.C.,594,1,0,1,,0,0,0,1,0.0,,0.0
Yang T.H.,249,4,0,4,,0,1,0,3,0.0,0.0,0.0
Yani M.,238,17,4,13,4.1431818181818185,1,2,3,11,0.23529411764705882,0.3333333333333333,0.21428571428571427
Ymer E.,123,46,11,35,3.079545454545454,2,7,9,28,0.2391304347826087,0.2222222222222222,0.24324324324324326
Ymer M.,80,31,10,21,3.4189285714285713,4,7,6,14,0.3225806451612903,0.36363636363636365,0.3
Yoo D.,0,1,0,1,,0,0,0,1,0.0,,0.0
Young D.,195,311,125,186,3.0377801092896175,22,28,103,158,0.40192926045016075,0.44,0.3946360153256705
Youzhny A.,18,1,0,1,,0,1,0,0,0.0,0.0,
Youzhny M.,110,718,390,328,2.287147573898494,108,65,282,263,0.5431754874651811,0.6242774566473989,0.5174311926605505
Youzhny M. ,23,5,4,1,3.02125,4,1,0,0,0.8,0.8,
Yu X.Y.,515,2,0,2,,0,0,0,2,0.0,,0.0
Yuksel A.,507,1,0,1,,0,0,0,1,0.0,,0.0
Zabaleta M.,118,114,58,56,2.130133267195767,1,3,57,53,0.5087719298245614,0.25,0.5181818181818182
Zampieri C.,316,3,1,2,3.4375,0,0,1,2,0.3333333333333333,,0.3333333333333333
Zapata Miralles B.,235,4,1,3,3.1033333333333335,0,0,1,3,0.25,,0.25
Zayed M. S.,1855,1,0,1,,0,0,0,1,0.0,,0.0
Zayed M.S.,0,1,0,1,,0,0,0,1,0.0,,0.0
Zayid M. S.,1512,1,0,1,,0,0,0,1,0.0,,0.0
Zayid M.S.,0,2,0,2,,0,0,0,2,0.0,,0.0
Zeballos H.,149,217,87,130,3.107203041144902,12,17,75,113,0.4009216589861751,0.41379310344827586,0.39893617021276595
Zeballos H. ,42,1,0,1,,0,1,0,0,0.0,0.0,
Zekic M.,316,3,1,2,5.725,0,0,1,2,0.3333333333333333,,0.3333333333333333
Zemlja G.,151,64,28,36,3.9875357142857144,8,7,20,29,0.4375,0.5333333333333333,0.40816326530612246
Zeng S.X.,393,5,1,4,6.88375,0,0,1,4,0.2,,0.2
Zeppieri G.,317,1,0,1,,0,0,0,1,0.0,,0.0
Zhang Z.,187,15,4,11,6.704545454545454,0,0,4,11,0.26666666666666666,,0.26666666666666666
Zhang Ze,216,11,1,10,5.4185,0,0,1,10,0.09090909090909091,,0.09090909090909091
Zhang Ze.,179,2,0,2,,0,0,0,2,0.0,,0.0
Zhang Zh.,179,11,5,6,4.583333333333334,0,0,5,6,0.45454545454545453,,0.45454545454545453
Zhu B.Q.,646,3,1,2,3.915,0,0,1,2,0.3333333333333333,,0.3333333333333333
Ziadi M.,757,5,0,5,,0,0,0,5,0.0,,0.0
Zib T.,292,88,28,60,3.160857279693487,2,10,26,50,0.3181818181818182,0.16666666666666666,0.34210526315789475
Zimonjic N.,520,7,2,5,,0,1,2,4,0.2857142857142857,0.0,0.3333333333333333
Zitko R.,487,1,0,1,,0,0,0,1,0.0,,0.0
Zlatanovic A.,1421,1,0,1,,0,0,0,1,0.0,,0.0
Zopp J.,133,47,16,31,3.862862903225807,5,10,11,21,0.3404255319148936,0.3333333333333333,0.34375
Zovko L.,769,5,2,3,4.0925,1,2,1,1,0.4,0.3333333333333333,0.5
Zverev A.,7,353,238,115,2.033375894331315,45,25,193,90,0.6742209631728046,0.6428571428571429,0.6819787985865724
Zverev A. ,7,4,2,2,2.175,2,2,0,0,0.5,0.5,
Zverev M.,268,332,134,198,2.946083928094348,40,45,94,153,0.4036144578313253,0.47058823529411764,0.3805668016194332
de Chaunac S.,312,19,5,14,3.673741666666667,3,5,2,9,0.2631578947368421,0.375,0.18181818181818182
de Voest R.,135,25,10,15,3.4460583333333332,4,5,6,10,0.4,0.4444444444444444,0.375
di Mauro A.,135,48,14,34,3.216263221153846,0,1,14,33,0.2916666666666667,0.0,0.2978723404255319
di Pasquale A.,228,12,3,9,2.7195,0,0,3,9,0.25,,0.25
van Gemerden M.,106,10,4,6,3.455,0,0,4,6,0.4,,0.4
van Lottum J.,493,17,3,14,2.726,1,1,2,13,0.17647058823529413,0.5,0.13333333333333333
van Scheppingen D.,278,27,8,19,2.984394736842105,3,4,5,15,0.2962962962962963,0.42857142857142855,0.25
van der Meer N.,620,1,0,1,,0,0,0,1,0.0,,0.0
