player1_name,player1_atprank,player1_games,player1_wins,player1_loses,player2_name,player2_atprank,player2_games,player2_wins,player2_loses,match_date,match_location,match_tournament,match_surface,match_odd_player1,match_odd_player2,winner_player1
Harrison R.,481,272,117,155,Mager G.,67,59,24,35,2021-01-07,Delray Beach,Delray Beach Open,Hard,1.72,2.0,0
Korda S.,26,126,75,51,Kwon S.W.,68,108,53,55,2021-01-07,Delray Beach,Delray Beach Open,Hard,1.72,2.0,1
Paul T.,14,204,111,93,Nam J.S.,590,3,0,3,2021-01-07,Delray Beach,Delray Beach Open,Hard,1.12,6.0,1
Kecmanovic M.,40,210,107,103,Travaglia S.,1024,81,27,54,2021-01-07,Antalya,Antalya Open,Hard,1.44,2.62,0
Bellucci T.,915,380,179,201,Monteiro T.,121,171,69,102,2021-01-07,Delray Beach,Delray Beach Open,Hard,3.0,1.36,0
Bublik A.,25,219,110,109,Caruso S.,146,63,19,44,2021-01-07,Antalya,Antalya Open,Hard,1.61,2.2,1
Arnaboldi A.,267,14,4,10,Basilashvili N.,118,301,138,163,2021-01-07,Antalya,Antalya Open,Hard,2.5,1.5,0
Zuk K.,172,3,0,3,Celikbilek A.,230,9,4,5,2021-01-07,Antalya,Antalya Open,Hard,1.5,2.5,0
Ruusuvuori E.,55,158,79,79,Vesely J.,528,288,130,158,2021-01-07,Antalya,Antalya Open,Hard,1.5,2.5,1
Goffin D.,123,522,296,226,Herbert P.H.,157,202,89,113,2021-01-07,Antalya,Antalya Open,Hard,1.4,2.75,1
Querrey S.,287,678,369,309,Mcdonald M.,60,190,87,103,2021-01-08,Delray Beach,Delray Beach Open,Hard,1.8,1.9,1
Harrison C.,251,15,6,9,Etcheverry T.,34,60,26,34,2021-01-08,Delray Beach,Delray Beach Open,Hard,1.33,3.25,1
Martin A.,723,258,107,151,Galan D.E.,76,78,33,45,2021-01-08,Delray Beach,Delray Beach Open,Hard,2.75,1.4,0
Quiroz R.,293,6,3,3,Rubin N.,306,29,8,21,2021-01-08,Delray Beach,Delray Beach Open,Hard,2.0,1.72,1
Fratangelo B.,695,62,22,40,King K.,304,7,1,6,2021-01-08,Delray Beach,Delray Beach Open,Hard,1.5,2.5,1
Aragone J.C.,299,1,0,1,Norrie C.,13,287,172,115,2021-01-08,Delray Beach,Delray Beach Open,Hard,4.33,1.2,0
Karlovic I.,221,674,351,323,Andujar P.,323,404,164,240,2021-01-08,Delray Beach,Delray Beach Open,Hard,2.62,1.44,1
Albot R.,97,215,86,129,Chardy J.,542,591,289,302,2021-01-08,Antalya,Antalya Open,Hard,1.72,2.0,0
Djere L.,38,243,120,123,Kuzmanov D.,207,12,4,8,2021-01-08,Antalya,Antalya Open,Hard,1.44,2.62,0
Fognini F.,128,742,383,359,Vrbensky M.,311,1,0,1,2021-01-08,Antalya,Antalya Open,Hard,1.4,2.75,1
Kuhn N.,259,12,3,9,Bachinger M.,279,86,31,55,2021-01-08,Antalya,Antalya Open,Hard,2.25,1.57,1
De Minaur A.,19,272,161,111,Jaziri M.,444,217,83,134,2021-01-08,Antalya,Antalya Open,Hard,1.04,13.0,1
Berrettini M.,38,217,142,75,Kirkin E.,446,2,0,2,2021-01-08,Antalya,Antalya Open,Hard,1.03,15.0,1
Molcan A.,120,86,45,41,Grenier H.,122,16,5,11,2021-01-08,Antalya,Antalya Open,Hard,1.9,1.8,0
Ilhan M.,571,74,20,54,Andreev A.,319,8,2,6,2021-01-08,Antalya,Antalya Open,Hard,4.33,1.2,0
Gerasimov E.,150,93,43,50,Lamasine T.,271,9,3,6,2021-01-08,Antalya,Antalya Open,Hard,1.16,5.0,0
Struff J.L.,21,369,170,199,Kotov P.,89,25,10,15,2021-01-08,Antalya,Antalya Open,Hard,1.22,4.0,1
Tiafoe F.,10,303,158,145,Young D.,327,312,125,187,2021-01-09,Delray Beach,Delray Beach Open,Hard,1.22,4.0,1
Garin C.,101,190,103,87,Harrison C.,251,15,6,9,2021-01-09,Delray Beach,Delray Beach Open,Hard,1.44,2.62,0
Mager G.,67,59,24,35,Querrey S.,287,678,369,309,2021-01-09,Delray Beach,Delray Beach Open,Hard,4.0,1.22,1
Kuhn N.,259,12,3,9,Goffin D.,123,522,296,226,2021-01-09,Antalya,Antalya Open,Hard,6.5,1.11,0
Korda S.,26,126,75,51,Paul T.,14,204,111,93,2021-01-09,Delray Beach,Delray Beach Open,Hard,2.37,1.53,1
Ruusuvuori E.,55,158,79,79,Travaglia S.,1024,81,27,54,2021-01-09,Antalya,Antalya Open,Hard,1.44,2.62,0
Celikbilek A.,230,9,4,5,Basilashvili N.,118,301,138,163,2021-01-09,Antalya,Antalya Open,Hard,2.75,1.4,0
De Minaur A.,19,272,161,111,Andreev A.,319,8,2,6,2021-01-09,Antalya,Antalya Open,Hard,1.08,8.0,1
Tiafoe F.,10,303,158,145,Fratangelo B.,695,62,22,40,2021-01-10,Delray Beach,Delray Beach Open,Hard,1.3,3.4,1
Quiroz R.,293,6,3,3,Karlovic I.,221,674,351,323,2021-01-10,Delray Beach,Delray Beach Open,Hard,2.1,1.66,1
Berrettini M.,38,217,142,75,Kuzmanov D.,207,12,4,8,2021-01-10,Antalya,Antalya Open,Hard,1.07,9.0,1
Grenier H.,122,16,5,11,Struff J.L.,21,369,170,199,2021-01-10,Antalya,Antalya Open,Hard,4.5,1.18,0
Lamasine T.,271,9,3,6,Bublik A.,25,219,110,109,2021-01-10,Antalya,Antalya Open,Hard,4.5,1.18,0
Fognini F.,128,742,383,359,Chardy J.,542,591,289,302,2021-01-10,Antalya,Antalya Open,Hard,1.61,2.2,0
Galan D.E.,76,78,33,45,Hurkacz H.,17,238,137,101,2021-01-10,Delray Beach,Delray Beach Open,Hard,3.0,1.36,0
Isner J.,114,755,465,290,Monteiro T.,121,171,69,102,2021-01-10,Delray Beach,Delray Beach Open,Hard,1.5,2.5,1
Norrie C.,13,287,172,115,Mannarino A.,27,567,264,303,2021-01-11,Delray Beach,Delray Beach Open,Hard,1.8,1.9,1
Mager G.,67,59,24,35,Harrison C.,251,15,6,9,2021-01-11,Delray Beach,Delray Beach Open,Hard,2.1,1.72,0
Quiroz R.,293,6,3,3,Hurkacz H.,17,238,137,101,2021-01-11,Delray Beach,Delray Beach Open,Hard,5.0,1.16,0
Isner J.,114,755,465,290,Korda S.,26,126,75,51,2021-01-11,Delray Beach,Delray Beach Open,Hard,1.72,2.1,0
Goffin D.,123,522,296,226,Travaglia S.,1024,81,27,54,2021-01-11,Antalya,Antalya Open,Hard,1.33,3.4,1
Basilashvili N.,118,301,138,163,De Minaur A.,19,272,161,111,2021-01-11,Antalya,Antalya Open,Hard,6.5,1.11,0
Berrettini M.,38,217,142,75,Bublik A.,25,219,110,109,2021-01-11,Antalya,Antalya Open,Hard,1.25,4.0,0
Chardy J.,542,591,289,302,Struff J.L.,21,369,170,199,2021-01-11,Antalya,Antalya Open,Hard,2.62,1.5,1
Chardy J.,542,591,289,302,Bublik A.,25,219,110,109,2021-01-12,Antalya,Antalya Open,Hard,3.0,1.4,0
De Minaur A.,19,272,161,111,Goffin D.,123,522,296,226,2021-01-12,Antalya,Antalya Open,Hard,1.53,2.5,1
Tiafoe F.,10,303,158,145,Norrie C.,13,287,172,115,2021-01-12,Delray Beach,Delray Beach Open,Hard,1.72,2.1,0
Harrison C.,251,15,6,9,Hurkacz H.,17,238,137,101,2021-01-12,Delray Beach,Delray Beach Open,Hard,3.2,1.36,0
Korda S.,26,126,75,51,Norrie C.,13,287,172,115,2021-01-13,Delray Beach,Delray Beach Open,Hard,1.66,2.2,1
Hurkacz H.,17,238,137,101,Korda S.,26,126,75,51,2021-01-13,Delray Beach,Delray Beach Open,Hard,1.8,2.0,1
De Minaur A.,19,272,161,111,Bublik A.,25,219,110,109,2021-01-13,Antalya,Antalya Open,Hard,1.2,4.5,1
Vukic A.,62,36,15,21,Lu Y.,625,11,1,10,2021-01-31,Melbourne,Great Ocean Road Open,Hard,1.16,5.0,1
Majchrzak K.,121,50,19,31,Djere L.,38,243,120,123,2021-01-31,Melbourne,Great Ocean Road Open,Hard,1.4,2.75,1
Uchiyama Y.,314,33,9,24,Bedene A.,347,291,131,160,2021-01-31,Melbourne,Great Ocean Road Open,Hard,2.75,1.4,0
Bourchier H.,324,2,1,1,Polmans M.,165,19,5,14,2021-02-01,Melbourne,Murray River Open,Hard,2.62,1.44,1
Chardy J.,542,591,289,302,Cilic M.,100,853,543,310,2021-02-01,Melbourne,Murray River Open,Hard,2.1,1.66,1
Berankis R.,212,249,104,145,Nagal S.,503,17,3,14,2021-02-01,Melbourne,Murray River Open,Hard,1.28,3.5,1
Bolt A.,345,40,13,27,Kokkinakis T.,86,124,55,69,2021-02-01,Melbourne,Murray River Open,Hard,3.25,1.33,1
Tiafoe F.,10,303,158,145,Moutet C.,80,118,50,68,2021-02-01,Melbourne,Murray River Open,Hard,1.36,3.0,0
Tu L.,252,5,1,4,Sousa P.,475,36,9,27,2021-02-01,Melbourne,Murray River Open,Hard,1.4,2.75,0
Ymer M.,59,130,58,72,Mannarino A.,27,567,264,303,2021-02-01,Melbourne,Murray River Open,Hard,2.75,1.4,0
Mcdonald M.,60,190,87,103,Gasquet R.,48,948,581,367,2021-02-01,Melbourne,Murray River Open,Hard,2.62,1.44,1
Coria F.,108,99,43,56,Albot R.,97,215,86,129,2021-02-01,Melbourne,Murray River Open,Hard,3.5,1.28,1
Sonego L.,43,221,107,114,Kubler J.,77,53,24,29,2021-02-01,Melbourne,Murray River Open,Hard,1.36,3.0,0
Cecchinato M.,108,204,79,125,Fucsovics M.,67,249,121,128,2021-02-01,Melbourne,Murray River Open,Hard,5.5,1.14,0
Harris L.,186,129,59,70,Gerasimov E.,150,93,43,50,2021-02-01,Melbourne,Murray River Open,Hard,1.9,1.8,0
Paul T.,14,204,111,93,Norrie C.,13,287,172,115,2021-02-01,Melbourne,Murray River Open,Hard,1.57,2.25,1
Ramos-Vinolas A.,82,437,204,233,Mott B.,481,2,0,2,2021-02-01,Melbourne,Murray River Open,Hard,1.36,3.0,1
O Connell C.,74,65,26,39,Koepfer D.,84,86,38,48,2021-02-01,Melbourne,Great Ocean Road Open,Hard,2.25,1.57,1
Gombos N.,114,66,21,45,Purcell M.,78,28,9,19,2021-02-01,Melbourne,Great Ocean Road Open,Hard,1.44,2.62,0
Martin A.,723,258,107,151,Kwon S.W.,68,108,53,55,2021-02-01,Melbourne,Great Ocean Road Open,Hard,3.75,1.25,0
Travaglia S.,1024,81,27,54,Carballes Baena R.,64,207,91,116,2021-02-01,Melbourne,Great Ocean Road Open,Hard,1.36,3.0,1
Anderson K.,652,598,347,251,Lopez F.,634,863,441,422,2021-02-01,Melbourne,Great Ocean Road Open,Hard,1.44,2.62,1
Seppi A.,141,758,363,395,Caruso S.,146,63,19,44,2021-02-01,Melbourne,Great Ocean Road Open,Hard,2.0,1.72,0
Torpegaard M.,188,4,1,3,Martinez P.,135,118,50,68,2021-02-02,Melbourne,Great Ocean Road Open,Hard,2.25,1.57,1
Daniel T.,111,178,67,111,Harris A.,232,3,1,2,2021-02-02,Melbourne,Murray River Open,Hard,1.33,3.25,0
Kyrgios N.,25,303,195,108,Muller A.,81,22,9,13,2021-02-02,Melbourne,Murray River Open,Hard,1.11,6.5,1
Ferreira Silva F.,185,2,0,2,Vesely J.,528,288,130,158,2021-02-02,Melbourne,Murray River Open,Hard,2.62,1.44,0
Halys Q.,79,72,23,49,Sugita Y.,131,129,47,82,2021-02-02,Melbourne,Murray River Open,Hard,1.57,2.25,0
Gojo B.,115,14,3,11,Popyrin A.,90,140,59,81,2021-02-02,Melbourne,Murray River Open,Hard,2.2,1.61,0
Kukushkin M.,221,352,141,211,Londero J.I.,142,83,34,49,2021-02-02,Melbourne,Murray River Open,Hard,1.44,2.62,1
Machac T.,108,18,6,12,Duckworth J.,123,143,55,88,2021-02-02,Melbourne,Murray River Open,Hard,1.53,2.37,0
Balazs A.,745,33,16,17,Alcaraz C.,1,164,130,34,2021-02-02,Melbourne,Great Ocean Road Open,Hard,4.0,1.22,0
Mager G.,67,59,24,35,Thompson J.,71,221,96,125,2021-02-02,Melbourne,Great Ocean Road Open,Hard,2.75,1.4,0
Ymer E.,186,81,24,57,Simon G.,188,869,491,378,2021-02-02,Melbourne,Murray River Open,Hard,3.0,1.36,0
Nam J.S.,590,3,0,3,Sweeny D.,797,2,1,1,2021-02-02,Melbourne,Great Ocean Road Open,Hard,1.57,2.25,0
Cuevas P.,149,421,210,211,Andujar P.,323,404,164,240,2021-02-02,Melbourne,Great Ocean Road Open,Hard,2.1,1.66,1
Herbert P.H.,157,202,89,113,Cressy M.,96,96,42,54,2021-02-02,Melbourne,Great Ocean Road Open,Hard,1.44,2.62,1
Smith J.P.,306,27,5,22,Sandgren T.,153,121,47,74,2021-02-02,Melbourne,Great Ocean Road Open,Hard,2.37,1.53,0
Mmoh M.,112,55,20,35,Giron M.,69,150,68,82,2021-02-02,Melbourne,Murray River Open,Hard,1.66,2.1,0
Querrey S.,287,678,369,309,Laaksonen H.,125,101,37,64,2021-02-02,Melbourne,Great Ocean Road Open,Hard,1.5,2.5,1
Troicki V.,230,525,269,256,Ruusuvuori E.,55,158,79,79,2021-02-02,Melbourne,Murray River Open,Hard,3.5,1.28,0
Gerasimov E.,150,93,43,50,Fucsovics M.,67,249,121,128,2021-02-02,Melbourne,Murray River Open,Hard,2.5,1.5,1
Giron M.,69,150,68,82,Mannarino A.,27,567,264,303,2021-02-02,Melbourne,Murray River Open,Hard,2.1,1.66,1
Sousa P.,475,36,9,27,Evans D.,30,251,124,127,2021-02-02,Melbourne,Murray River Open,Hard,5.5,1.14,0
Delbonis F.,131,340,152,188,Ebden M.,432,203,75,128,2021-02-02,Melbourne,Great Ocean Road Open,Hard,,,0
Vilella Martinez M.,167,10,4,6,Hanfmann Y.,50,99,50,49,2021-02-02,Melbourne,Great Ocean Road Open,Hard,2.37,1.53,1
Dellien H.,164,70,22,48,Stebe C.M.,231,76,28,48,2021-02-02,Melbourne,Great Ocean Road Open,Hard,4.33,1.2,0
Stakhovsky S.,200,339,145,194,Safiullin R.,92,42,20,22,2021-02-02,Melbourne,Great Ocean Road Open,Hard,3.0,1.36,1
Haase R.,257,458,202,256,Coppejans K.,188,11,0,11,2021-02-02,Melbourne,Great Ocean Road Open,Hard,1.57,2.25,1
Fancutt T.,562,1,0,1,Monteiro T.,121,171,69,102,2021-02-02,Melbourne,Great Ocean Road Open,Hard,5.5,1.14,0
Van De Zandschulp B.,44,117,63,54,Schoolkate T.,844,1,0,1,2021-02-02,Melbourne,Great Ocean Road Open,Hard,1.33,3.25,1
Kubler J.,77,53,24,29,Berankis R.,212,249,104,145,2021-02-02,Melbourne,Murray River Open,Hard,2.62,1.44,0
Moutet C.,80,118,50,68,Ramos-Vinolas A.,82,437,204,233,2021-02-03,Melbourne,Murray River Open,Hard,1.44,2.62,1
Harris A.,232,3,1,2,Dimitrov G.,20,651,389,262,2021-02-03,Melbourne,Murray River Open,Hard,5.5,1.14,0
Sugita Y.,131,129,47,82,Auger-Aliassime F.,12,268,163,105,2021-02-03,Melbourne,Murray River Open,Hard,5.0,1.16,0
Kyrgios N.,25,303,195,108,Bourchier H.,324,2,1,1,2021-02-03,Melbourne,Murray River Open,Hard,1.12,6.0,1
Coric B.,15,343,185,158,Ruusuvuori E.,55,158,79,79,2021-02-03,Melbourne,Murray River Open,Hard,1.66,2.1,1
Simon G.,188,869,491,378,Chardy J.,542,591,289,302,2021-02-03,Melbourne,Murray River Open,Hard,1.83,1.83,0
Duckworth J.,123,143,55,88,Humbert U.,36,170,80,90,2021-02-03,Melbourne,Murray River Open,Hard,3.25,1.33,1
Wawrinka S.,72,854,535,319,Kukushkin M.,221,352,141,211,2021-02-03,Melbourne,Murray River Open,Hard,1.3,3.4,1
Paul T.,14,204,111,93,Popyrin A.,90,140,59,81,2021-02-03,Melbourne,Murray River Open,Hard,1.4,2.75,0
Bolt A.,345,40,13,27,Mcdonald M.,60,190,87,103,2021-02-03,Melbourne,Murray River Open,Hard,3.0,1.36,1
Fritz T.,9,356,205,151,Coria F.,108,99,43,56,2021-02-03,Melbourne,Murray River Open,Hard,1.14,5.5,1
Vesely J.,528,288,130,158,Ruud C.,4,275,176,99,2021-02-03,Melbourne,Murray River Open,Hard,2.0,1.72,1
Stebe C.M.,231,76,28,48,Anderson K.,652,598,347,251,2021-02-03,Melbourne,Great Ocean Road Open,Hard,4.33,1.2,0
Van De Zandschulp B.,44,117,63,54,Majchrzak K.,121,50,19,31,2021-02-03,Melbourne,Great Ocean Road Open,Hard,2.0,1.72,1
Bedene A.,347,291,131,160,Sweeny D.,797,2,1,1,2021-02-03,Melbourne,Great Ocean Road Open,Hard,1.14,5.5,1
Torpegaard M.,188,4,1,3,Hurkacz H.,17,238,137,101,2021-02-03,Melbourne,Great Ocean Road Open,Hard,4.0,1.22,0
Kecmanovic M.,40,210,107,103,Kwon S.W.,68,108,53,55,2021-02-03,Melbourne,Great Ocean Road Open,Hard,1.53,2.37,1
Querrey S.,287,678,369,309,Travaglia S.,1024,81,27,54,2021-02-03,Melbourne,Great Ocean Road Open,Hard,1.66,2.1,0
Haase R.,257,458,202,256,Cuevas P.,149,421,210,211,2021-02-03,Melbourne,Great Ocean Road Open,Hard,1.61,2.2,0
Thompson J.,71,221,96,125,Herbert P.H.,157,202,89,113,2021-02-03,Melbourne,Great Ocean Road Open,Hard,1.57,2.25,1
Ebden M.,432,203,75,128,Monteiro T.,121,171,69,102,2021-02-03,Melbourne,Great Ocean Road Open,Hard,2.37,1.53,0
Opelka R.,17,168,88,80,Stakhovsky S.,200,339,145,194,2021-02-03,Melbourne,Great Ocean Road Open,Hard,1.33,3.25,1
Bublik A.,25,219,110,109,O Connell C.,74,65,26,39,2021-02-03,Melbourne,Great Ocean Road Open,Hard,1.5,2.5,1
Vilella Martinez M.,167,10,4,6,Basilashvili N.,118,301,138,163,2021-02-03,Melbourne,Great Ocean Road Open,Hard,2.25,1.57,1
Khachanov K.,11,378,217,161,Purcell M.,78,28,9,19,2021-02-03,Melbourne,Great Ocean Road Open,Hard,1.14,5.5,1
Goffin D.,123,522,296,226,Alcaraz C.,1,164,130,34,2021-02-03,Melbourne,Great Ocean Road Open,Hard,1.33,3.25,0
Caruso S.,146,63,19,44,Sandgren T.,153,121,47,74,2021-02-03,Melbourne,Great Ocean Road Open,Hard,1.8,1.9,1
Vukic A.,62,36,15,21,Sinner J.,8,224,153,71,2021-02-03,Melbourne,Great Ocean Road Open,Hard,5.5,1.14,0
Alcaraz C.,1,164,130,34,Monteiro T.,121,171,69,102,2021-02-04,Melbourne,Great Ocean Road Open,Hard,1.36,3.2,0
Anderson K.,652,598,347,251,Khachanov K.,11,378,217,161,2021-02-04,Melbourne,Great Ocean Road Open,Hard,1.61,2.3,0
Sinner J.,8,224,153,71,Bedene A.,347,291,131,160,2021-02-04,Melbourne,Great Ocean Road Open,Hard,1.25,4.0,1
Van De Zandschulp B.,44,117,63,54,Opelka R.,17,168,88,80,2021-02-04,Melbourne,Great Ocean Road Open,Hard,3.0,1.4,1
Caruso S.,146,63,19,44,Kecmanovic M.,40,210,107,103,2021-02-04,Melbourne,Great Ocean Road Open,Hard,2.75,1.44,0
Bublik A.,25,219,110,109,Travaglia S.,1024,81,27,54,2021-02-04,Melbourne,Great Ocean Road Open,Hard,1.66,2.2,0
Vilella Martinez M.,167,10,4,6,Thompson J.,71,221,96,125,2021-02-04,Melbourne,Great Ocean Road Open,Hard,3.5,1.3,0
Evans D.,30,251,124,127,Giron M.,69,150,68,82,2021-02-05,Melbourne,Murray River Open,Hard,1.53,2.5,1
Moutet C.,80,118,50,68,Duckworth J.,123,143,55,88,2021-02-05,Melbourne,Murray River Open,Hard,1.72,2.1,1
Berankis R.,212,249,104,145,Vesely J.,528,288,130,158,2021-02-05,Melbourne,Murray River Open,Hard,1.8,2.0,0
Bolt A.,345,40,13,27,Wawrinka S.,72,854,535,319,2021-02-05,Melbourne,Murray River Open,Hard,3.5,1.3,0
Auger-Aliassime F.,12,268,163,105,Gerasimov E.,150,93,43,50,2021-02-05,Melbourne,Murray River Open,Hard,1.36,3.2,1
Dimitrov G.,20,651,389,262,Popyrin A.,90,140,59,81,2021-02-05,Melbourne,Murray River Open,Hard,1.4,3.0,1
Coric B.,15,343,185,158,Evans D.,30,251,124,127,2021-02-05,Melbourne,Murray River Open,Hard,1.5,2.62,0
Fritz T.,9,356,205,151,Chardy J.,542,591,289,302,2021-02-05,Melbourne,Murray River Open,Hard,1.57,2.37,0
Kyrgios N.,25,303,195,108,Coric B.,15,343,185,158,2021-02-05,Melbourne,Murray River Open,Hard,2.1,1.72,0
Chardy J.,542,591,289,302,Wawrinka S.,72,854,535,319,2021-02-05,Melbourne,Murray River Open,Hard,1.9,1.9,1
Cuevas P.,149,421,210,211,Hurkacz H.,17,238,137,101,2021-02-05,Melbourne,Great Ocean Road Open,Hard,4.33,1.22,0
Thompson J.,71,221,96,125,Monteiro T.,121,171,69,102,2021-02-05,Melbourne,Great Ocean Road Open,Hard,1.44,2.75,0
Sinner J.,8,224,153,71,Kecmanovic M.,40,210,107,103,2021-02-05,Melbourne,Great Ocean Road Open,Hard,1.28,3.75,1
Khachanov K.,11,378,217,161,Van De Zandschulp B.,44,117,63,54,2021-02-05,Melbourne,Great Ocean Road Open,Hard,1.3,3.5,1
Travaglia S.,1024,81,27,54,Hurkacz H.,17,238,137,101,2021-02-05,Melbourne,Great Ocean Road Open,Hard,3.0,1.4,1
Dimitrov G.,20,651,389,262,Moutet C.,80,118,50,68,2021-02-05,Melbourne,Murray River Open,Hard,,,0
Vesely J.,528,288,130,158,Auger-Aliassime F.,12,268,163,105,2021-02-05,Melbourne,Murray River Open,Hard,2.62,1.5,0
Evans D.,30,251,124,127,Chardy J.,542,591,289,302,2021-02-06,Melbourne,Murray River Open,Hard,1.72,2.1,1
Moutet C.,80,118,50,68,Auger-Aliassime F.,12,268,163,105,2021-02-06,Melbourne,Murray River Open,Hard,3.0,1.4,0
Sinner J.,8,224,153,71,Khachanov K.,11,378,217,161,2021-02-06,Melbourne,Great Ocean Road Open,Hard,1.44,2.75,1
Travaglia S.,1024,81,27,54,Monteiro T.,121,171,69,102,2021-02-06,Melbourne,Great Ocean Road Open,Hard,1.72,2.1,1
Sinner J.,8,224,153,71,Travaglia S.,1024,81,27,54,2021-02-07,Melbourne,Great Ocean Road Open,Hard,1.25,4.0,1
Evans D.,30,251,124,127,Auger-Aliassime F.,12,268,163,105,2021-02-07,Melbourne,Murray River Open,Hard,2.2,1.66,1
Humbert U.,36,170,80,90,Uchiyama Y.,314,33,9,24,2021-02-08,Melbourne,Australian Open,Hard,1.14,5.5,1
Muller A.,81,22,9,13,Londero J.I.,142,83,34,49,2021-02-08,Melbourne,Australian Open,Hard,1.8,2.0,1
Nishikori K.,439,617,408,209,Carreno Busta P.,16,352,214,138,2021-02-08,Melbourne,Australian Open,Hard,3.4,1.33,0
Travaglia S.,1024,81,27,54,Tiafoe F.,10,303,158,145,2021-02-08,Melbourne,Australian Open,Hard,3.75,1.28,0
Dimitrov G.,20,651,389,262,Cilic M.,100,853,543,310,2021-02-08,Melbourne,Australian Open,Hard,1.5,2.62,1
Koepfer D.,84,86,38,48,Dellien H.,164,70,22,48,2021-02-08,Melbourne,Australian Open,Hard,1.22,4.33,1
Lajovic D.,66,378,163,215,Stakhovsky S.,200,339,145,194,2021-02-08,Melbourne,Australian Open,Hard,1.36,3.2,1
Stebe C.M.,231,76,28,48,Auger-Aliassime F.,12,268,163,105,2021-02-08,Melbourne,Australian Open,Hard,6.0,1.12,0
Schwartzman D.,95,428,233,195,Ymer E.,186,81,24,57,2021-02-08,Melbourne,Australian Open,Hard,1.04,13.0,1
Tomic B.,233,349,169,180,Sugita Y.,131,129,47,82,2021-02-08,Melbourne,Australian Open,Hard,2.2,1.66,1
Ferreira Silva F.,185,2,0,2,Kyrgios N.,25,303,195,108,2021-02-08,Melbourne,Australian Open,Hard,5.5,1.14,0
Cressy M.,96,96,42,54,Daniel T.,111,178,67,111,2021-02-08,Melbourne,Australian Open,Hard,2.1,1.72,1
Djokovic N.,2,1207,1012,195,Chardy J.,542,591,289,302,2021-02-08,Melbourne,Australian Open,Hard,1.01,26.0,1
Shapovalov D.,29,298,166,132,Sinner J.,8,224,153,71,2021-02-08,Melbourne,Australian Open,Hard,1.5,2.62,1
Coppejans K.,188,11,0,11,Vesely J.,528,288,130,158,2021-02-08,Melbourne,Australian Open,Hard,4.0,1.25,0
Duckworth J.,123,143,55,88,Dzumhur D.,202,234,107,127,2021-02-08,Melbourne,Australian Open,Hard,1.36,3.2,1
Raonic M.,849,540,361,179,Coria F.,108,99,43,56,2021-02-08,Melbourne,Australian Open,Hard,1.01,26.0,1
Bedene A.,347,291,131,160,Bublik A.,25,219,110,109,2021-02-08,Melbourne,Australian Open,Hard,1.8,2.0,0
Gerasimov E.,150,93,43,50,Paire B.,149,527,237,290,2021-02-08,Melbourne,Australian Open,Hard,1.16,5.0,1
Novak D.,166,58,15,43,Mannarino A.,27,567,264,303,2021-02-08,Melbourne,Australian Open,Hard,2.2,1.66,0
Monfils G.,323,816,510,306,Ruusuvuori E.,55,158,79,79,2021-02-08,Melbourne,Australian Open,Hard,2.3,1.61,0
Millman J.,140,256,113,143,Moutet C.,80,118,50,68,2021-02-08,Melbourne,Australian Open,Hard,1.4,3.0,0
Wawrinka S.,72,854,535,319,Sousa P.,475,36,9,27,2021-02-08,Melbourne,Australian Open,Hard,1.08,8.0,1
Bolt A.,345,40,13,27,Gombos N.,114,66,21,45,2021-02-08,Melbourne,Australian Open,Hard,1.66,2.2,1
Lu Y.,625,11,1,10,Opelka R.,17,168,88,80,2021-02-08,Melbourne,Australian Open,Hard,10.0,1.06,0
Ramos-Vinolas A.,82,437,204,233,Fritz T.,9,356,205,151,2021-02-08,Melbourne,Australian Open,Hard,5.5,1.14,0
Fucsovics M.,67,249,121,128,Polmans M.,165,19,5,14,2021-02-08,Melbourne,Australian Open,Hard,1.16,5.0,1
Kukushkin M.,221,352,141,211,Thiem D.,116,517,327,190,2021-02-08,Melbourne,Australian Open,Hard,17.0,1.02,0
Mager G.,67,59,24,35,Karatsev A.,75,136,66,70,2021-02-08,Melbourne,Australian Open,Hard,4.0,1.25,0
Majchrzak K.,121,50,19,31,Kecmanovic M.,40,210,107,103,2021-02-08,Melbourne,Australian Open,Hard,2.75,1.44,0
Zverev A.,19,500,346,154,Giron M.,69,150,68,82,2021-02-08,Melbourne,Australian Open,Hard,1.05,11.0,1
Martinez P.,135,118,50,68,Nishioka Y.,31,215,99,116,2021-02-08,Melbourne,Australian Open,Hard,3.2,1.36,1
Sandgren T.,153,121,47,74,De Minaur A.,19,272,161,111,2021-02-09,Melbourne,Australian Open,Hard,6.0,1.12,0
Paul T.,14,204,111,93,Basilashvili N.,118,301,138,163,2021-02-09,Melbourne,Australian Open,Hard,1.2,4.5,1
Djere L.,38,243,120,123,Nadal R.,2,1223,1017,206,2021-02-09,Melbourne,Australian Open,Hard,26.0,1.01,0
Caruso S.,146,63,19,44,Laaksonen H.,125,101,37,64,2021-02-09,Melbourne,Australian Open,Hard,1.57,2.37,1
Troicki V.,230,525,269,256,Mmoh M.,112,55,20,35,2021-02-09,Melbourne,Australian Open,Hard,2.2,1.66,0
Carballes Baena R.,64,207,91,116,Balazs A.,745,33,16,17,2021-02-09,Melbourne,Australian Open,Hard,1.08,8.0,1
Querrey S.,287,678,369,309,Sonego L.,43,221,107,114,2021-02-09,Melbourne,Australian Open,Hard,2.0,1.8,0
Vilella Martinez M.,167,10,4,6,Machac T.,108,18,6,12,2021-02-09,Melbourne,Australian Open,Hard,2.75,1.44,0
Herbert P.H.,157,202,89,113,Fognini F.,128,742,383,359,2021-02-09,Melbourne,Australian Open,Hard,2.1,1.72,0
Simon G.,188,869,491,378,Tsitsipas S.,5,390,264,126,2021-02-09,Melbourne,Australian Open,Hard,10.0,1.06,0
Kwon S.W.,68,108,53,55,Kokkinakis T.,86,124,55,69,2021-02-09,Melbourne,Australian Open,Hard,2.1,1.72,0
Berrettini M.,38,217,142,75,Anderson K.,652,598,347,251,2021-02-09,Melbourne,Australian Open,Hard,1.33,3.4,1
Ivashka I.,113,159,78,81,Safiullin R.,92,42,20,22,2021-02-09,Melbourne,Australian Open,Hard,2.37,1.57,0
Evans D.,30,251,124,127,Norrie C.,13,287,172,115,2021-02-09,Melbourne,Australian Open,Hard,1.4,3.0,0
Tu L.,252,5,1,4,Lopez F.,634,863,441,422,2021-02-09,Melbourne,Australian Open,Hard,3.4,1.33,0
Thompson J.,71,221,96,125,Ruud C.,4,275,176,99,2021-02-09,Melbourne,Australian Open,Hard,2.0,1.8,0
Nagal S.,503,17,3,14,Berankis R.,212,249,104,145,2021-02-09,Melbourne,Australian Open,Hard,6.0,1.12,0
Pospisil V.,99,280,122,158,Medvedev D.,3,406,289,117,2021-02-09,Melbourne,Australian Open,Hard,13.0,1.04,0
Torpegaard M.,188,4,1,3,Harris L.,186,129,59,70,2021-02-09,Melbourne,Australian Open,Hard,3.2,1.36,0
Cecchinato M.,108,204,79,125,Mcdonald M.,60,190,87,103,2021-02-09,Melbourne,Australian Open,Hard,3.2,1.36,0
Monteiro T.,121,171,69,102,Martin A.,723,258,107,151,2021-02-09,Melbourne,Australian Open,Hard,1.22,4.33,1
Coric B.,15,343,185,158,Pella G.,199,260,118,142,2021-02-09,Melbourne,Australian Open,Hard,1.12,6.0,1
Alcaraz C.,1,164,130,34,Van De Zandschulp B.,44,117,63,54,2021-02-09,Melbourne,Australian Open,Hard,1.66,2.2,1
Hurkacz H.,17,238,137,101,Ymer M.,59,130,58,72,2021-02-09,Melbourne,Australian Open,Hard,1.22,4.33,0
O Connell C.,74,65,26,39,Struff J.L.,21,369,170,199,2021-02-09,Melbourne,Australian Open,Hard,4.5,1.2,1
Goffin D.,123,522,296,226,Popyrin A.,90,140,59,81,2021-02-09,Melbourne,Australian Open,Hard,1.4,3.0,0
Vukic A.,62,36,15,21,Khachanov K.,11,378,217,161,2021-02-09,Melbourne,Australian Open,Hard,7.0,1.1,0
Albot R.,97,215,86,129,Bautista Agut R.,25,379,234,145,2021-02-09,Melbourne,Australian Open,Hard,11.0,1.05,1
Seppi A.,141,758,363,395,Cuevas P.,149,421,210,211,2021-02-09,Melbourne,Australian Open,Hard,2.2,1.66,0
Krajinovic F.,93,240,115,125,Haase R.,257,458,202,256,2021-02-09,Melbourne,Australian Open,Hard,1.22,4.33,1
Halys Q.,79,72,23,49,Andujar P.,323,404,164,240,2021-02-09,Melbourne,Australian Open,Hard,1.4,3.0,0
Hanfmann Y.,50,99,50,49,Rublev A.,7,392,255,137,2021-02-09,Melbourne,Australian Open,Hard,23.0,1.01,0
Opelka R.,17,168,88,80,Fritz T.,9,356,205,151,2021-02-10,Melbourne,Australian Open,Hard,2.2,1.66,0
Dimitrov G.,20,651,389,262,Bolt A.,345,40,13,27,2021-02-10,Melbourne,Australian Open,Hard,1.22,4.33,1
Zverev A.,19,500,346,154,Cressy M.,96,96,42,54,2021-02-10,Melbourne,Australian Open,Hard,1.08,8.0,1
Carreno Busta P.,16,352,214,138,Vesely J.,528,288,130,158,2021-02-10,Melbourne,Australian Open,Hard,1.22,4.33,1
Mannarino A.,27,567,264,303,Kecmanovic M.,40,210,107,103,2021-02-10,Melbourne,Australian Open,Hard,2.1,1.72,1
Shapovalov D.,29,298,166,132,Tomic B.,233,349,169,180,2021-02-10,Melbourne,Australian Open,Hard,1.07,9.0,1
Lajovic D.,66,378,163,215,Bublik A.,25,219,110,109,2021-02-10,Melbourne,Australian Open,Hard,2.75,1.44,1
Kyrgios N.,25,303,195,108,Humbert U.,36,170,80,90,2021-02-10,Melbourne,Australian Open,Hard,1.8,2.0,1
Djokovic N.,2,1207,1012,195,Tiafoe F.,10,303,158,145,2021-02-10,Melbourne,Australian Open,Hard,29.0,0.967,1
Raonic M.,849,540,361,179,Moutet C.,80,118,50,68,2021-02-10,Melbourne,Australian Open,Hard,1.12,6.0,1
Muller A.,81,22,9,13,Schwartzman D.,95,428,233,195,2021-02-10,Melbourne,Australian Open,Hard,8.0,1.08,0
Duckworth J.,123,143,55,88,Auger-Aliassime F.,12,268,163,105,2021-02-10,Melbourne,Australian Open,Hard,4.5,1.2,0
Martinez P.,135,118,50,68,Ruusuvuori E.,55,158,79,79,2021-02-10,Melbourne,Australian Open,Hard,3.0,1.4,1
Wawrinka S.,72,854,535,319,Fucsovics M.,67,249,121,128,2021-02-10,Melbourne,Australian Open,Hard,1.4,3.0,0
Gerasimov E.,150,93,43,50,Karatsev A.,75,136,66,70,2021-02-10,Melbourne,Australian Open,Hard,2.5,1.53,0
Thiem D.,116,517,327,190,Koepfer D.,84,86,38,48,2021-02-10,Melbourne,Australian Open,Hard,1.06,10.0,1
Nadal R.,2,1223,1017,206,Mmoh M.,112,55,20,35,2021-02-11,Melbourne,Australian Open,Hard,1.01,23.0,1
Medvedev D.,3,406,289,117,Carballes Baena R.,64,207,91,116,2021-02-11,Melbourne,Australian Open,Hard,1.005,29.0,1
De Minaur A.,19,272,161,111,Cuevas P.,149,421,210,211,2021-02-11,Melbourne,Australian Open,Hard,1.08,8.0,1
Norrie C.,13,287,172,115,Safiullin R.,92,42,20,22,2021-02-11,Melbourne,Australian Open,Hard,1.36,3.2,1
Caruso S.,146,63,19,44,Fognini F.,128,742,383,359,2021-02-11,Melbourne,Australian Open,Hard,3.0,1.4,0
O Connell C.,74,65,26,39,Albot R.,97,215,86,129,2021-02-11,Melbourne,Australian Open,Hard,1.53,2.5,0
Berrettini M.,38,217,142,75,Machac T.,108,18,6,12,2021-02-11,Melbourne,Australian Open,Hard,1.05,11.0,1
Mcdonald M.,60,190,87,103,Coric B.,15,343,185,158,2021-02-11,Melbourne,Australian Open,Hard,4.5,1.2,1
Krajinovic F.,93,240,115,125,Andujar P.,323,404,164,240,2021-02-11,Melbourne,Australian Open,Hard,1.12,6.0,1
Berankis R.,212,249,104,145,Khachanov K.,11,378,217,161,2021-02-11,Melbourne,Australian Open,Hard,4.0,1.25,0
Paul T.,14,204,111,93,Ruud C.,4,275,176,99,2021-02-11,Melbourne,Australian Open,Hard,2.1,1.72,0
Alcaraz C.,1,164,130,34,Ymer M.,59,130,58,72,2021-02-11,Melbourne,Australian Open,Hard,1.5,2.62,0
Popyrin A.,90,140,59,81,Harris L.,186,129,59,70,2021-02-11,Melbourne,Australian Open,Hard,2.3,1.61,0
Rublev A.,7,392,255,137,Monteiro T.,121,171,69,102,2021-02-11,Melbourne,Australian Open,Hard,1.04,13.0,1
Sonego L.,43,221,107,114,Lopez F.,634,863,441,422,2021-02-11,Melbourne,Australian Open,Hard,1.25,4.0,0
Tsitsipas S.,5,390,264,126,Kokkinakis T.,86,124,55,69,2021-02-11,Melbourne,Australian Open,Hard,1.08,8.0,1
Fritz T.,9,356,205,151,Djokovic N.,2,1207,1012,195,2021-02-12,Melbourne,Australian Open,Hard,21.0,1.01,0
Thiem D.,116,517,327,190,Kyrgios N.,25,303,195,108,2021-02-12,Melbourne,Australian Open,Hard,1.28,3.75,1
Shapovalov D.,29,298,166,132,Auger-Aliassime F.,12,268,163,105,2021-02-12,Melbourne,Australian Open,Hard,1.44,2.75,0
Fucsovics M.,67,249,121,128,Raonic M.,849,540,361,179,2021-02-12,Melbourne,Australian Open,Hard,5.5,1.14,0
Zverev A.,19,500,346,154,Mannarino A.,27,567,264,303,2021-02-12,Melbourne,Australian Open,Hard,1.14,5.5,1
Martinez P.,135,118,50,68,Lajovic D.,66,378,163,215,2021-02-12,Melbourne,Australian Open,Hard,2.1,1.72,0
Carreno Busta P.,16,352,214,138,Dimitrov G.,20,651,389,262,2021-02-12,Melbourne,Australian Open,Hard,2.1,1.72,0
Schwartzman D.,95,428,233,195,Karatsev A.,75,136,66,70,2021-02-12,Melbourne,Australian Open,Hard,1.33,3.4,0
Nadal R.,2,1223,1017,206,Norrie C.,13,287,172,115,2021-02-13,Melbourne,Australian Open,Hard,1.02,19.0,1
De Minaur A.,19,272,161,111,Fognini F.,128,742,383,359,2021-02-13,Melbourne,Australian Open,Hard,1.14,5.5,0
Berrettini M.,38,217,142,75,Khachanov K.,11,378,217,161,2021-02-13,Melbourne,Australian Open,Hard,1.4,3.0,1
Lopez F.,634,863,441,422,Rublev A.,7,392,255,137,2021-02-13,Melbourne,Australian Open,Hard,19.0,1.02,0
Medvedev D.,3,406,289,117,Krajinovic F.,93,240,115,125,2021-02-13,Melbourne,Australian Open,Hard,1.05,11.0,1
Harris L.,186,129,59,70,Mcdonald M.,60,190,87,103,2021-02-13,Melbourne,Australian Open,Hard,1.66,2.2,0
Albot R.,97,215,86,129,Ruud C.,4,275,176,99,2021-02-13,Melbourne,Australian Open,Hard,3.4,1.33,0
Tsitsipas S.,5,390,264,126,Ymer M.,59,130,58,72,2021-02-13,Melbourne,Australian Open,Hard,1.03,15.0,1
Auger-Aliassime F.,12,268,163,105,Karatsev A.,75,136,66,70,2021-02-14,Melbourne,Australian Open,Hard,1.53,2.5,0
Thiem D.,116,517,327,190,Dimitrov G.,20,651,389,262,2021-02-14,Melbourne,Australian Open,Hard,1.33,3.4,0
Lajovic D.,66,378,163,215,Zverev A.,19,500,346,154,2021-02-14,Melbourne,Australian Open,Hard,10.0,1.06,0
Raonic M.,849,540,361,179,Djokovic N.,2,1207,1012,195,2021-02-14,Melbourne,Australian Open,Hard,2.75,1.44,0
Tsitsipas S.,5,390,264,126,Berrettini M.,38,217,142,75,2021-02-15,Melbourne,Australian Open,Hard,1.25,4.0,1
Nadal R.,2,1223,1017,206,Fognini F.,128,742,383,359,2021-02-15,Melbourne,Australian Open,Hard,1.16,5.0,1
Rublev A.,7,392,255,137,Ruud C.,4,275,176,99,2021-02-15,Melbourne,Australian Open,Hard,1.08,8.0,1
Medvedev D.,3,406,289,117,Mcdonald M.,60,190,87,103,2021-02-15,Melbourne,Australian Open,Hard,1.03,15.0,1
Dimitrov G.,20,651,389,262,Karatsev A.,75,136,66,70,2021-02-16,Melbourne,Australian Open,Hard,1.3,3.5,0
Zverev A.,19,500,346,154,Djokovic N.,2,1207,1012,195,2021-02-16,Melbourne,Australian Open,Hard,2.37,1.57,0
Medvedev D.,3,406,289,117,Rublev A.,7,392,255,137,2021-02-17,Melbourne,Australian Open,Hard,1.44,2.75,1
Nadal R.,2,1223,1017,206,Tsitsipas S.,5,390,264,126,2021-02-17,Melbourne,Australian Open,Hard,1.44,2.75,0
Djokovic N.,2,1207,1012,195,Karatsev A.,75,136,66,70,2021-02-18,Melbourne,Australian Open,Hard,1.07,9.0,1
Medvedev D.,3,406,289,117,Tsitsipas S.,5,390,264,126,2021-02-19,Melbourne,Australian Open,Hard,1.4,3.0,1
Medvedev D.,3,406,289,117,Djokovic N.,2,1207,1012,195,2021-02-21,Melbourne,Australian Open,Hard,2.0,1.83,0
Kovalik J.,172,68,24,44,Galan D.E.,76,78,33,45,2021-02-22,Cordoba,Cordoba Open,Clay,2.0,1.72,1
Mmoh M.,112,55,20,35,Nishioka Y.,31,215,99,116,2021-02-22,Singapore,Singapore Open,Hard,2.2,1.61,0
Popyrin A.,90,140,59,81,Eubanks C.,29,64,28,36,2021-02-22,Singapore,Singapore Open,Hard,1.5,2.5,1
Harris L.,186,129,59,70,Andreev A.,319,8,2,6,2021-02-22,Singapore,Singapore Open,Hard,1.2,4.33,0
Jung J.,276,32,10,22,Cressy M.,96,96,42,54,2021-02-22,Singapore,Singapore Open,Hard,2.62,1.44,0
Ramanathan R.,435,40,14,26,Daniel T.,111,178,67,111,2021-02-22,Singapore,Singapore Open,Hard,2.75,1.4,0
Gombos N.,114,66,21,45,Humbert U.,36,170,80,90,2021-02-22,Montpellier,Open Sud de France,Hard,4.5,1.18,0
Sonego L.,43,221,107,114,Gaston H.,109,58,24,34,2021-02-22,Montpellier,Open Sud de France,Hard,1.4,2.75,1
Jarry N.,28,141,73,68,Munar J.,104,178,75,103,2021-02-22,Cordoba,Cordoba Open,Clay,3.75,1.25,1
Tsonga J.W.,297,672,444,228,Korda S.,26,126,75,51,2021-02-22,Montpellier,Open Sud de France,Hard,2.75,1.4,0
Polmans M.,165,19,5,14,Uchiyama Y.,314,33,9,24,2021-02-23,Singapore,Singapore Open,Hard,2.1,1.66,0
Murray A.,44,932,687,245,Gerasimov E.,150,93,43,50,2021-02-23,Montpellier,Open Sud de France,Hard,1.44,2.62,0
Giron M.,69,150,68,82,Griekspoor T.,37,97,47,50,2021-02-23,Montpellier,Open Sud de France,Hard,1.5,2.5,0
Gojowczyk P.,108,172,75,97,Struff J.L.,21,369,170,199,2021-02-23,Montpellier,Open Sud de France,Hard,3.0,1.36,1
Pouille L.,675,259,134,125,Bonzi B.,107,83,37,46,2021-02-23,Montpellier,Open Sud de France,Hard,2.25,1.57,0
Ymer M.,59,130,58,72,Vesely J.,528,288,130,158,2021-02-23,Montpellier,Open Sud de France,Hard,1.83,1.83,0
Novak D.,166,58,15,43,Simon G.,188,869,491,378,2021-02-23,Montpellier,Open Sud de France,Hard,2.25,1.57,1
Smith J.P.,306,27,5,22,Albot R.,97,215,86,129,2021-02-23,Singapore,Singapore Open,Hard,3.0,1.36,0
Mager G.,67,59,24,35,Cerundolo F.,21,104,58,46,2021-02-23,Cordoba,Cordoba Open,Clay,2.5,1.5,0
Celikbilek A.,230,9,4,5,Mochizuki S.,200,8,0,8,2021-02-23,Singapore,Singapore Open,Hard,1.33,3.25,1
Sousa J.,147,436,189,247,Carballes Baena R.,64,207,91,116,2021-02-23,Cordoba,Cordoba Open,Clay,3.75,1.25,0
Dellien H.,164,70,22,48,Cecchinato M.,108,204,79,125,2021-02-23,Cordoba,Cordoba Open,Clay,3.5,1.28,0
Koepfer D.,84,86,38,48,Coria F.,108,99,43,56,2021-02-23,Cordoba,Cordoba Open,Clay,2.2,1.61,0
Seyboth Wild T.,117,28,12,16,Cerundolo J.M.,106,29,12,17,2021-02-23,Cordoba,Cordoba Open,Clay,1.33,3.25,0
Kicker N.,203,47,19,28,Bagnis F.,135,121,39,82,2021-02-23,Cordoba,Cordoba Open,Clay,4.33,1.2,0
Martin A.,723,258,107,151,Etcheverry T.,34,60,26,34,2021-02-23,Cordoba,Cordoba Open,Clay,2.0,1.72,0
Duckworth J.,123,143,55,88,Hanfmann Y.,50,99,50,49,2021-02-23,Singapore,Singapore Open,Hard,1.61,2.2,0
Londero J.I.,142,83,34,49,Ramos-Vinolas A.,82,437,204,233,2021-02-23,Cordoba,Cordoba Open,Clay,1.61,2.2,0
Bonzi B.,107,83,37,46,Goffin D.,123,522,296,226,2021-02-24,Montpellier,Open Sud de France,Hard,2.37,1.53,0
Bublik A.,25,219,110,109,Celikbilek A.,230,9,4,5,2021-02-24,Singapore,Singapore Open,Hard,1.2,4.33,1
Nishioka Y.,31,215,99,116,Cressy M.,96,96,42,54,2021-02-24,Singapore,Singapore Open,Hard,1.72,2.0,1
Cilic M.,100,853,543,310,Daniel T.,111,178,67,111,2021-02-24,Singapore,Singapore Open,Hard,1.33,3.25,1
Bhambri Y.,862,40,14,26,Ebden M.,432,203,75,128,2021-02-24,Singapore,Singapore Open,Hard,3.75,1.25,0
Gulbis E.,191,453,221,232,Marcora R.,208,7,3,4,2021-02-24,Singapore,Singapore Open,Hard,1.83,1.83,0
Kwon S.W.,68,108,53,55,Kwiatkowski T.S.,219,6,0,6,2021-02-24,Singapore,Singapore Open,Hard,1.36,3.0,1
Humbert U.,36,170,80,90,Griekspoor T.,37,97,47,50,2021-02-24,Montpellier,Open Sud de France,Hard,1.22,4.0,1
Popyrin A.,90,140,59,81,Andreev A.,319,8,2,6,2021-02-24,Singapore,Singapore Open,Hard,1.22,4.0,1
Sonego L.,43,221,107,114,Korda S.,26,126,75,51,2021-02-24,Montpellier,Open Sud de France,Hard,2.37,1.53,1
Coria F.,108,99,43,56,Cerundolo F.,21,104,58,46,2021-02-24,Cordoba,Cordoba Open,Clay,2.25,1.57,1
Sinner J.,8,224,153,71,Bedene A.,347,291,131,160,2021-02-24,Montpellier,Open Sud de France,Hard,1.18,4.5,0
Zapata Miralles B.,54,80,32,48,Davidovich Fokina A.,39,168,84,84,2021-02-24,Montpellier,Open Sud de France,Hard,2.25,1.57,0
Delbonis F.,131,340,152,188,Bagnis F.,135,121,39,82,2021-02-24,Cordoba,Cordoba Open,Clay,1.72,2.0,0
Barrere G.,59,79,31,48,Basilashvili N.,118,301,138,163,2021-02-24,Montpellier,Open Sud de France,Hard,1.53,2.37,1
Kovalik J.,172,68,24,44,Barrios M.,121,10,3,7,2021-02-24,Cordoba,Cordoba Open,Clay,1.57,2.25,1
Menezes J.,199,1,0,1,Monteiro T.,121,171,69,102,2021-02-24,Cordoba,Cordoba Open,Clay,4.0,1.22,0
Delbonis F.,131,340,152,188,Sousa P.,475,36,9,27,2021-02-24,Cordoba,Cordoba Open,Clay,1.53,2.37,1
Etcheverry T.,34,60,26,34,Ramos-Vinolas A.,82,437,204,233,2021-02-25,Cordoba,Cordoba Open,Clay,2.37,1.53,0
Carballes Baena R.,64,207,91,116,Monteiro T.,121,171,69,102,2021-02-25,Cordoba,Cordoba Open,Clay,3.0,1.36,0
Jarry N.,28,141,73,68,Paire B.,149,527,237,290,2021-02-25,Cordoba,Cordoba Open,Clay,1.44,2.62,0
Albot R.,97,215,86,129,Hanfmann Y.,50,99,50,49,2021-02-25,Singapore,Singapore Open,Hard,1.66,2.1,1
Millman J.,140,256,113,143,Ebden M.,432,203,75,128,2021-02-25,Singapore,Singapore Open,Hard,1.25,3.75,0
Marcora R.,208,7,3,4,Mannarino A.,27,567,264,303,2021-02-25,Singapore,Singapore Open,Hard,4.5,1.18,0
Uchiyama Y.,314,33,9,24,Kwon S.W.,68,108,53,55,2021-02-25,Singapore,Singapore Open,Hard,2.75,1.4,0
Bautista Agut R.,25,379,234,145,Barrere G.,59,79,31,48,2021-02-25,Montpellier,Open Sud de France,Hard,1.28,3.5,1
Novak D.,166,58,15,43,Lajovic D.,66,378,163,215,2021-02-25,Montpellier,Open Sud de France,Hard,1.83,1.83,1
Davidovich Fokina A.,39,168,84,84,Hurkacz H.,17,238,137,101,2021-02-25,Montpellier,Open Sud de France,Hard,2.2,1.61,1
Vesely J.,528,288,130,158,Gojowczyk P.,108,172,75,97,2021-02-25,Montpellier,Open Sud de France,Hard,1.44,2.62,0
Gerasimov E.,150,93,43,50,Bedene A.,347,291,131,160,2021-02-25,Montpellier,Open Sud de France,Hard,2.0,1.72,1
Schwartzman D.,95,428,233,195,Cecchinato M.,108,204,79,125,2021-02-25,Cordoba,Cordoba Open,Clay,1.3,3.4,1
Kecmanovic M.,40,210,107,103,Cerundolo J.M.,106,29,12,17,2021-02-25,Cordoba,Cordoba Open,Clay,1.4,2.75,0
Mannarino A.,27,567,264,303,Albot R.,97,215,86,129,2021-02-26,Singapore,Singapore Open,Hard,1.44,2.75,0
Cilic M.,100,853,543,310,Kwon S.W.,68,108,53,55,2021-02-26,Singapore,Singapore Open,Hard,1.8,2.0,1
Bublik A.,25,219,110,109,Nishioka Y.,31,215,99,116,2021-02-26,Singapore,Singapore Open,Hard,1.72,2.1,1
Ebden M.,432,203,75,128,Popyrin A.,90,140,59,81,2021-02-26,Singapore,Singapore Open,Hard,2.62,1.5,0
Paire B.,149,527,237,290,Coria F.,108,99,43,56,2021-02-26,Cordoba,Cordoba Open,Clay,2.0,1.8,0
Sonego L.,43,221,107,114,Goffin D.,123,522,296,226,2021-02-26,Montpellier,Open Sud de France,Hard,1.72,2.1,0
Davidovich Fokina A.,39,168,84,84,Gerasimov E.,150,93,43,50,2021-02-26,Montpellier,Open Sud de France,Hard,1.8,2.0,0
Cerundolo J.M.,106,29,12,17,Monteiro T.,121,171,69,102,2021-02-26,Cordoba,Cordoba Open,Clay,3.75,1.28,1
Humbert U.,36,170,80,90,Bautista Agut R.,25,379,234,145,2021-02-26,Montpellier,Open Sud de France,Hard,2.0,1.8,0
Novak D.,166,58,15,43,Gojowczyk P.,108,172,75,97,2021-02-26,Montpellier,Open Sud de France,Hard,1.8,2.0,0
Ramos-Vinolas A.,82,437,204,233,Schwartzman D.,95,428,233,195,2021-02-26,Cordoba,Cordoba Open,Clay,7.0,1.1,1
Bagnis F.,135,121,39,82,Kovalik J.,172,68,24,44,2021-02-26,Cordoba,Cordoba Open,Clay,1.5,2.62,1
Bautista Agut R.,25,379,234,145,Gojowczyk P.,108,172,75,97,2021-02-27,Montpellier,Open Sud de France,Hard,1.2,4.5,1
Gerasimov E.,150,93,43,50,Goffin D.,123,522,296,226,2021-02-27,Montpellier,Open Sud de France,Hard,2.62,1.5,0
Coria F.,108,99,43,56,Cerundolo J.M.,106,29,12,17,2021-02-27,Cordoba,Cordoba Open,Clay,1.44,2.75,0
Cilic M.,100,853,543,310,Popyrin A.,90,140,59,81,2021-02-27,Singapore,Singapore Open,Hard,1.57,2.37,0
Bublik A.,25,219,110,109,Albot R.,97,215,86,129,2021-02-27,Singapore,Singapore Open,Hard,1.44,2.75,1
Bagnis F.,135,121,39,82,Ramos-Vinolas A.,82,437,204,233,2021-02-28,Cordoba,Cordoba Open,Clay,2.0,1.8,0
Cerundolo J.M.,106,29,12,17,Ramos-Vinolas A.,82,437,204,233,2021-02-28,Cordoba,Cordoba Open,Clay,2.62,1.5,1
Bublik A.,25,219,110,109,Popyrin A.,90,140,59,81,2021-02-28,Singapore,Singapore Open,Hard,1.61,2.3,0
Bautista Agut R.,25,379,234,145,Goffin D.,123,522,296,226,2021-02-28,Montpellier,Open Sud de France,Hard,1.4,3.0,0
Norrie C.,13,287,172,115,Basilashvili N.,118,301,138,163,2021-03-01,Rotterdam,ABN AMRO World Tennis Tournament,Hard,1.18,4.5,1
Opelka R.,17,168,88,80,Fucsovics M.,67,249,121,128,2021-03-01,Rotterdam,ABN AMRO World Tennis Tournament,Hard,2.3,1.61,0
Carballes Baena R.,64,207,91,116,Monteiro T.,121,171,69,102,2021-03-01,Buenos Aires,Argentina Open,Clay,2.75,1.44,0
Murray A.,44,932,687,245,Haase R.,257,458,202,256,2021-03-01,Rotterdam,ABN AMRO World Tennis Tournament,Hard,1.44,2.75,1
Auger-Aliassime F.,12,268,163,105,Nishikori K.,439,617,408,209,2021-03-01,Rotterdam,ABN AMRO World Tennis Tournament,Hard,1.33,3.4,0
Tirante T.A.,136,5,2,3,Koepfer D.,84,86,38,48,2021-03-01,Buenos Aires,Argentina Open,Clay,2.3,1.61,0
Djere L.,38,243,120,123,Cecchinato M.,108,204,79,125,2021-03-01,Buenos Aires,Argentina Open,Clay,2.0,1.8,1
Andujar P.,323,404,164,240,Londero J.I.,142,83,34,49,2021-03-01,Buenos Aires,Argentina Open,Clay,1.8,2.0,1
Klein L.,142,7,2,5,Martin A.,723,258,107,151,2021-03-02,Buenos Aires,Argentina Open,Clay,1.66,2.2,1
De Minaur A.,19,272,161,111,Millman J.,140,256,113,143,2021-03-02,Rotterdam,ABN AMRO World Tennis Tournament,Hard,1.16,5.0,1
Giron M.,69,150,68,82,Rublev A.,7,392,255,137,2021-03-02,Rotterdam,ABN AMRO World Tennis Tournament,Hard,6.0,1.12,0
Mannarino A.,27,567,264,303,Hurkacz H.,17,238,137,101,2021-03-02,Rotterdam,ABN AMRO World Tennis Tournament,Hard,2.0,1.8,0
Wawrinka S.,72,854,535,319,Khachanov K.,11,378,217,161,2021-03-02,Rotterdam,ABN AMRO World Tennis Tournament,Hard,2.0,1.8,0
Humbert U.,36,170,80,90,Chardy J.,542,591,289,302,2021-03-02,Rotterdam,ABN AMRO World Tennis Tournament,Hard,1.44,2.75,0
Gerasimov E.,150,93,43,50,Tsitsipas S.,5,390,264,126,2021-03-02,Rotterdam,ABN AMRO World Tennis Tournament,Hard,4.5,1.2,0
Van De Zandschulp B.,44,117,63,54,Coric B.,15,343,185,158,2021-03-02,Rotterdam,ABN AMRO World Tennis Tournament,Hard,3.4,1.33,0
Sousa J.,147,436,189,247,Nagal S.,503,17,3,14,2021-03-02,Buenos Aires,Argentina Open,Clay,3.0,1.4,0
Delbonis F.,131,340,152,188,Cerundolo J.M.,106,29,12,17,2021-03-02,Buenos Aires,Argentina Open,Clay,1.57,2.37,1
Bagnis F.,135,121,39,82,Tiafoe F.,10,303,158,145,2021-03-02,Buenos Aires,Argentina Open,Clay,2.0,1.8,0
Rune H.,6,131,83,48,Ramos-Vinolas A.,82,437,204,233,2021-03-02,Buenos Aires,Argentina Open,Clay,3.0,1.4,0
Cerundolo F.,21,104,58,46,Coria F.,108,99,43,56,2021-03-02,Buenos Aires,Argentina Open,Clay,1.61,2.3,1
Munar J.,104,178,75,103,Diaz Acosta F.,137,5,1,4,2021-03-02,Buenos Aires,Argentina Open,Clay,1.12,6.0,1
Mager G.,67,59,24,35,Caruso S.,146,63,19,44,2021-03-02,Buenos Aires,Argentina Open,Clay,2.0,1.8,1
Sonego L.,43,221,107,114,Paul T.,14,204,111,93,2021-03-03,Rotterdam,ABN AMRO World Tennis Tournament,Hard,1.57,2.37,0
Bublik A.,25,219,110,109,Zverev A.,19,500,346,154,2021-03-03,Rotterdam,ABN AMRO World Tennis Tournament,Hard,5.0,1.16,1
Davidovich Fokina A.,39,168,84,84,Bautista Agut R.,25,379,234,145,2021-03-03,Rotterdam,ABN AMRO World Tennis Tournament,Hard,3.2,1.36,1
Nishikori K.,439,617,408,209,De Minaur A.,19,272,161,111,2021-03-03,Rotterdam,ABN AMRO World Tennis Tournament,Hard,3.4,1.33,1
Murray A.,44,932,687,245,Rublev A.,7,392,255,137,2021-03-03,Rotterdam,ABN AMRO World Tennis Tournament,Hard,6.0,1.12,0
Struff J.L.,21,369,170,199,Goffin D.,123,522,296,226,2021-03-03,Rotterdam,ABN AMRO World Tennis Tournament,Hard,2.37,1.57,0
Medvedev D.,3,406,289,117,Lajovic D.,66,378,163,215,2021-03-03,Rotterdam,ABN AMRO World Tennis Tournament,Hard,1.08,8.0,0
Khachanov K.,11,378,217,161,Norrie C.,13,287,172,115,2021-03-03,Rotterdam,ABN AMRO World Tennis Tournament,Hard,1.53,2.5,1
Ramos-Vinolas A.,82,437,204,233,Koepfer D.,84,86,38,48,2021-03-03,Buenos Aires,Argentina Open,Clay,2.1,1.72,1
Monteiro T.,121,171,69,102,Kecmanovic M.,40,210,107,103,2021-03-03,Buenos Aires,Argentina Open,Clay,1.53,2.5,0
Delbonis F.,131,340,152,188,Djere L.,38,243,120,123,2021-03-03,Buenos Aires,Argentina Open,Clay,2.2,1.66,0
Garin C.,101,190,103,87,Nagal S.,503,17,3,14,2021-03-03,Buenos Aires,Argentina Open,Clay,1.44,2.75,0
Lajovic D.,66,378,163,215,Coric B.,15,343,185,158,2021-03-04,Rotterdam,ABN AMRO World Tennis Tournament,Hard,2.5,1.53,0
Klein L.,142,7,2,5,Schwartzman D.,95,428,233,195,2021-03-04,Buenos Aires,Argentina Open,Clay,5.0,1.16,0
Tiafoe F.,10,303,158,145,Munar J.,104,178,75,103,2021-03-04,Buenos Aires,Argentina Open,Clay,1.9,1.9,0
Cerundolo F.,21,104,58,46,Paire B.,149,527,237,290,2021-03-04,Buenos Aires,Argentina Open,Clay,1.33,3.4,1
Mager G.,67,59,24,35,Andujar P.,323,404,164,240,2021-03-04,Buenos Aires,Argentina Open,Clay,2.5,1.53,0
Davidovich Fokina A.,39,168,84,84,Fucsovics M.,67,249,121,128,2021-03-04,Rotterdam,ABN AMRO World Tennis Tournament,Hard,2.3,1.61,0
Hurkacz H.,17,238,137,101,Tsitsipas S.,5,390,264,126,2021-03-04,Rotterdam,ABN AMRO World Tennis Tournament,Hard,4.5,1.2,0
Bublik A.,25,219,110,109,Paul T.,14,204,111,93,2021-03-04,Rotterdam,ABN AMRO World Tennis Tournament,Hard,1.8,2.0,0
Chardy J.,542,591,289,302,Goffin D.,123,522,296,226,2021-03-04,Rotterdam,ABN AMRO World Tennis Tournament,Hard,4.0,1.25,1
Andujar P.,323,404,164,240,Cerundolo F.,21,104,58,46,2021-03-05,Buenos Aires,Argentina Open,Clay,2.0,1.8,0
Nishikori K.,439,617,408,209,Coric B.,15,343,185,158,2021-03-05,Rotterdam,ABN AMRO World Tennis Tournament,Hard,2.2,1.66,0
Paul T.,14,204,111,93,Fucsovics M.,67,249,121,128,2021-03-05,Rotterdam,ABN AMRO World Tennis Tournament,Hard,2.62,1.5,0
Kecmanovic M.,40,210,107,103,Djere L.,38,243,120,123,2021-03-05,Buenos Aires,Argentina Open,Clay,2.2,1.66,1
Munar J.,104,178,75,103,Schwartzman D.,95,428,233,195,2021-03-05,Buenos Aires,Argentina Open,Clay,3.4,1.33,0
Nagal S.,503,17,3,14,Ramos-Vinolas A.,82,437,204,233,2021-03-05,Buenos Aires,Argentina Open,Clay,2.3,1.61,0
Rublev A.,7,392,255,137,Chardy J.,542,591,289,302,2021-03-05,Rotterdam,ABN AMRO World Tennis Tournament,Hard,1.12,6.0,1
Tsitsipas S.,5,390,264,126,Khachanov K.,11,378,217,161,2021-03-05,Rotterdam,ABN AMRO World Tennis Tournament,Hard,1.36,3.2,1
Kecmanovic M.,40,210,107,103,Schwartzman D.,95,428,233,195,2021-03-06,Buenos Aires,Argentina Open,Clay,4.0,1.25,0
Rublev A.,7,392,255,137,Tsitsipas S.,5,390,264,126,2021-03-06,Rotterdam,ABN AMRO World Tennis Tournament,Hard,2.0,1.8,1
Cerundolo F.,21,104,58,46,Ramos-Vinolas A.,82,437,204,233,2021-03-06,Buenos Aires,Argentina Open,Clay,1.61,2.3,1
Coric B.,15,343,185,158,Fucsovics M.,67,249,121,128,2021-03-06,Rotterdam,ABN AMRO World Tennis Tournament,Hard,1.66,2.2,0
Schwartzman D.,95,428,233,195,Cerundolo F.,21,104,58,46,2021-03-07,Buenos Aires,Argentina Open,Clay,1.2,4.5,1
Rublev A.,7,392,255,137,Fucsovics M.,67,249,121,128,2021-03-07,Rotterdam,ABN AMRO World Tennis Tournament,Hard,1.25,4.0,1
Basilashvili N.,118,301,138,163,Millman J.,140,256,113,143,2021-03-08,Doha,Qatar Exxon Mobil Open,Hard,4.0,1.25,1
Gaston H.,109,58,24,34,Novak D.,166,58,15,43,2021-03-08,Marseille,Open 13,Hard,2.37,1.57,1
Barrere G.,59,79,31,48,Sinner J.,8,224,153,71,2021-03-08,Marseille,Open 13,Hard,5.0,1.16,0
Cecchinato M.,108,204,79,125,Bagnis F.,135,121,39,82,2021-03-08,Santiago,Chile Open,Clay,1.66,2.2,0
Altmaier D.,51,79,28,51,Galan D.E.,76,78,33,45,2021-03-08,Santiago,Chile Open,Clay,1.8,2.0,0
Carballes Baena R.,64,207,91,116,Caruso S.,146,63,19,44,2021-03-08,Santiago,Chile Open,Clay,1.9,1.9,1
Tiafoe F.,10,303,158,145,Jarry N.,28,141,73,68,2021-03-08,Santiago,Chile Open,Clay,1.57,2.37,1
Sousa P.,475,36,9,27,Mayer L.,146,358,165,193,2021-03-08,Santiago,Chile Open,Clay,1.9,1.9,1
Ruusuvuori E.,55,158,79,79,Nishioka Y.,31,215,99,116,2021-03-08,Marseille,Open 13,Hard,1.9,1.9,1
Opelka R.,17,168,88,80,Bautista Agut R.,25,379,234,145,2021-03-08,Doha,Qatar Exxon Mobil Open,Hard,2.5,1.53,0
Gasquet R.,48,948,581,367,Rola B.,163,27,9,18,2021-03-08,Doha,Qatar Exxon Mobil Open,Hard,1.53,2.5,1
Sonego L.,43,221,107,114,Fritz T.,9,356,205,151,2021-03-08,Doha,Qatar Exxon Mobil Open,Hard,2.2,1.66,0
Zayid M.,0,1,0,1,Karatsev A.,75,136,66,70,2021-03-08,Doha,Qatar Exxon Mobil Open,Hard,51.0,1.0,0
Bublik A.,25,219,110,109,Ramanathan R.,435,40,14,26,2021-03-08,Doha,Qatar Exxon Mobil Open,Hard,1.3,3.5,1
Bonzi B.,107,83,37,46,Ebden M.,432,203,75,128,2021-03-09,Marseille,Open 13,Hard,1.5,2.62,0
Travaglia S.,1024,81,27,54,Mcdonald M.,60,190,87,103,2021-03-09,Marseille,Open 13,Hard,2.62,1.5,0
Kukushkin M.,221,352,141,211,Rinderknech A.,67,96,46,50,2021-03-09,Marseille,Open 13,Hard,2.5,1.53,0
Herbert P.H.,157,202,89,113,Nishikori K.,439,617,408,209,2021-03-09,Marseille,Open 13,Hard,3.0,1.4,1
Delbonis F.,131,340,152,188,Munar J.,104,178,75,103,2021-03-09,Santiago,Chile Open,Clay,2.37,1.57,1
Mager G.,67,59,24,35,Coria F.,108,99,43,56,2021-03-09,Santiago,Chile Open,Clay,1.72,2.1,0
Pouille L.,675,259,134,125,Molcan A.,120,86,45,41,2021-03-09,Marseille,Open 13,Hard,1.44,2.75,1
Lama G.,410,4,0,4,Cerundolo J.M.,106,29,12,17,2021-03-09,Santiago,Chile Open,Clay,4.33,1.22,0
Cerundolo F.,21,104,58,46,Martin A.,723,258,107,151,2021-03-09,Santiago,Chile Open,Clay,1.8,2.0,0
Tabilo A.,122,44,21,23,Kovalik J.,172,68,24,44,2021-03-09,Santiago,Chile Open,Clay,1.72,2.1,1
Tsonga J.W.,297,672,444,228,Lopez F.,634,863,441,422,2021-03-09,Marseille,Open 13,Hard,2.0,1.8,1
Davidovich Fokina A.,39,168,84,84,Tsitsipas P.,970,1,0,1,2021-03-09,Marseille,Open 13,Hard,1.01,23.0,1
Rune H.,6,131,83,48,Baez S.,72,95,47,48,2021-03-09,Santiago,Chile Open,Clay,3.2,1.36,1
Evans D.,30,251,124,127,Chardy J.,542,591,289,302,2021-03-09,Doha,Qatar Exxon Mobil Open,Hard,1.72,2.1,1
Pospisil V.,99,280,122,158,O Connell C.,74,65,26,39,2021-03-09,Doha,Qatar Exxon Mobil Open,Hard,1.5,2.62,1
Gombos N.,114,66,21,45,Jaziri M.,444,217,83,134,2021-03-09,Doha,Qatar Exxon Mobil Open,Hard,1.25,4.0,0
Varillas J. P.,1345,20,9,11,Sousa J.,147,436,189,247,2021-03-09,Santiago,Chile Open,Clay,1.3,3.5,1
Goffin D.,123,522,296,226,Krajinovic F.,93,240,115,125,2021-03-09,Doha,Qatar Exxon Mobil Open,Hard,1.66,2.2,1
Wawrinka S.,72,854,535,319,Harris L.,186,129,59,70,2021-03-09,Doha,Qatar Exxon Mobil Open,Hard,1.4,3.0,0
Fucsovics M.,67,249,121,128,Lajovic D.,66,378,163,215,2021-03-09,Doha,Qatar Exxon Mobil Open,Hard,1.61,2.3,1
Federer R.,8,1143,981,162,Evans D.,30,251,124,127,2021-03-10,Doha,Qatar Exxon Mobil Open,Hard,1.5,2.62,1
Tiafoe F.,10,303,158,145,Bagnis F.,135,121,39,82,2021-03-10,Santiago,Chile Open,Clay,1.5,2.62,0
Martin A.,723,258,107,151,Delbonis F.,131,340,152,188,2021-03-10,Santiago,Chile Open,Clay,2.37,1.57,0
Paire B.,149,527,237,290,Rune H.,6,131,83,48,2021-03-10,Santiago,Chile Open,Clay,2.37,1.57,0
Shapovalov D.,29,298,166,132,Pospisil V.,99,280,122,158,2021-03-10,Doha,Qatar Exxon Mobil Open,Hard,1.44,2.75,1
Rublev A.,7,392,255,137,Gasquet R.,48,948,581,367,2021-03-10,Doha,Qatar Exxon Mobil Open,Hard,1.1,7.0,1
Humbert U.,36,170,80,90,Tsonga J.W.,297,672,444,228,2021-03-10,Marseille,Open 13,Hard,1.3,3.5,1
Ebden M.,432,203,75,128,Ruusuvuori E.,55,158,79,79,2021-03-10,Marseille,Open 13,Hard,3.0,1.4,1
Mcdonald M.,60,190,87,103,Khachanov K.,11,378,217,161,2021-03-10,Marseille,Open 13,Hard,2.75,1.44,0
Sousa P.,475,36,9,27,Djere L.,38,243,120,123,2021-03-10,Santiago,Chile Open,Clay,3.2,1.36,0
Lestienne C.,109,40,13,27,Norrie C.,13,287,172,115,2021-03-10,Marseille,Open 13,Hard,3.5,1.3,0
Hanfmann Y.,50,99,50,49,Gerasimov E.,150,93,43,50,2021-03-10,Marseille,Open 13,Hard,3.0,1.4,0
Bublik A.,25,219,110,109,Bautista Agut R.,25,379,234,145,2021-03-10,Doha,Qatar Exxon Mobil Open,Hard,3.4,1.33,0
Fritz T.,9,356,205,151,Goffin D.,123,522,296,226,2021-03-10,Doha,Qatar Exxon Mobil Open,Hard,2.75,1.44,1
Basilashvili N.,118,301,138,163,Jaziri M.,444,217,83,134,2021-03-10,Doha,Qatar Exxon Mobil Open,Hard,1.4,3.0,1
Fucsovics M.,67,249,121,128,Harris L.,186,129,59,70,2021-03-10,Doha,Qatar Exxon Mobil Open,Hard,1.66,2.2,1
Gaston H.,109,58,24,34,Sinner J.,8,224,153,71,2021-03-10,Marseille,Open 13,Hard,5.0,1.16,0
Thiem D.,116,517,327,190,Karatsev A.,75,136,66,70,2021-03-10,Doha,Qatar Exxon Mobil Open,Hard,1.36,3.2,1
Garin C.,101,190,103,87,Tabilo A.,122,44,21,23,2021-03-11,Santiago,Chile Open,Clay,1.5,2.62,1
Coria F.,108,99,43,56,Varillas J. P.,1345,20,9,11,2021-03-11,Santiago,Chile Open,Clay,1.66,2.2,0
Tsitsipas S.,5,390,264,126,Pouille L.,675,259,134,125,2021-03-11,Marseille,Open 13,Hard,1.1,7.0,1
Cerundolo J.M.,106,29,12,17,Carballes Baena R.,64,207,91,116,2021-03-11,Santiago,Chile Open,Clay,2.1,1.72,0
Davidovich Fokina A.,39,168,84,84,Rinderknech A.,67,96,46,50,2021-03-11,Marseille,Open 13,Hard,1.4,3.0,0
Norrie C.,13,287,172,115,Herbert P.H.,157,202,89,113,2021-03-11,Marseille,Open 13,Hard,2.0,1.8,0
Fritz T.,9,356,205,151,Shapovalov D.,29,298,166,132,2021-03-11,Doha,Qatar Exxon Mobil Open,Hard,2.62,1.5,1
Rublev A.,7,392,255,137,Fucsovics M.,67,249,121,128,2021-03-11,Doha,Qatar Exxon Mobil Open,Hard,1.2,4.5,1
Basilashvili N.,118,301,138,163,Federer R.,8,1143,981,162,2021-03-11,Doha,Qatar Exxon Mobil Open,Hard,5.5,1.14,1
Thiem D.,116,517,327,190,Bautista Agut R.,25,379,234,145,2021-03-11,Doha,Qatar Exxon Mobil Open,Hard,1.44,2.75,0
Andujar P.,323,404,164,240,Galan D.E.,76,78,33,45,2021-03-11,Santiago,Chile Open,Clay,1.57,2.37,0
Medvedev D.,3,406,289,117,Gerasimov E.,150,93,43,50,2021-03-11,Marseille,Open 13,Hard,1.14,5.5,1
Rublev A.,7,392,255,137,Bautista Agut R.,25,379,234,145,2021-03-12,Doha,Qatar Exxon Mobil Open,Hard,1.36,3.2,0
Galan D.E.,76,78,33,45,Carballes Baena R.,64,207,91,116,2021-03-12,Santiago,Chile Open,Clay,2.1,1.72,1
Humbert U.,36,170,80,90,Rinderknech A.,67,96,46,50,2021-03-12,Marseille,Open 13,Hard,1.33,3.4,1
Herbert P.H.,157,202,89,113,Tsitsipas S.,5,390,264,126,2021-03-12,Marseille,Open 13,Hard,5.0,1.16,1
Sinner J.,8,224,153,71,Medvedev D.,3,406,289,117,2021-03-12,Marseille,Open 13,Hard,3.4,1.33,0
Khachanov K.,11,378,217,161,Ebden M.,432,203,75,128,2021-03-12,Marseille,Open 13,Hard,1.14,5.5,0
Basilashvili N.,118,301,138,163,Fritz T.,9,356,205,151,2021-03-12,Doha,Qatar Exxon Mobil Open,Hard,3.0,1.4,1
Bagnis F.,135,121,39,82,Djere L.,38,243,120,123,2021-03-12,Santiago,Chile Open,Clay,2.2,1.66,1
Garin C.,101,190,103,87,Varillas J. P.,1345,20,9,11,2021-03-12,Santiago,Chile Open,Clay,1.36,3.2,1
Rune H.,6,131,83,48,Delbonis F.,131,340,152,188,2021-03-12,Santiago,Chile Open,Clay,2.5,1.53,0
Bagnis F.,135,121,39,82,Delbonis F.,131,340,152,188,2021-03-13,Santiago,Chile Open,Clay,2.1,1.72,1
Galan D.E.,76,78,33,45,Garin C.,101,190,103,87,2021-03-13,Santiago,Chile Open,Clay,2.5,1.53,0
Basilashvili N.,118,301,138,163,Bautista Agut R.,25,379,234,145,2021-03-13,Doha,Qatar Exxon Mobil Open,Hard,4.0,1.25,1
Humbert U.,36,170,80,90,Herbert P.H.,157,202,89,113,2021-03-13,Marseille,Open 13,Hard,1.61,2.3,0
Ebden M.,432,203,75,128,Medvedev D.,3,406,289,117,2021-03-13,Marseille,Open 13,Hard,11.0,1.05,0
Popyrin A.,90,140,59,81,Novak D.,166,58,15,43,2021-03-14,Dubai ,Dubai Tennis Championships,Hard,1.44,2.75,1
Jaziri M.,444,217,83,134,Tsonga J.W.,297,672,444,228,2021-03-14,Dubai ,Dubai Tennis Championships,Hard,3.75,1.28,1
Medvedev D.,3,406,289,117,Herbert P.H.,157,202,89,113,2021-03-14,Marseille,Open 13,Hard,1.2,4.5,1
Karatsev A.,75,136,66,70,Gerasimov E.,150,93,43,50,2021-03-14,Dubai ,Dubai Tennis Championships,Hard,1.4,3.0,1
Chardy J.,542,591,289,302,Ramos-Vinolas A.,82,437,204,233,2021-03-14,Dubai ,Dubai Tennis Championships,Hard,1.36,3.2,1
Nishikori K.,439,617,408,209,Opelka R.,17,168,88,80,2021-03-14,Dubai ,Dubai Tennis Championships,Hard,2.1,1.72,1
Nishioka Y.,31,215,99,116,Bublik A.,25,219,110,109,2021-03-14,Dubai ,Dubai Tennis Championships,Hard,2.75,1.44,0
Garin C.,101,190,103,87,Bagnis F.,135,121,39,82,2021-03-14,Santiago,Chile Open,Clay,1.5,2.62,1
Davidovich Fokina A.,39,168,84,84,Albot R.,97,215,86,129,2021-03-15,Dubai ,Dubai Tennis Championships,Hard,1.44,2.75,1
Kukushkin M.,221,352,141,211,Struff J.L.,21,369,170,199,2021-03-15,Dubai ,Dubai Tennis Championships,Hard,2.62,1.5,0
Zapata Miralles B.,54,80,32,48,Millman J.,140,256,113,143,2021-03-15,Dubai ,Dubai Tennis Championships,Hard,2.1,1.72,1
Bedene A.,347,291,131,160,Bhambri Y.,862,40,14,26,2021-03-15,Dubai ,Dubai Tennis Championships,Hard,1.4,3.0,1
Harris L.,186,129,59,70,O Connell C.,74,65,26,39,2021-03-15,Dubai ,Dubai Tennis Championships,Hard,1.36,3.2,1
Gasquet R.,48,948,581,367,Cecchinato M.,108,204,79,125,2021-03-15,Dubai ,Dubai Tennis Championships,Hard,1.4,3.0,1
Ruusuvuori E.,55,158,79,79,Thompson J.,71,221,96,125,2021-03-15,Dubai ,Dubai Tennis Championships,Hard,1.4,3.0,1
Pospisil V.,99,280,122,158,Fucsovics M.,67,249,121,128,2021-03-15,Dubai ,Dubai Tennis Championships,Hard,2.3,1.61,0
De Minaur A.,19,272,161,111,Chardy J.,542,591,289,302,2021-03-15,Dubai ,Dubai Tennis Championships,Hard,1.36,3.2,0
Djere L.,38,243,120,123,Johnson S.,197,395,196,199,2021-03-16,Acapulco,Abierto Mexicano,Hard,1.9,1.9,1
Zapata Miralles B.,54,80,32,48,Sonego L.,43,221,107,114,2021-03-16,Dubai ,Dubai Tennis Championships,Hard,2.5,1.53,0
Gasquet R.,48,948,581,367,Hurkacz H.,17,238,137,101,2021-03-16,Dubai ,Dubai Tennis Championships,Hard,2.5,1.53,0
Karatsev A.,75,136,66,70,Evans D.,30,251,124,127,2021-03-16,Dubai ,Dubai Tennis Championships,Hard,1.9,1.9,1
Shapovalov D.,29,298,166,132,Struff J.L.,21,369,170,199,2021-03-16,Dubai ,Dubai Tennis Championships,Hard,1.53,2.5,1
Khachanov K.,11,378,217,161,Popyrin A.,90,140,59,81,2021-03-16,Dubai ,Dubai Tennis Championships,Hard,1.57,2.37,1
Bublik A.,25,219,110,109,Sinner J.,8,224,153,71,2021-03-16,Dubai ,Dubai Tennis Championships,Hard,2.75,1.44,0
Jaziri M.,444,217,83,134,Lajovic D.,66,378,163,215,2021-03-16,Dubai ,Dubai Tennis Championships,Hard,4.33,1.22,0
Ruusuvuori E.,55,158,79,79,Rublev A.,7,392,255,137,2021-03-16,Dubai ,Dubai Tennis Championships,Hard,5.5,1.14,0
Giustino L.,223,8,1,7,Bedene A.,347,291,131,160,2021-03-16,Dubai ,Dubai Tennis Championships,Hard,5.0,1.16,0
Ebden M.,432,203,75,128,Bautista Agut R.,25,379,234,145,2021-03-16,Dubai ,Dubai Tennis Championships,Hard,5.5,1.14,0
Fucsovics M.,67,249,121,128,Carreno Busta P.,16,352,214,138,2021-03-16,Dubai ,Dubai Tennis Championships,Hard,1.8,2.0,1
Basilashvili N.,118,301,138,163,Fritz T.,9,356,205,151,2021-03-16,Dubai ,Dubai Tennis Championships,Hard,2.3,1.61,0
Nishikori K.,439,617,408,209,Goffin D.,123,522,296,226,2021-03-16,Dubai ,Dubai Tennis Championships,Hard,2.2,1.66,1
Krajinovic F.,93,240,115,125,Davidovich Fokina A.,39,168,84,84,2021-03-16,Dubai ,Dubai Tennis Championships,Hard,2.0,1.8,1
Thiem D.,116,517,327,190,Harris L.,186,129,59,70,2021-03-16,Dubai ,Dubai Tennis Championships,Hard,1.25,4.0,0
Lopez Villasenor G.,654,4,0,4,Koepfer D.,84,86,38,48,2021-03-16,Acapulco,Abierto Mexicano,Hard,5.0,1.16,0
Auger-Aliassime F.,12,268,163,105,Sandgren T.,153,121,47,74,2021-03-16,Acapulco,Abierto Mexicano,Hard,1.25,4.0,1
Korda S.,26,126,75,51,Cilic M.,100,853,543,310,2021-03-16,Acapulco,Abierto Mexicano,Hard,1.72,2.1,1
Zverev A.,19,500,346,154,Alcaraz C.,1,164,130,34,2021-03-16,Acapulco,Abierto Mexicano,Hard,1.14,5.5,1
Caruso S.,146,63,19,44,Isner J.,114,755,465,290,2021-03-16,Acapulco,Abierto Mexicano,Hard,2.62,1.5,0
Norrie C.,13,287,172,115,Kozlov S.,108,35,9,26,2021-03-17,Acapulco,Abierto Mexicano,Hard,1.16,5.0,1
Paire B.,149,527,237,290,Tsitsipas S.,5,390,264,126,2021-03-17,Acapulco,Abierto Mexicano,Hard,10.0,1.06,0
Fognini F.,128,742,383,359,Travaglia S.,1024,81,27,54,2021-03-17,Acapulco,Abierto Mexicano,Hard,1.72,2.1,1
Kudla D.,137,198,70,128,Griekspoor T.,37,97,47,50,2021-03-17,Acapulco,Abierto Mexicano,Hard,2.3,1.61,0
Tiafoe F.,10,303,158,145,Nakashima B.,70,106,57,49,2021-03-17,Acapulco,Abierto Mexicano,Hard,1.9,1.9,1
Schwartzman D.,95,428,233,195,Musetti L.,18,143,79,64,2021-03-17,Acapulco,Abierto Mexicano,Hard,1.25,4.0,0
Raonic M.,849,540,361,179,Paul T.,14,204,111,93,2021-03-17,Acapulco,Abierto Mexicano,Hard,1.3,3.5,1
Shapovalov D.,29,298,166,132,Hurkacz H.,17,238,137,101,2021-03-17,Dubai ,Dubai Tennis Championships,Hard,1.53,2.5,1
Bautista Agut R.,25,379,234,145,Sinner J.,8,224,153,71,2021-03-17,Dubai ,Dubai Tennis Championships,Hard,1.72,2.1,0
Sonego L.,43,221,107,114,Karatsev A.,75,136,66,70,2021-03-17,Dubai ,Dubai Tennis Championships,Hard,2.37,1.57,0
Nishikori K.,439,617,408,209,Bedene A.,347,291,131,160,2021-03-17,Dubai ,Dubai Tennis Championships,Hard,1.44,2.75,1
Lajovic D.,66,378,163,215,Fucsovics M.,67,249,121,128,2021-03-17,Dubai ,Dubai Tennis Championships,Hard,2.62,1.5,0
Rublev A.,7,392,255,137,Fritz T.,9,356,205,151,2021-03-17,Dubai ,Dubai Tennis Championships,Hard,1.25,4.0,1
Harris L.,186,129,59,70,Krajinovic F.,93,240,115,125,2021-03-17,Dubai ,Dubai Tennis Championships,Hard,2.0,1.8,1
Khachanov K.,11,378,217,161,Chardy J.,542,591,289,302,2021-03-17,Dubai ,Dubai Tennis Championships,Hard,1.57,2.37,0
Mannarino A.,27,567,264,303,Dimitrov G.,20,651,389,262,2021-03-17,Acapulco,Abierto Mexicano,Hard,2.75,1.44,0
Lopez F.,634,863,441,422,Kecmanovic M.,40,210,107,103,2021-03-17,Acapulco,Abierto Mexicano,Hard,3.0,1.4,0
Galan D.E.,76,78,33,45,Ruud C.,4,275,176,99,2021-03-17,Acapulco,Abierto Mexicano,Hard,4.0,1.25,0
Tiafoe F.,10,303,158,145,Musetti L.,18,143,79,64,2021-03-18,Acapulco,Abierto Mexicano,Hard,1.57,2.37,0
Karatsev A.,75,136,66,70,Sinner J.,8,224,153,71,2021-03-18,Dubai ,Dubai Tennis Championships,Hard,2.62,1.5,1
Shapovalov D.,29,298,166,132,Chardy J.,542,591,289,302,2021-03-18,Dubai ,Dubai Tennis Championships,Hard,1.3,3.5,1
Nishikori K.,439,617,408,209,Harris L.,186,129,59,70,2021-03-18,Dubai ,Dubai Tennis Championships,Hard,1.8,2.0,0
Isner J.,114,755,465,290,Tsitsipas S.,5,390,264,126,2021-03-18,Acapulco,Abierto Mexicano,Hard,4.33,1.22,0
Rublev A.,7,392,255,137,Fucsovics M.,67,249,121,128,2021-03-18,Dubai ,Dubai Tennis Championships,Hard,1.16,5.0,1
Djere L.,38,243,120,123,Zverev A.,19,500,346,154,2021-03-18,Acapulco,Abierto Mexicano,Hard,8.0,1.08,0
Ruud C.,4,275,176,99,Griekspoor T.,37,97,47,50,2021-03-18,Acapulco,Abierto Mexicano,Hard,1.36,3.2,1
Dimitrov G.,20,651,389,262,Kecmanovic M.,40,210,107,103,2021-03-18,Acapulco,Abierto Mexicano,Hard,1.5,2.62,1
Korda S.,26,126,75,51,Auger-Aliassime F.,12,268,163,105,2021-03-18,Acapulco,Abierto Mexicano,Hard,2.37,1.57,0
Koepfer D.,84,86,38,48,Raonic M.,849,540,361,179,2021-03-18,Acapulco,Abierto Mexicano,Hard,7.0,1.1,1
Fognini F.,128,742,383,359,Norrie C.,13,287,172,115,2021-03-18,Acapulco,Abierto Mexicano,Hard,1.66,2.2,0
Zverev A.,19,500,346,154,Ruud C.,4,275,176,99,2021-03-19,Acapulco,Abierto Mexicano,Hard,1.2,4.5,1
Tsitsipas S.,5,390,264,126,Auger-Aliassime F.,12,268,163,105,2021-03-19,Acapulco,Abierto Mexicano,Hard,1.36,3.2,1
Musetti L.,18,143,79,64,Dimitrov G.,20,651,389,262,2021-03-19,Acapulco,Abierto Mexicano,Hard,3.75,1.28,1
Karatsev A.,75,136,66,70,Rublev A.,7,392,255,137,2021-03-19,Dubai ,Dubai Tennis Championships,Hard,4.33,1.22,1
Harris L.,186,129,59,70,Shapovalov D.,29,298,166,132,2021-03-19,Dubai ,Dubai Tennis Championships,Hard,3.0,1.4,1
Norrie C.,13,287,172,115,Koepfer D.,84,86,38,48,2021-03-19,Acapulco,Abierto Mexicano,Hard,1.57,2.37,0
Karatsev A.,75,136,66,70,Harris L.,186,129,59,70,2021-03-20,Dubai ,Dubai Tennis Championships,Hard,1.5,2.62,1
Tsitsipas S.,5,390,264,126,Musetti L.,18,143,79,64,2021-03-20,Acapulco,Abierto Mexicano,Hard,1.16,5.0,1
Koepfer D.,84,86,38,48,Zverev A.,19,500,346,154,2021-03-20,Acapulco,Abierto Mexicano,Hard,5.5,1.14,0
Zverev A.,19,500,346,154,Tsitsipas S.,5,390,264,126,2021-03-21,Acapulco,Abierto Mexicano,Hard,2.75,1.44,1
Djere L.,38,243,120,123,Vesely J.,528,288,130,158,2021-03-24,Miami,Miami Open,Hard,2.37,1.57,1
Mcdonald M.,60,190,87,103,Pospisil V.,99,280,122,158,2021-03-24,Miami,Miami Open,Hard,1.8,2.0,1
Nava E.,242,13,2,11,Harris L.,186,129,59,70,2021-03-24,Miami,Miami Open,Hard,4.5,1.2,0
Zverev M.,280,333,134,199,Duckworth J.,123,143,55,88,2021-03-24,Miami,Miami Open,Hard,2.37,1.57,0
Hanfmann Y.,50,99,50,49,Johnson S.,197,395,196,199,2021-03-24,Miami,Miami Open,Hard,1.66,2.2,1
Escobedo E.,377,57,20,37,Lorenzi P.,171,284,104,180,2021-03-24,Miami,Miami Open,Hard,1.25,4.0,1
Berankis R.,212,249,104,145,Gaio F.,174,18,3,15,2021-03-24,Miami,Miami Open,Hard,1.61,2.3,1
Querrey S.,287,678,369,309,Lu Y.,625,11,1,10,2021-03-24,Miami,Miami Open,Hard,1.12,6.0,0
Giron M.,69,150,68,82,Paul T.,14,204,111,93,2021-03-24,Miami,Miami Open,Hard,2.3,1.61,1
Ymer M.,59,130,58,72,Tabilo A.,122,44,21,23,2021-03-24,Miami,Miami Open,Hard,1.66,2.2,1
Nishioka Y.,31,215,99,116,Norrie C.,13,287,172,115,2021-03-24,Miami,Miami Open,Hard,2.37,1.57,0
Sousa P.,475,36,9,27,Herbert P.H.,157,202,89,113,2021-03-24,Miami,Miami Open,Hard,5.0,1.16,0
Lopez F.,634,863,441,422,Popyrin A.,90,140,59,81,2021-03-24,Miami,Miami Open,Hard,3.2,1.36,0
Gaston H.,109,58,24,34,Koepfer D.,84,86,38,48,2021-03-24,Miami,Miami Open,Hard,3.0,1.4,1
Coria F.,108,99,43,56,Cilic M.,100,853,543,310,2021-03-25,Miami,Miami Open,Hard,4.5,1.2,0
Korda S.,26,126,75,51,Albot R.,97,215,86,129,2021-03-25,Miami,Miami Open,Hard,1.4,3.0,1
Martinez P.,135,118,50,68,Sandgren T.,153,121,47,74,2021-03-25,Miami,Miami Open,Hard,2.37,1.57,0
Seyboth Wild T.,117,28,12,16,Galan D.E.,76,78,33,45,2021-03-25,Miami,Miami Open,Hard,1.9,1.9,0
Musetti L.,18,143,79,64,Mmoh M.,112,55,20,35,2021-03-25,Miami,Miami Open,Hard,1.53,2.5,1
Anderson K.,652,598,347,251,Dzumhur D.,202,234,107,127,2021-03-25,Miami,Miami Open,Hard,1.36,3.2,0
Kecmanovic M.,40,210,107,103,Broady L.,125,47,18,29,2021-03-25,Miami,Miami Open,Hard,1.33,3.4,1
Uchiyama Y.,314,33,9,24,Caruso S.,146,63,19,44,2021-03-25,Miami,Miami Open,Hard,3.2,1.36,1
Draper J.,55,51,29,22,Kukushkin M.,221,352,141,211,2021-03-25,Miami,Miami Open,Hard,2.62,1.5,0
Kudla D.,137,198,70,128,Chardy J.,542,591,289,302,2021-03-25,Miami,Miami Open,Hard,3.5,1.3,1
Fratangelo B.,695,62,22,40,Verdasco F.,244,962,537,425,2021-03-25,Miami,Miami Open,Hard,1.36,3.2,1
Ivashka I.,113,159,78,81,Kwon S.W.,68,108,53,55,2021-03-25,Miami,Miami Open,Hard,2.5,1.53,1
Kokkinakis T.,86,124,55,69,Mochizuki S.,200,8,0,8,2021-03-25,Miami,Miami Open,Hard,1.1,7.0,1
Travaglia S.,1024,81,27,54,Tiafoe F.,10,303,158,145,2021-03-25,Miami,Miami Open,Hard,3.5,1.3,0
Ruusuvuori E.,55,158,79,79,Alcaraz C.,1,164,130,34,2021-03-25,Miami,Miami Open,Hard,1.57,2.37,1
Thompson J.,71,221,96,125,Delbonis F.,131,340,152,188,2021-03-25,Miami,Miami Open,Hard,1.61,2.3,1
Tiafoe F.,10,303,158,145,Evans D.,30,251,124,127,2021-03-26,Miami,Miami Open,Hard,2.1,1.72,1
Djere L.,38,243,120,123,Bublik A.,25,219,110,109,2021-03-26,Miami,Miami Open,Hard,2.5,1.53,0
Zverev A.,19,500,346,154,Ruusuvuori E.,55,158,79,79,2021-03-26,Miami,Miami Open,Hard,1.16,5.0,0
Harris L.,186,129,59,70,Bautista Agut R.,25,379,234,145,2021-03-26,Miami,Miami Open,Hard,3.2,1.36,0
Hanfmann Y.,50,99,50,49,Khachanov K.,11,378,217,161,2021-03-26,Miami,Miami Open,Hard,4.5,1.2,0
Medvedev D.,3,406,289,117,Lu Y.,625,11,1,10,2021-03-26,Miami,Miami Open,Hard,1.01,23.0,1
Auger-Aliassime F.,12,268,163,105,Herbert P.H.,157,202,89,113,2021-03-26,Miami,Miami Open,Hard,1.5,2.62,1
Basilashvili N.,118,301,138,163,Ymer M.,59,130,58,72,2021-03-26,Miami,Miami Open,Hard,1.57,2.37,0
Gaston H.,109,58,24,34,Sinner J.,8,224,153,71,2021-03-26,Miami,Miami Open,Hard,5.0,1.16,0
Dimitrov G.,20,651,389,262,Norrie C.,13,287,172,115,2021-03-26,Miami,Miami Open,Hard,1.5,2.62,0
Fritz T.,9,356,205,151,Giron M.,69,150,68,82,2021-03-26,Miami,Miami Open,Hard,1.5,2.62,1
Escobedo E.,377,57,20,37,Lajovic D.,66,378,163,215,2021-03-26,Miami,Miami Open,Hard,2.2,1.66,0
Duckworth J.,123,143,55,88,Goffin D.,123,522,296,226,2021-03-26,Miami,Miami Open,Hard,5.0,1.16,1
Popyrin A.,90,140,59,81,Opelka R.,17,168,88,80,2021-03-26,Miami,Miami Open,Hard,2.1,1.72,1
Bedene A.,347,291,131,160,Fabbiano T.,192,89,27,62,2021-03-26,Miami,Miami Open,Hard,1.28,3.75,1
Sousa J.,147,436,189,247,O Connell C.,74,65,26,39,2021-03-26,Miami,Miami Open,Hard,3.4,1.33,1
Struff J.L.,21,369,170,199,Berankis R.,212,249,104,145,2021-03-26,Miami,Miami Open,Hard,1.4,3.0,1
Rublev A.,7,392,255,137,Sandgren T.,153,121,47,74,2021-03-27,Miami,Miami Open,Hard,1.1,7.0,1
Ivashka I.,113,159,78,81,Shapovalov D.,29,298,166,132,2021-03-27,Miami,Miami Open,Hard,6.5,1.11,0
Mannarino A.,27,567,264,303,Kecmanovic M.,40,210,107,103,2021-03-27,Miami,Miami Open,Hard,2.0,1.8,1
Sousa J.,147,436,189,247,Humbert U.,36,170,80,90,2021-03-27,Miami,Miami Open,Hard,5.0,1.16,0
Kukushkin M.,221,352,141,211,Karatsev A.,75,136,66,70,2021-03-27,Miami,Miami Open,Hard,5.5,1.14,0
Garin C.,101,190,103,87,Cilic M.,100,853,543,310,2021-03-27,Miami,Miami Open,Hard,2.0,1.8,0
Galan D.E.,76,78,33,45,De Minaur A.,19,272,161,111,2021-03-27,Miami,Miami Open,Hard,6.0,1.12,1
Kokkinakis T.,86,124,55,69,Fucsovics M.,67,249,121,128,2021-03-27,Miami,Miami Open,Hard,2.2,1.66,0
Tsitsipas S.,5,390,264,126,Dzumhur D.,202,234,107,127,2021-03-27,Miami,Miami Open,Hard,1.08,8.0,1
Hurkacz H.,17,238,137,101,Kudla D.,137,198,70,128,2021-03-27,Miami,Miami Open,Hard,1.4,3.0,1
Raonic M.,849,540,361,179,Thompson J.,71,221,96,125,2021-03-27,Miami,Miami Open,Hard,1.16,5.0,1
Nishikori K.,439,617,408,209,Bedene A.,347,291,131,160,2021-03-27,Miami,Miami Open,Hard,1.4,3.0,1
Fratangelo B.,695,62,22,40,Sonego L.,43,221,107,114,2021-03-27,Miami,Miami Open,Hard,2.3,1.61,0
Mcdonald M.,60,190,87,103,Isner J.,114,755,465,290,2021-03-27,Miami,Miami Open,Hard,1.72,2.1,0
Paire B.,149,527,237,290,Musetti L.,18,143,79,64,2021-03-27,Miami,Miami Open,Hard,4.5,1.2,0
Medvedev D.,3,406,289,117,Popyrin A.,90,140,59,81,2021-03-28,Miami,Miami Open,Hard,1.11,6.5,1
Sinner J.,8,224,153,71,Khachanov K.,11,378,217,161,2021-03-28,Miami,Miami Open,Hard,1.57,2.37,1
Isner J.,114,755,465,290,Auger-Aliassime F.,12,268,163,105,2021-03-28,Miami,Miami Open,Hard,2.75,1.44,1
Ymer M.,59,130,58,72,Ruusuvuori E.,55,158,79,79,2021-03-28,Miami,Miami Open,Hard,2.62,1.5,0
Schwartzman D.,95,428,233,195,Uchiyama Y.,314,33,9,24,2021-03-28,Miami,Miami Open,Hard,1.14,5.5,1
Fognini F.,128,742,383,359,Korda S.,26,126,75,51,2021-03-28,Miami,Miami Open,Hard,2.5,1.53,0
Bautista Agut R.,25,379,234,145,Struff J.L.,21,369,170,199,2021-03-28,Miami,Miami Open,Hard,1.28,3.75,1
Norrie C.,13,287,172,115,Fritz T.,9,356,205,151,2021-03-29,Miami,Miami Open,Hard,2.3,1.61,0
Duckworth J.,123,143,55,88,Bublik A.,25,219,110,109,2021-03-29,Miami,Miami Open,Hard,3.0,1.4,0
Lajovic D.,66,378,163,215,Tiafoe F.,10,303,158,145,2021-03-29,Miami,Miami Open,Hard,2.5,1.53,0
Raonic M.,849,540,361,179,Humbert U.,36,170,80,90,2021-03-29,Miami,Miami Open,Hard,1.5,2.62,1
Musetti L.,18,143,79,64,Cilic M.,100,853,543,310,2021-03-29,Miami,Miami Open,Hard,1.66,2.2,0
Hurkacz H.,17,238,137,101,Shapovalov D.,29,298,166,132,2021-03-29,Miami,Miami Open,Hard,2.75,1.44,1
Rublev A.,7,392,255,137,Fucsovics M.,67,249,121,128,2021-03-29,Miami,Miami Open,Hard,1.14,5.5,1
Mannarino A.,27,567,264,303,Schwartzman D.,95,428,233,195,2021-03-29,Miami,Miami Open,Hard,3.4,1.33,0
Karatsev A.,75,136,66,70,Korda S.,26,126,75,51,2021-03-29,Miami,Miami Open,Hard,1.4,3.0,0
Sonego L.,43,221,107,114,Galan D.E.,76,78,33,45,2021-03-29,Miami,Miami Open,Hard,1.33,3.4,1
Korda S.,26,126,75,51,Schwartzman D.,95,428,233,195,2021-03-30,Miami,Miami Open,Hard,2.37,1.57,1
Tiafoe F.,10,303,158,145,Medvedev D.,3,406,289,117,2021-03-30,Miami,Miami Open,Hard,5.5,1.14,0
Raonic M.,849,540,361,179,Hurkacz H.,17,238,137,101,2021-03-30,Miami,Miami Open,Hard,1.36,3.2,0
Isner J.,114,755,465,290,Bautista Agut R.,25,379,234,145,2021-03-30,Miami,Miami Open,Hard,2.5,1.53,0
Ruusuvuori E.,55,158,79,79,Sinner J.,8,224,153,71,2021-03-30,Miami,Miami Open,Hard,2.75,1.44,0
Nishikori K.,439,617,408,209,Tsitsipas S.,5,390,264,126,2021-03-30,Miami,Miami Open,Hard,4.5,1.2,0
Fritz T.,9,356,205,151,Bublik A.,25,219,110,109,2021-03-30,Miami,Miami Open,Hard,1.61,2.3,0
Cilic M.,100,853,543,310,Rublev A.,7,392,255,137,2021-03-31,Miami,Miami Open,Hard,7.0,1.1,0
Sonego L.,43,221,107,114,Tsitsipas S.,5,390,264,126,2021-03-31,Miami,Miami Open,Hard,6.0,1.12,0
Sinner J.,8,224,153,71,Bublik A.,25,219,110,109,2021-03-31,Miami,Miami Open,Hard,1.36,3.2,1
Bautista Agut R.,25,379,234,145,Medvedev D.,3,406,289,117,2021-04-01,Miami,Miami Open,Hard,3.5,1.3,1
Tsitsipas S.,5,390,264,126,Hurkacz H.,17,238,137,101,2021-04-01,Miami,Miami Open,Hard,1.2,4.5,0
Korda S.,26,126,75,51,Rublev A.,7,392,255,137,2021-04-02,Miami,Miami Open,Hard,4.5,1.2,0
Bautista Agut R.,25,379,234,145,Sinner J.,8,224,153,71,2021-04-02,Miami,Miami Open,Hard,1.8,2.0,0
Rublev A.,7,392,255,137,Hurkacz H.,17,238,137,101,2021-04-03,Miami,Miami Open,Hard,1.22,4.33,0
Sinner J.,8,224,153,71,Hurkacz H.,17,238,137,101,2021-04-04,Miami,Miami Open,Hard,1.57,2.37,0
Delbonis F.,131,340,152,188,Carballes Baena R.,64,207,91,116,2021-04-05,Marbella,AnyTech365 Andalucia Open,Hard,1.66,2.2,1
Gombos N.,114,66,21,45,Londero J.I.,142,83,34,49,2021-04-05,Marbella,AnyTech365 Andalucia Open,Hard,2.1,1.72,1
Pouille L.,675,259,134,125,Berankis R.,212,249,104,145,2021-04-05,Marbella,AnyTech365 Andalucia Open,Hard,1.5,2.62,0
Rune H.,6,131,83,48,Kwon S.W.,68,108,53,55,2021-04-05,Marbella,AnyTech365 Andalucia Open,Hard,1.33,3.4,0
Zeppieri G.,129,13,4,9,Bedene A.,347,291,131,160,2021-04-05,Cagliari,Sardegna Open,Hard,3.5,1.3,0
Gerasimov E.,150,93,43,50,Pella G.,199,260,118,142,2021-04-05,Cagliari,Sardegna Open,Hard,2.5,1.53,1
Gaio F.,174,18,3,15,Djere L.,38,243,120,123,2021-04-05,Cagliari,Sardegna Open,Hard,3.75,1.28,0
Paul T.,14,204,111,93,Hanfmann Y.,50,99,50,49,2021-04-05,Cagliari,Sardegna Open,Hard,1.9,1.9,0
Struff J.L.,21,369,170,199,Sousa J.,147,436,189,247,2021-04-06,Cagliari,Sardegna Open,Hard,1.25,4.0,1
Dzumhur D.,202,234,107,127,Davidovich Fokina A.,39,168,84,84,2021-04-06,Marbella,AnyTech365 Andalucia Open,Hard,3.75,1.28,0
Mager G.,67,59,24,35,Kukushkin M.,221,352,141,211,2021-04-06,Marbella,AnyTech365 Andalucia Open,Hard,1.36,3.2,1
Daniel T.,111,178,67,111,Lopez F.,634,863,441,422,2021-04-06,Marbella,AnyTech365 Andalucia Open,Hard,1.66,2.2,0
Vilella Martinez M.,167,10,4,6,Zapata Miralles B.,54,80,32,48,2021-04-06,Marbella,AnyTech365 Andalucia Open,Hard,2.3,1.61,1
Bagnis F.,135,121,39,82,Cerundolo F.,21,104,58,46,2021-04-06,Marbella,AnyTech365 Andalucia Open,Hard,2.1,1.72,1
Martinez P.,135,118,50,68,Ivashka I.,113,159,78,81,2021-04-06,Marbella,AnyTech365 Andalucia Open,Hard,1.5,2.62,0
Milojevic N.,136,14,6,8,Alcaraz C.,1,164,130,34,2021-04-06,Marbella,AnyTech365 Andalucia Open,Hard,3.0,1.4,0
Laaksonen H.,125,101,37,64,Munar J.,104,178,75,103,2021-04-06,Marbella,AnyTech365 Andalucia Open,Hard,4.0,1.25,0
Coria F.,108,99,43,56,Millman J.,140,256,113,143,2021-04-06,Cagliari,Sardegna Open,Hard,1.53,2.5,0
Cecchinato M.,108,204,79,125,Fabbiano T.,192,89,27,62,2021-04-06,Cagliari,Sardegna Open,Hard,1.25,4.0,1
Vesely J.,528,288,130,158,Martin A.,723,258,107,151,2021-04-06,Cagliari,Sardegna Open,Hard,1.5,2.62,0
Simon G.,188,869,491,378,Travaglia S.,1024,81,27,54,2021-04-06,Cagliari,Sardegna Open,Hard,3.4,1.33,1
Huesler M.A.,88,58,21,37,Broady L.,125,47,18,29,2021-04-06,Cagliari,Sardegna Open,Hard,1.72,2.1,0
Kovalik J.,172,68,24,44,Nagal S.,503,17,3,14,2021-04-06,Cagliari,Sardegna Open,Hard,2.62,1.5,1
Musetti L.,18,143,79,64,Novak D.,166,58,15,43,2021-04-06,Cagliari,Sardegna Open,Hard,1.22,4.33,1
Bagnis F.,135,121,39,82,Kwon S.W.,68,108,53,55,2021-04-07,Marbella,AnyTech365 Andalucia Open,Hard,1.3,3.5,0
Delbonis F.,131,340,152,188,Gombos N.,114,66,21,45,2021-04-07,Marbella,AnyTech365 Andalucia Open,Hard,1.33,3.4,0
Fritz T.,9,356,205,151,Martin A.,723,258,107,151,2021-04-07,Cagliari,Sardegna Open,Hard,1.57,2.37,1
Basilashvili N.,118,301,138,163,Kovalik J.,172,68,24,44,2021-04-07,Cagliari,Sardegna Open,Hard,1.8,2.0,1
Bedene A.,347,291,131,160,Gerasimov E.,150,93,43,50,2021-04-07,Cagliari,Sardegna Open,Hard,1.8,2.0,1
Struff J.L.,21,369,170,199,Broady L.,125,47,18,29,2021-04-07,Cagliari,Sardegna Open,Hard,1.57,2.37,1
Berankis R.,212,249,104,145,Ramos-Vinolas A.,82,437,204,233,2021-04-07,Marbella,AnyTech365 Andalucia Open,Hard,3.5,1.3,0
Carreno Busta P.,16,352,214,138,Vilella Martinez M.,167,10,4,6,2021-04-07,Marbella,AnyTech365 Andalucia Open,Hard,1.4,3.0,1
Cecchinato M.,108,204,79,125,Hanfmann Y.,50,99,50,49,2021-04-08,Cagliari,Sardegna Open,Hard,2.0,1.8,0
Davidovich Fokina A.,39,168,84,84,Ivashka I.,113,159,78,81,2021-04-08,Marbella,AnyTech365 Andalucia Open,Hard,1.25,4.0,0
Fognini F.,128,742,383,359,Munar J.,104,178,75,103,2021-04-08,Marbella,AnyTech365 Andalucia Open,Hard,2.1,1.72,0
Ruud C.,4,275,176,99,Mager G.,67,59,24,35,2021-04-08,Marbella,AnyTech365 Andalucia Open,Hard,1.53,2.5,1
Lopez F.,634,863,441,422,Alcaraz C.,1,164,130,34,2021-04-08,Marbella,AnyTech365 Andalucia Open,Hard,3.2,1.36,0
Musetti L.,18,143,79,64,Evans D.,30,251,124,127,2021-04-08,Cagliari,Sardegna Open,Hard,1.3,3.5,1
Millman J.,140,256,113,143,Djere L.,38,243,120,123,2021-04-08,Cagliari,Sardegna Open,Hard,3.5,1.3,0
Simon G.,188,869,491,378,Sonego L.,43,221,107,114,2021-04-08,Cagliari,Sardegna Open,Hard,3.2,1.36,0
Basilashvili N.,118,301,138,163,Struff J.L.,21,369,170,199,2021-04-09,Cagliari,Sardegna Open,Hard,2.5,1.53,1
Djere L.,38,243,120,123,Musetti L.,18,143,79,64,2021-04-09,Cagliari,Sardegna Open,Hard,2.0,1.8,1
Sonego L.,43,221,107,114,Hanfmann Y.,50,99,50,49,2021-04-09,Cagliari,Sardegna Open,Hard,1.53,2.5,1
Fritz T.,9,356,205,151,Bedene A.,347,291,131,160,2021-04-09,Cagliari,Sardegna Open,Hard,1.8,2.0,1
Gombos N.,114,66,21,45,Ramos-Vinolas A.,82,437,204,233,2021-04-09,Marbella,AnyTech365 Andalucia Open,Hard,3.0,1.4,0
Ivashka I.,113,159,78,81,Munar J.,104,178,75,103,2021-04-09,Marbella,AnyTech365 Andalucia Open,Hard,3.2,1.36,0
Kwon S.W.,68,108,53,55,Carreno Busta P.,16,352,214,138,2021-04-09,Marbella,AnyTech365 Andalucia Open,Hard,4.33,1.22,0
Alcaraz C.,1,164,130,34,Ruud C.,4,275,176,99,2021-04-09,Marbella,AnyTech365 Andalucia Open,Hard,2.75,1.44,1
Basilashvili N.,118,301,138,163,Djere L.,38,243,120,123,2021-04-10,Cagliari,Sardegna Open,Hard,2.62,1.5,0
Fritz T.,9,356,205,151,Sonego L.,43,221,107,114,2021-04-10,Cagliari,Sardegna Open,Hard,2.1,1.72,0
Ramos-Vinolas A.,82,437,204,233,Carreno Busta P.,16,352,214,138,2021-04-10,Marbella,AnyTech365 Andalucia Open,Hard,3.0,1.4,0
Alcaraz C.,1,164,130,34,Munar J.,104,178,75,103,2021-04-10,Marbella,AnyTech365 Andalucia Open,Hard,1.57,2.37,0
Sonego L.,43,221,107,114,Djere L.,38,243,120,123,2021-04-11,Cagliari,Sardegna Open,Hard,2.2,1.66,1
Thompson J.,71,221,96,125,Paire B.,149,527,237,290,2021-04-11,Monte Carlo,Monte Carlo Masters,Clay,1.8,2.0,1
Munar J.,104,178,75,103,Carreno Busta P.,16,352,214,138,2021-04-11,Marbella,AnyTech365 Andalucia Open,Hard,2.37,1.57,0
Cilic M.,100,853,543,310,Goffin D.,123,522,296,226,2021-04-11,Monte Carlo,Monte Carlo Masters,Clay,2.1,1.72,0
Davidovich Fokina A.,39,168,84,84,De Minaur A.,19,272,161,111,2021-04-12,Monte Carlo,Monte Carlo Masters,Clay,1.66,2.2,1
Musetti L.,18,143,79,64,Karatsev A.,75,136,66,70,2021-04-12,Monte Carlo,Monte Carlo Masters,Clay,2.0,1.8,0
Humbert U.,36,170,80,90,Millman J.,140,256,113,143,2021-04-12,Monte Carlo,Monte Carlo Masters,Clay,1.5,2.62,0
Martinez P.,135,118,50,68,Paul T.,14,204,111,93,2021-04-12,Monte Carlo,Monte Carlo Masters,Clay,2.0,1.8,0
Popyrin A.,90,140,59,81,Andujar P.,323,404,164,240,2021-04-13,Monte Carlo,Monte Carlo Masters,Clay,1.5,2.62,1
Davidovich Fokina A.,39,168,84,84,Berrettini M.,38,217,142,75,2021-04-13,Monte Carlo,Monte Carlo Masters,Clay,2.0,1.8,1
Basilashvili N.,118,301,138,163,Krajinovic F.,93,240,115,125,2021-04-13,Monte Carlo,Monte Carlo Masters,Clay,3.2,1.36,0
Travaglia S.,1024,81,27,54,Carreno Busta P.,16,352,214,138,2021-04-13,Monte Carlo,Monte Carlo Masters,Clay,2.75,1.44,0
Djere L.,38,243,120,123,Khachanov K.,11,378,217,161,2021-04-13,Monte Carlo,Monte Carlo Masters,Clay,2.2,1.66,0
Sonego L.,43,221,107,114,Fucsovics M.,67,249,121,128,2021-04-13,Monte Carlo,Monte Carlo Masters,Clay,2.3,1.61,1
Dimitrov G.,20,651,389,262,Struff J.L.,21,369,170,199,2021-04-13,Monte Carlo,Monte Carlo Masters,Clay,1.61,2.3,1
Ruud C.,4,275,176,99,Rune H.,6,131,83,48,2021-04-13,Monte Carlo,Monte Carlo Masters,Clay,1.16,5.0,1
Fritz T.,9,356,205,151,Bautista Agut R.,25,379,234,145,2021-04-13,Monte Carlo,Monte Carlo Masters,Clay,3.2,1.36,0
Karatsev A.,75,136,66,70,Tsitsipas S.,5,390,264,126,2021-04-13,Monte Carlo,Monte Carlo Masters,Clay,2.5,1.53,0
Bublik A.,25,219,110,109,Chardy J.,542,591,289,302,2021-04-13,Monte Carlo,Monte Carlo Masters,Clay,2.2,1.66,0
Cecchinato M.,108,204,79,125,Koepfer D.,84,86,38,48,2021-04-13,Monte Carlo,Monte Carlo Masters,Clay,2.0,1.8,1
Sinner J.,8,224,153,71,Ramos-Vinolas A.,82,437,204,233,2021-04-13,Monte Carlo,Monte Carlo Masters,Clay,1.33,3.4,1
Delbonis F.,131,340,152,188,Mannarino A.,27,567,264,303,2021-04-13,Monte Carlo,Monte Carlo Masters,Clay,1.28,3.75,1
Pella G.,199,260,118,142,Pouille L.,675,259,134,125,2021-04-13,Monte Carlo,Monte Carlo Masters,Clay,1.8,2.0,0
Caruso S.,146,63,19,44,Catarina L.,430,4,0,4,2021-04-13,Monte Carlo,Monte Carlo Masters,Clay,1.14,5.5,1
Hurkacz H.,17,238,137,101,Fabbiano T.,192,89,27,62,2021-04-13,Monte Carlo,Monte Carlo Masters,Clay,1.25,4.0,1
Evans D.,30,251,124,127,Lajovic D.,66,378,163,215,2021-04-13,Monte Carlo,Monte Carlo Masters,Clay,2.5,1.53,1
Auger-Aliassime F.,12,268,163,105,Garin C.,101,190,103,87,2021-04-13,Monte Carlo,Monte Carlo Masters,Clay,1.72,2.1,0
Fognini F.,128,742,383,359,Kecmanovic M.,40,210,107,103,2021-04-13,Monte Carlo,Monte Carlo Masters,Clay,1.57,2.37,1
Londero J.I.,142,83,34,49,Krajinovic F.,93,240,115,125,2021-04-14,Monte Carlo,Monte Carlo Masters,Clay,5.0,1.16,0
Zverev A.,19,500,346,154,Sonego L.,43,221,107,114,2021-04-14,Monte Carlo,Monte Carlo Masters,Clay,1.44,2.75,1
Carreno Busta P.,16,352,214,138,Khachanov K.,11,378,217,161,2021-04-14,Monte Carlo,Monte Carlo Masters,Clay,2.0,1.8,1
Nadal R.,2,1223,1017,206,Delbonis F.,131,340,152,188,2021-04-14,Monte Carlo,Monte Carlo Masters,Clay,1.04,13.0,1
Paul T.,14,204,111,93,Bautista Agut R.,25,379,234,145,2021-04-14,Monte Carlo,Monte Carlo Masters,Clay,4.0,1.25,0
Hurkacz H.,17,238,137,101,Evans D.,30,251,124,127,2021-04-14,Monte Carlo,Monte Carlo Masters,Clay,1.53,2.5,0
Pouille L.,675,259,134,125,Popyrin A.,90,140,59,81,2021-04-14,Monte Carlo,Monte Carlo Masters,Clay,2.2,1.66,1
Thompson J.,71,221,96,125,Fognini F.,128,742,383,359,2021-04-14,Monte Carlo,Monte Carlo Masters,Clay,4.5,1.2,0
Ruud C.,4,275,176,99,Schwartzman D.,95,428,233,195,2021-04-14,Monte Carlo,Monte Carlo Masters,Clay,2.5,1.53,1
Sinner J.,8,224,153,71,Djokovic N.,2,1207,1012,195,2021-04-14,Monte Carlo,Monte Carlo Masters,Clay,3.4,1.33,0
Caruso S.,146,63,19,44,Rublev A.,7,392,255,137,2021-04-14,Monte Carlo,Monte Carlo Masters,Clay,8.0,1.08,0
Millman J.,140,256,113,143,Garin C.,101,190,103,87,2021-04-14,Monte Carlo,Monte Carlo Masters,Clay,3.75,1.28,0
Chardy J.,542,591,289,302,Dimitrov G.,20,651,389,262,2021-04-14,Monte Carlo,Monte Carlo Masters,Clay,3.0,1.4,0
Cecchinato M.,108,204,79,125,Goffin D.,123,522,296,226,2021-04-14,Monte Carlo,Monte Carlo Masters,Clay,2.37,1.57,0
Dimitrov G.,20,651,389,262,Nadal R.,2,1223,1017,206,2021-04-15,Monte Carlo,Monte Carlo Masters,Clay,11.0,1.05,0
Ruud C.,4,275,176,99,Carreno Busta P.,16,352,214,138,2021-04-15,Monte Carlo,Monte Carlo Masters,Clay,1.9,1.9,1
Krajinovic F.,93,240,115,125,Fognini F.,128,742,383,359,2021-04-15,Monte Carlo,Monte Carlo Masters,Clay,1.8,2.0,0
Rublev A.,7,392,255,137,Bautista Agut R.,25,379,234,145,2021-04-15,Monte Carlo,Monte Carlo Masters,Clay,1.44,2.75,1
Zverev A.,19,500,346,154,Goffin D.,123,522,296,226,2021-04-15,Monte Carlo,Monte Carlo Masters,Clay,1.53,2.5,0
Pouille L.,675,259,134,125,Davidovich Fokina A.,39,168,84,84,2021-04-15,Monte Carlo,Monte Carlo Masters,Clay,3.75,1.28,0
Djokovic N.,2,1207,1012,195,Evans D.,30,251,124,127,2021-04-15,Monte Carlo,Monte Carlo Masters,Clay,1.05,11.0,0
Tsitsipas S.,5,390,264,126,Garin C.,101,190,103,87,2021-04-15,Monte Carlo,Monte Carlo Masters,Clay,1.33,3.4,1
Davidovich Fokina A.,39,168,84,84,Tsitsipas S.,5,390,264,126,2021-04-16,Monte Carlo,Monte Carlo Masters,Clay,4.33,1.22,0
Evans D.,30,251,124,127,Goffin D.,123,522,296,226,2021-04-16,Monte Carlo,Monte Carlo Masters,Clay,2.5,1.53,1
Fognini F.,128,742,383,359,Ruud C.,4,275,176,99,2021-04-16,Monte Carlo,Monte Carlo Masters,Clay,2.1,1.72,0
Nadal R.,2,1223,1017,206,Rublev A.,7,392,255,137,2021-04-16,Monte Carlo,Monte Carlo Masters,Clay,1.11,6.5,0
Ruud C.,4,275,176,99,Rublev A.,7,392,255,137,2021-04-17,Monte Carlo,Monte Carlo Masters,Clay,3.4,1.33,0
Evans D.,30,251,124,127,Tsitsipas S.,5,390,264,126,2021-04-17,Monte Carlo,Monte Carlo Masters,Clay,5.0,1.16,0
Rublev A.,7,392,255,137,Tsitsipas S.,5,390,264,126,2021-04-18,Monte Carlo,Monte Carlo Masters,Clay,1.8,2.0,0
Pella G.,199,260,118,142,Nishikori K.,439,617,408,209,2021-04-19,Barcelona,Barcelona Open,Clay,3.5,1.3,0
Krajinovic F.,93,240,115,125,Travaglia S.,1024,81,27,54,2021-04-19,Belgrade,Serbia Open,Clay,1.4,3.0,1
Munar J.,104,178,75,103,Monteiro T.,121,171,69,102,2021-04-19,Barcelona,Barcelona Open,Clay,1.36,3.2,1
Ivashka I.,113,159,78,81,Griekspoor T.,37,97,47,50,2021-04-19,Barcelona,Barcelona Open,Clay,1.44,2.75,1
Gaio F.,174,18,3,15,Paire B.,149,527,237,290,2021-04-19,Barcelona,Barcelona Open,Clay,2.3,1.61,1
Petrovic D.,157,5,2,3,Millman J.,140,256,113,143,2021-04-19,Belgrade,Serbia Open,Clay,2.75,1.44,0
Caruso S.,146,63,19,44,Norrie C.,13,287,172,115,2021-04-19,Barcelona,Barcelona Open,Clay,1.61,2.3,0
Herbert P.H.,157,202,89,113,Nagal S.,503,17,3,14,2021-04-19,Barcelona,Barcelona Open,Clay,1.8,2.0,1
Zapata Miralles B.,54,80,32,48,Kuznetsov An.,228,162,70,92,2021-04-19,Barcelona,Barcelona Open,Clay,1.57,2.37,1
Andujar P.,323,404,164,240,Simon G.,188,869,491,378,2021-04-19,Barcelona,Barcelona Open,Clay,1.53,2.5,1
Chardy J.,542,591,289,302,Basilashvili N.,118,301,138,163,2021-04-19,Barcelona,Barcelona Open,Clay,1.4,3.0,1
Cecchinato M.,108,204,79,125,Troicki V.,230,525,269,256,2021-04-19,Belgrade,Serbia Open,Clay,1.25,4.0,1
Tsonga J.W.,297,672,444,228,Gerasimov E.,150,93,43,50,2021-04-19,Barcelona,Barcelona Open,Clay,3.2,1.36,0
Coria F.,108,99,43,56,Milojevic N.,136,14,6,8,2021-04-19,Belgrade,Serbia Open,Clay,2.3,1.61,0
Korda S.,26,126,75,51,Bedene A.,347,291,131,160,2021-04-20,Belgrade,Serbia Open,Clay,1.57,2.37,0
Cerundolo F.,21,104,58,46,Popyrin A.,90,140,59,81,2021-04-20,Belgrade,Serbia Open,Clay,2.1,1.72,0
Djere L.,38,243,120,123,Mager G.,67,59,24,35,2021-04-20,Belgrade,Serbia Open,Clay,1.3,3.5,0
Kecmanovic M.,40,210,107,103,Bagnis F.,135,121,39,82,2021-04-20,Belgrade,Serbia Open,Clay,1.8,2.0,1
Daniel T.,111,178,67,111,Sousa J.,147,436,189,247,2021-04-20,Belgrade,Serbia Open,Clay,,,1
Berankis R.,212,249,104,145,Delbonis F.,131,340,152,188,2021-04-20,Belgrade,Serbia Open,Clay,2.75,1.44,0
Carballes Baena R.,64,207,91,116,Kwon S.W.,68,108,53,55,2021-04-20,Belgrade,Serbia Open,Clay,1.5,2.62,0
Londero J.I.,142,83,34,49,Rinderknech A.,67,96,46,50,2021-04-20,Belgrade,Serbia Open,Clay,2.75,1.44,0
Khachanov K.,11,378,217,161,Norrie C.,13,287,172,115,2021-04-20,Barcelona,Barcelona Open,Clay,1.33,3.4,0
Bautista Agut R.,25,379,234,145,Andujar P.,323,404,164,240,2021-04-20,Barcelona,Barcelona Open,Clay,1.16,5.0,1
Rune H.,6,131,83,48,Ramos-Vinolas A.,82,437,204,233,2021-04-20,Barcelona,Barcelona Open,Clay,3.0,1.4,0
Gasquet R.,48,948,581,367,Thompson J.,71,221,96,125,2021-04-20,Barcelona,Barcelona Open,Clay,1.72,2.1,0
Koepfer D.,84,86,38,48,Moutet C.,80,118,50,68,2021-04-20,Barcelona,Barcelona Open,Clay,1.61,2.3,0
Musetti L.,18,143,79,64,Lopez F.,634,863,441,422,2021-04-20,Barcelona,Barcelona Open,Clay,1.28,3.75,1
Davidovich Fokina A.,39,168,84,84,Bublik A.,25,219,110,109,2021-04-20,Barcelona,Barcelona Open,Clay,1.5,2.62,0
Tiafoe F.,10,303,158,145,Alcaraz C.,1,164,130,34,2021-04-20,Barcelona,Barcelona Open,Clay,2.5,1.53,1
Goffin D.,123,522,296,226,Herbert P.H.,157,202,89,113,2021-04-20,Barcelona,Barcelona Open,Clay,1.4,3.0,1
Shapovalov D.,29,298,166,132,Chardy J.,542,591,289,302,2021-04-20,Barcelona,Barcelona Open,Clay,1.53,2.5,1
Gerasimov E.,150,93,43,50,Sinner J.,8,224,153,71,2021-04-20,Barcelona,Barcelona Open,Clay,6.0,1.12,0
Krajinovic F.,93,240,115,125,Milojevic N.,136,14,6,8,2021-04-21,Belgrade,Serbia Open,Clay,1.3,3.5,1
Berrettini M.,38,217,142,75,Cecchinato M.,108,204,79,125,2021-04-21,Belgrade,Serbia Open,Clay,1.53,2.5,1
Djokovic N.,2,1207,1012,195,Kwon S.W.,68,108,53,55,2021-04-21,Belgrade,Serbia Open,Clay,1.01,21.0,1
Kecmanovic M.,40,210,107,103,Rinderknech A.,67,96,46,50,2021-04-21,Belgrade,Serbia Open,Clay,1.53,2.5,1
Mannarino A.,27,567,264,303,Ramos-Vinolas A.,82,437,204,233,2021-04-21,Barcelona,Barcelona Open,Clay,4.0,1.25,0
Gaio F.,174,18,3,15,Rublev A.,7,392,255,137,2021-04-21,Barcelona,Barcelona Open,Clay,13.0,1.04,0
Musetti L.,18,143,79,64,Auger-Aliassime F.,12,268,163,105,2021-04-21,Barcelona,Barcelona Open,Clay,2.0,1.8,0
Moutet C.,80,118,50,68,Evans D.,30,251,124,127,2021-04-21,Barcelona,Barcelona Open,Clay,2.1,1.72,1
Munar J.,104,178,75,103,Tsitsipas S.,5,390,264,126,2021-04-21,Barcelona,Barcelona Open,Clay,4.33,1.22,0
Thompson J.,71,221,96,125,Carreno Busta P.,16,352,214,138,2021-04-21,Barcelona,Barcelona Open,Clay,6.0,1.12,0
Zapata Miralles B.,54,80,32,48,Fognini F.,128,742,383,359,2021-04-21,Barcelona,Barcelona Open,Clay,2.75,1.44,1
Ivashka I.,113,159,78,81,Nadal R.,2,1223,1017,206,2021-04-21,Barcelona,Barcelona Open,Clay,19.0,1.02,0
Nishikori K.,439,617,408,209,Garin C.,101,190,103,87,2021-04-21,Barcelona,Barcelona Open,Clay,2.62,1.5,1
Schwartzman D.,95,428,233,195,Tiafoe F.,10,303,158,145,2021-04-21,Barcelona,Barcelona Open,Clay,1.36,3.2,1
De Minaur A.,19,272,161,111,Bublik A.,25,219,110,109,2021-04-21,Barcelona,Barcelona Open,Clay,1.66,2.2,1
Zapata Miralles B.,54,80,32,48,Carreno Busta P.,16,352,214,138,2021-04-22,Barcelona,Barcelona Open,Clay,4.5,1.2,0
Ramos-Vinolas A.,82,437,204,233,Rublev A.,7,392,255,137,2021-04-22,Barcelona,Barcelona Open,Clay,5.0,1.16,0
Shapovalov D.,29,298,166,132,Auger-Aliassime F.,12,268,163,105,2021-04-22,Barcelona,Barcelona Open,Clay,2.0,1.8,0
Sinner J.,8,224,153,71,Bautista Agut R.,25,379,234,145,2021-04-22,Barcelona,Barcelona Open,Clay,1.72,2.1,1
De Minaur A.,19,272,161,111,Tsitsipas S.,5,390,264,126,2021-04-22,Barcelona,Barcelona Open,Clay,7.0,1.1,0
Lajovic D.,66,378,163,215,Delbonis F.,131,340,152,188,2021-04-22,Belgrade,Serbia Open,Clay,1.8,2.0,0
Nishikori K.,439,617,408,209,Nadal R.,2,1223,1017,206,2021-04-22,Barcelona,Barcelona Open,Clay,8.0,1.08,0
Moutet C.,80,118,50,68,Schwartzman D.,95,428,233,195,2021-04-22,Barcelona,Barcelona Open,Clay,4.33,1.22,0
Popyrin A.,90,140,59,81,Mager G.,67,59,24,35,2021-04-22,Belgrade,Serbia Open,Clay,1.9,1.9,0
Bedene A.,347,291,131,160,Karatsev A.,75,136,66,70,2021-04-22,Belgrade,Serbia Open,Clay,2.75,1.44,0
Goffin D.,123,522,296,226,Norrie C.,13,287,172,115,2021-04-22,Barcelona,Barcelona Open,Clay,1.4,3.0,0
Daniel T.,111,178,67,111,Millman J.,140,256,113,143,2021-04-22,Belgrade,Serbia Open,Clay,2.2,1.66,1
Berrettini M.,38,217,142,75,Krajinovic F.,93,240,115,125,2021-04-23,Belgrade,Serbia Open,Clay,1.9,1.9,1
Djokovic N.,2,1207,1012,195,Kecmanovic M.,40,210,107,103,2021-04-23,Belgrade,Serbia Open,Clay,1.05,11.0,1
Daniel T.,111,178,67,111,Delbonis F.,131,340,152,188,2021-04-23,Belgrade,Serbia Open,Clay,2.75,1.44,1
Karatsev A.,75,136,66,70,Mager G.,67,59,24,35,2021-04-23,Belgrade,Serbia Open,Clay,1.44,2.75,1
Sinner J.,8,224,153,71,Rublev A.,7,392,255,137,2021-04-23,Barcelona,Barcelona Open,Clay,1.72,2.1,1
Carreno Busta P.,16,352,214,138,Schwartzman D.,95,428,233,195,2021-04-23,Barcelona,Barcelona Open,Clay,2.1,1.72,1
Nadal R.,2,1223,1017,206,Norrie C.,13,287,172,115,2021-04-23,Barcelona,Barcelona Open,Clay,1.05,11.0,1
Tsitsipas S.,5,390,264,126,Auger-Aliassime F.,12,268,163,105,2021-04-23,Barcelona,Barcelona Open,Clay,1.3,3.5,1
Carreno Busta P.,16,352,214,138,Nadal R.,2,1223,1017,206,2021-04-24,Barcelona,Barcelona Open,Clay,5.5,1.14,0
Tsitsipas S.,5,390,264,126,Sinner J.,8,224,153,71,2021-04-24,Barcelona,Barcelona Open,Clay,1.44,2.75,1
Karatsev A.,75,136,66,70,Djokovic N.,2,1207,1012,195,2021-04-24,Belgrade,Serbia Open,Clay,6.0,1.12,1
Daniel T.,111,178,67,111,Berrettini M.,38,217,142,75,2021-04-24,Belgrade,Serbia Open,Clay,5.5,1.14,0
Tsitsipas S.,5,390,264,126,Nadal R.,2,1223,1017,206,2021-04-25,Barcelona,Barcelona Open,Clay,2.37,1.57,0
Karatsev A.,75,136,66,70,Berrettini M.,38,217,142,75,2021-04-25,Belgrade,Serbia Open,Clay,1.8,2.0,0
Coria F.,108,99,43,56,Stebe C.M.,231,76,28,48,2021-04-26,Munich,BMW Open,Clay,2.2,1.66,1
Berankis R.,212,249,104,145,Marterer M.,144,91,31,60,2021-04-26,Munich,BMW Open,Clay,2.1,1.72,1
Pella G.,199,260,118,142,Gerasimov E.,150,93,43,50,2021-04-26,Munich,BMW Open,Clay,1.44,2.75,1
Ruusuvuori E.,55,158,79,79,Ivashka I.,113,159,78,81,2021-04-26,Munich,BMW Open,Clay,3.2,1.36,0
Millman J.,140,256,113,143,Popyrin A.,90,140,59,81,2021-04-26,Munich,BMW Open,Clay,2.3,1.61,1
Chardy J.,542,591,289,302,Munar J.,104,178,75,103,2021-04-26,Estoril,Millennium Estoril Open,Clay,2.5,1.53,1
Andujar P.,323,404,164,240,Davidovich Fokina A.,39,168,84,84,2021-04-26,Estoril,Millennium Estoril Open,Clay,3.2,1.36,0
Borges N.,69,28,10,18,Thompson J.,71,221,96,125,2021-04-26,Estoril,Millennium Estoril Open,Clay,1.57,2.37,1
Tiafoe F.,10,303,158,145,Anderson K.,652,598,347,251,2021-04-26,Estoril,Millennium Estoril Open,Clay,1.36,3.2,0
Martinez P.,135,118,50,68,Bublik A.,25,219,110,109,2021-04-27,Estoril,Millennium Estoril Open,Clay,1.8,2.0,1
Galan D.E.,76,78,33,45,Korda S.,26,126,75,51,2021-04-27,Munich,BMW Open,Clay,3.2,1.36,1
Daniel T.,111,178,67,111,Hanfmann Y.,50,99,50,49,2021-04-27,Munich,BMW Open,Clay,3.0,1.4,0
Koepfer D.,84,86,38,48,Kohlschreiber P.,132,812,446,366,2021-04-27,Munich,BMW Open,Clay,1.53,2.5,1
Basilashvili N.,118,301,138,163,Monteiro T.,121,171,69,102,2021-04-27,Munich,BMW Open,Clay,2.2,1.66,1
Mcdonald M.,60,190,87,103,Lajovic D.,66,378,163,215,2021-04-27,Munich,BMW Open,Clay,2.37,1.57,1
Sandgren T.,153,121,47,74,Cuevas P.,149,421,210,211,2021-04-27,Munich,BMW Open,Clay,1.61,2.3,0
Gasquet R.,48,948,581,367,Londero J.I.,142,83,34,49,2021-04-27,Estoril,Millennium Estoril Open,Clay,1.44,2.75,1
Struff J.L.,21,369,170,199,Martin A.,723,258,107,151,2021-04-27,Munich,BMW Open,Clay,1.33,3.4,1
Harris L.,186,129,59,70,Cecchinato M.,108,204,79,125,2021-04-27,Estoril,Millennium Estoril Open,Clay,2.62,1.5,0
Norrie C.,13,287,172,115,Sousa J.,147,436,189,247,2021-04-27,Estoril,Millennium Estoril Open,Clay,1.33,3.4,1
Herbert P.H.,157,202,89,113,Simon G.,188,869,491,378,2021-04-27,Estoril,Millennium Estoril Open,Clay,1.57,2.37,1
Alcaraz C.,1,164,130,34,Cilic M.,100,853,543,310,2021-04-27,Estoril,Millennium Estoril Open,Clay,1.57,2.37,0
Moutet C.,80,118,50,68,Giron M.,69,150,68,82,2021-04-27,Estoril,Millennium Estoril Open,Clay,1.28,3.75,1
Verdasco F.,244,962,537,425,Ramos-Vinolas A.,82,437,204,233,2021-04-27,Estoril,Millennium Estoril Open,Clay,4.5,1.2,0
Mcdonald M.,60,190,87,103,Ivashka I.,113,159,78,81,2021-04-28,Munich,BMW Open,Clay,2.62,1.5,0
Zverev A.,19,500,346,154,Berankis R.,212,249,104,145,2021-04-28,Munich,BMW Open,Clay,1.11,6.5,1
Pella G.,199,260,118,142,Millman J.,140,256,113,143,2021-04-28,Munich,BMW Open,Clay,1.66,2.2,0
Anderson K.,652,598,347,251,Carballes Baena R.,64,207,91,116,2021-04-28,Estoril,Millennium Estoril Open,Clay,1.57,2.37,1
Borges N.,69,28,10,18,Cilic M.,100,853,543,310,2021-04-28,Estoril,Millennium Estoril Open,Clay,2.62,1.5,0
Humbert U.,36,170,80,90,Cecchinato M.,108,204,79,125,2021-04-28,Estoril,Millennium Estoril Open,Clay,2.3,1.61,1
Ruud C.,4,275,176,99,Cuevas P.,149,421,210,211,2021-04-28,Munich,BMW Open,Clay,1.16,5.0,1
Chardy J.,542,591,289,302,Davidovich Fokina A.,39,168,84,84,2021-04-28,Estoril,Millennium Estoril Open,Clay,2.62,1.5,0
Coria F.,108,99,43,56,Gombos N.,114,66,21,45,2021-04-29,Munich,BMW Open,Clay,2.1,1.72,0
Koepfer D.,84,86,38,48,Struff J.L.,21,369,170,199,2021-04-29,Munich,BMW Open,Clay,2.3,1.61,0
Krajinovic F.,93,240,115,125,Hanfmann Y.,50,99,50,49,2021-04-29,Munich,BMW Open,Clay,1.44,2.75,1
Herbert P.H.,157,202,89,113,Ramos-Vinolas A.,82,437,204,233,2021-04-29,Estoril,Millennium Estoril Open,Clay,2.75,1.44,0
Garin C.,101,190,103,87,Gasquet R.,48,948,581,367,2021-04-29,Estoril,Millennium Estoril Open,Clay,1.33,3.4,1
Galan D.E.,76,78,33,45,Basilashvili N.,118,301,138,163,2021-04-29,Munich,BMW Open,Clay,2.0,1.8,0
Moutet C.,80,118,50,68,Shapovalov D.,29,298,166,132,2021-04-29,Estoril,Millennium Estoril Open,Clay,2.62,1.5,1
Norrie C.,13,287,172,115,Martinez P.,135,118,50,68,2021-04-29,Estoril,Millennium Estoril Open,Clay,1.72,2.1,1
Humbert U.,36,170,80,90,Davidovich Fokina A.,39,168,84,84,2021-04-30,Estoril,Millennium Estoril Open,Clay,3.0,1.4,0
Zverev A.,19,500,346,154,Ivashka I.,113,159,78,81,2021-04-30,Munich,BMW Open,Clay,1.28,3.75,0
Struff J.L.,21,369,170,199,Krajinovic F.,93,240,115,125,2021-04-30,Munich,BMW Open,Clay,2.5,1.53,1
Ramos-Vinolas A.,82,437,204,233,Moutet C.,80,118,50,68,2021-04-30,Estoril,Millennium Estoril Open,Clay,1.61,2.3,1
Norrie C.,13,287,172,115,Garin C.,101,190,103,87,2021-04-30,Estoril,Millennium Estoril Open,Clay,2.75,1.44,1
Anderson K.,652,598,347,251,Cilic M.,100,853,543,310,2021-04-30,Estoril,Millennium Estoril Open,Clay,2.0,1.8,0
Ruud C.,4,275,176,99,Millman J.,140,256,113,143,2021-05-01,Munich,BMW Open,Clay,1.12,6.0,1
Ramos-Vinolas A.,82,437,204,233,Davidovich Fokina A.,39,168,84,84,2021-05-01,Estoril,Millennium Estoril Open,Clay,2.3,1.61,1
Cilic M.,100,853,543,310,Norrie C.,13,287,172,115,2021-05-01,Estoril,Millennium Estoril Open,Clay,2.0,1.8,0
Gombos N.,114,66,21,45,Basilashvili N.,118,301,138,163,2021-05-01,Munich,BMW Open,Clay,2.37,1.57,0
Struff J.L.,21,369,170,199,Ivashka I.,113,159,78,81,2021-05-01,Munich,BMW Open,Clay,2.37,1.57,1
Basilashvili N.,118,301,138,163,Ruud C.,4,275,176,99,2021-05-01,Munich,BMW Open,Clay,3.75,1.28,1
Munar J.,104,178,75,103,De Minaur A.,19,272,161,111,2021-05-02,Madrid,Mutua Madrid Open,Clay,1.9,1.9,0
Fucsovics M.,67,249,121,128,Bublik A.,25,219,110,109,2021-05-02,Madrid,Mutua Madrid Open,Clay,1.53,2.5,0
Lajovic D.,66,378,163,215,Shapovalov D.,29,298,166,132,2021-05-02,Madrid,Mutua Madrid Open,Clay,2.62,1.5,0
Ramos-Vinolas A.,82,437,204,233,Norrie C.,13,287,172,115,2021-05-02,Estoril,Millennium Estoril Open,Clay,1.57,2.37,1
Paul T.,14,204,111,93,Martinez P.,135,118,50,68,2021-05-02,Madrid,Mutua Madrid Open,Clay,2.2,1.66,1
Struff J.L.,21,369,170,199,Basilashvili N.,118,301,138,163,2021-05-02,Munich,BMW Open,Clay,2.1,1.72,0
Taberner C.,181,37,13,24,Fognini F.,128,742,383,359,2021-05-03,Madrid,Mutua Madrid Open,Clay,2.37,1.57,0
Delbonis F.,131,340,152,188,Carreno Busta P.,16,352,214,138,2021-05-03,Madrid,Mutua Madrid Open,Clay,3.5,1.3,1
Verdasco F.,244,962,537,425,Garin C.,101,190,103,87,2021-05-03,Madrid,Mutua Madrid Open,Clay,5.0,1.16,0
Giron M.,69,150,68,82,Andujar P.,323,404,164,240,2021-05-03,Madrid,Mutua Madrid Open,Clay,2.75,1.44,1
Mannarino A.,27,567,264,303,Alcaraz C.,1,164,130,34,2021-05-03,Madrid,Mutua Madrid Open,Clay,4.5,1.2,0
Koepfer D.,84,86,38,48,Opelka R.,17,168,88,80,2021-05-03,Madrid,Mutua Madrid Open,Clay,1.72,2.1,1
Humbert U.,36,170,80,90,Karatsev A.,75,136,66,70,2021-05-03,Madrid,Mutua Madrid Open,Clay,3.5,1.3,0
Kecmanovic M.,40,210,107,103,Isner J.,114,755,465,290,2021-05-03,Madrid,Mutua Madrid Open,Clay,1.66,2.2,0
Dimitrov G.,20,651,389,262,Harris L.,186,129,59,70,2021-05-03,Madrid,Mutua Madrid Open,Clay,1.36,3.2,0
Chardy J.,542,591,289,302,Evans D.,30,251,124,127,2021-05-03,Madrid,Mutua Madrid Open,Clay,2.2,1.66,0
Harris L.,186,129,59,70,De Minaur A.,19,272,161,111,2021-05-04,Madrid,Mutua Madrid Open,Clay,2.5,1.53,0
Giron M.,69,150,68,82,Thiem D.,116,517,327,190,2021-05-04,Madrid,Mutua Madrid Open,Clay,5.0,1.16,0
Berrettini M.,38,217,142,75,Fognini F.,128,742,383,359,2021-05-04,Madrid,Mutua Madrid Open,Clay,1.33,3.4,1
Shapovalov D.,29,298,166,132,Bublik A.,25,219,110,109,2021-05-04,Madrid,Mutua Madrid Open,Clay,1.44,2.75,0
Rublev A.,7,392,255,137,Paul T.,14,204,111,93,2021-05-04,Madrid,Mutua Madrid Open,Clay,1.11,6.5,1
Basilashvili N.,118,301,138,163,Paire B.,149,527,237,290,2021-05-04,Madrid,Mutua Madrid Open,Clay,1.22,4.33,0
Bautista Agut R.,25,379,234,145,Cecchinato M.,108,204,79,125,2021-05-04,Madrid,Mutua Madrid Open,Clay,1.3,3.5,1
Fritz T.,9,356,205,151,Ramos-Vinolas A.,82,437,204,233,2021-05-04,Madrid,Mutua Madrid Open,Clay,1.72,2.1,0
Popyrin A.,90,140,59,81,Struff J.L.,21,369,170,199,2021-05-04,Madrid,Mutua Madrid Open,Clay,2.0,1.8,1
Krajinovic F.,93,240,115,125,Nishioka Y.,31,215,99,116,2021-05-04,Madrid,Mutua Madrid Open,Clay,1.16,5.0,0
Davidovich Fokina A.,39,168,84,84,Herbert P.H.,157,202,89,113,2021-05-04,Madrid,Mutua Madrid Open,Clay,1.57,2.37,1
Nishikori K.,439,617,408,209,Khachanov K.,11,378,217,161,2021-05-04,Madrid,Mutua Madrid Open,Clay,1.8,2.0,1
Auger-Aliassime F.,12,268,163,105,Ruud C.,4,275,176,99,2021-05-04,Madrid,Mutua Madrid Open,Clay,1.8,2.0,0
Millman J.,140,256,113,143,Hurkacz H.,17,238,137,101,2021-05-04,Madrid,Mutua Madrid Open,Clay,2.75,1.44,1
Pella G.,199,260,118,142,Sinner J.,8,224,153,71,2021-05-04,Madrid,Mutua Madrid Open,Clay,8.0,1.08,0
Paire B.,149,527,237,290,Tsitsipas S.,5,390,264,126,2021-05-05,Madrid,Mutua Madrid Open,Clay,11.0,1.05,0
Nishioka Y.,31,215,99,116,Ruud C.,4,275,176,99,2021-05-05,Madrid,Mutua Madrid Open,Clay,6.5,1.11,0
Sinner J.,8,224,153,71,Popyrin A.,90,140,59,81,2021-05-05,Madrid,Mutua Madrid Open,Clay,1.14,5.5,0
Alcaraz C.,1,164,130,34,Nadal R.,2,1223,1017,206,2021-05-05,Madrid,Mutua Madrid Open,Clay,8.0,1.08,0
Ramos-Vinolas A.,82,437,204,233,Delbonis F.,131,340,152,188,2021-05-05,Madrid,Mutua Madrid Open,Clay,2.37,1.57,0
Isner J.,114,755,465,290,Bautista Agut R.,25,379,234,145,2021-05-05,Madrid,Mutua Madrid Open,Clay,3.75,1.28,1
Evans D.,30,251,124,127,Millman J.,140,256,113,143,2021-05-05,Madrid,Mutua Madrid Open,Clay,1.4,3.0,1
Davidovich Fokina A.,39,168,84,84,Medvedev D.,3,406,289,117,2021-05-05,Madrid,Mutua Madrid Open,Clay,2.37,1.57,0
Karatsev A.,75,136,66,70,Schwartzman D.,95,428,233,195,2021-05-05,Madrid,Mutua Madrid Open,Clay,1.61,2.3,1
Garin C.,101,190,103,87,Koepfer D.,84,86,38,48,2021-05-05,Madrid,Mutua Madrid Open,Clay,1.4,3.0,1
Zverev A.,19,500,346,154,Nishikori K.,439,617,408,209,2021-05-05,Madrid,Mutua Madrid Open,Clay,1.44,2.75,1
Karatsev A.,75,136,66,70,Bublik A.,25,219,110,109,2021-05-06,Madrid,Mutua Madrid Open,Clay,1.3,3.5,0
De Minaur A.,19,272,161,111,Thiem D.,116,517,327,190,2021-05-06,Madrid,Mutua Madrid Open,Clay,4.0,1.25,0
Garin C.,101,190,103,87,Medvedev D.,3,406,289,117,2021-05-06,Madrid,Mutua Madrid Open,Clay,2.3,1.61,1
Popyrin A.,90,140,59,81,Nadal R.,2,1223,1017,206,2021-05-06,Madrid,Mutua Madrid Open,Clay,13.0,1.04,0
Rublev A.,7,392,255,137,Isner J.,114,755,465,290,2021-05-06,Madrid,Mutua Madrid Open,Clay,1.3,3.5,0
Tsitsipas S.,5,390,264,126,Ruud C.,4,275,176,99,2021-05-06,Madrid,Mutua Madrid Open,Clay,1.25,4.0,0
Evans D.,30,251,124,127,Zverev A.,19,500,346,154,2021-05-06,Madrid,Mutua Madrid Open,Clay,4.0,1.25,0
Berrettini M.,38,217,142,75,Delbonis F.,131,340,152,188,2021-05-06,Madrid,Mutua Madrid Open,Clay,1.25,4.0,1
Garin C.,101,190,103,87,Berrettini M.,38,217,142,75,2021-05-07,Madrid,Mutua Madrid Open,Clay,2.5,1.53,0
Bublik A.,25,219,110,109,Ruud C.,4,275,176,99,2021-05-07,Madrid,Mutua Madrid Open,Clay,3.5,1.3,0
Zverev A.,19,500,346,154,Nadal R.,2,1223,1017,206,2021-05-07,Madrid,Mutua Madrid Open,Clay,4.33,1.22,1
Thiem D.,116,517,327,190,Isner J.,114,755,465,290,2021-05-07,Madrid,Mutua Madrid Open,Clay,1.28,3.75,1
Thiem D.,116,517,327,190,Zverev A.,19,500,346,154,2021-05-08,Madrid,Mutua Madrid Open,Clay,2.1,1.72,0
Berrettini M.,38,217,142,75,Ruud C.,4,275,176,99,2021-05-08,Madrid,Mutua Madrid Open,Clay,2.2,1.66,1
Berrettini M.,38,217,142,75,Zverev A.,19,500,346,154,2021-05-09,Madrid,Mutua Madrid Open,Clay,2.3,1.61,0
Auger-Aliassime F.,12,268,163,105,Krajinovic F.,93,240,115,125,2021-05-09,Rome,Internazionali BNL d'Italia,Clay,1.72,2.1,1
Djere L.,38,243,120,123,Carreno Busta P.,16,352,214,138,2021-05-09,Rome,Internazionali BNL d'Italia,Clay,3.2,1.36,0
Gasquet R.,48,948,581,367,Opelka R.,17,168,88,80,2021-05-09,Rome,Internazionali BNL d'Italia,Clay,1.72,2.1,0
Caruso S.,146,63,19,44,Goffin D.,123,522,296,226,2021-05-09,Rome,Internazionali BNL d'Italia,Clay,3.0,1.4,0
Dellien H.,164,70,22,48,Mannarino A.,27,567,264,303,2021-05-10,Rome,Internazionali BNL d'Italia,Clay,1.3,3.5,1
Bublik A.,25,219,110,109,Cilic M.,100,853,543,310,2021-05-10,Rome,Internazionali BNL d'Italia,Clay,2.1,1.72,0
Struff J.L.,21,369,170,199,Bedene A.,347,291,131,160,2021-05-10,Rome,Internazionali BNL d'Italia,Clay,1.53,2.5,1
Musetti L.,18,143,79,64,Hurkacz H.,17,238,137,101,2021-05-10,Rome,Internazionali BNL d'Italia,Clay,1.57,2.37,1
De Minaur A.,19,272,161,111,Mager G.,67,59,24,35,2021-05-10,Rome,Internazionali BNL d'Italia,Clay,1.5,2.62,0
Garin C.,101,190,103,87,Harris L.,186,129,59,70,2021-05-10,Rome,Internazionali BNL d'Italia,Clay,1.25,4.0,1
Travaglia S.,1024,81,27,54,Paire B.,149,527,237,290,2021-05-10,Rome,Internazionali BNL d'Italia,Clay,1.3,3.5,1
Khachanov K.,11,378,217,161,Delbonis F.,131,340,152,188,2021-05-10,Rome,Internazionali BNL d'Italia,Clay,1.8,2.0,0
Fognini F.,128,742,383,359,Nishikori K.,439,617,408,209,2021-05-10,Rome,Internazionali BNL d'Italia,Clay,2.1,1.72,0
Karatsev A.,75,136,66,70,Kecmanovic M.,40,210,107,103,2021-05-10,Rome,Internazionali BNL d'Italia,Clay,1.3,3.5,1
Nishioka Y.,31,215,99,116,Fucsovics M.,67,249,121,128,2021-05-10,Rome,Internazionali BNL d'Italia,Clay,,,0
Fritz T.,9,356,205,151,Evans D.,30,251,124,127,2021-05-10,Rome,Internazionali BNL d'Italia,Clay,2.3,1.61,1
Sinner J.,8,224,153,71,Humbert U.,36,170,80,90,2021-05-10,Rome,Internazionali BNL d'Italia,Clay,1.16,5.0,1
Schwartzman D.,95,428,233,195,Auger-Aliassime F.,12,268,163,105,2021-05-11,Rome,Internazionali BNL d'Italia,Clay,1.53,2.5,0
Carreno Busta P.,16,352,214,138,Nishikori K.,439,617,408,209,2021-05-11,Rome,Internazionali BNL d'Italia,Clay,1.9,1.9,0
Musetti L.,18,143,79,64,Opelka R.,17,168,88,80,2021-05-11,Rome,Internazionali BNL d'Italia,Clay,1.33,3.4,0
Basilashvili N.,118,301,138,163,Berrettini M.,38,217,142,75,2021-05-11,Rome,Internazionali BNL d'Italia,Clay,3.4,1.33,0
Sonego L.,43,221,107,114,Monfils G.,323,816,510,306,2021-05-11,Rome,Internazionali BNL d'Italia,Clay,1.25,4.0,1
Djokovic N.,2,1207,1012,195,Fritz T.,9,356,205,151,2021-05-11,Rome,Internazionali BNL d'Italia,Clay,1.11,6.5,1
Carballes Baena R.,64,207,91,116,Norrie C.,13,287,172,115,2021-05-11,Rome,Internazionali BNL d'Italia,Clay,3.0,1.4,0
Paul T.,14,204,111,93,Bautista Agut R.,25,379,234,145,2021-05-11,Rome,Internazionali BNL d'Italia,Clay,3.5,1.3,0
Davidovich Fokina A.,39,168,84,84,Dimitrov G.,20,651,389,262,2021-05-11,Rome,Internazionali BNL d'Italia,Clay,1.66,2.2,1
Millman J.,140,256,113,143,Lajovic D.,66,378,163,215,2021-05-11,Rome,Internazionali BNL d'Italia,Clay,2.2,1.66,1
Shapovalov D.,29,298,166,132,Majchrzak K.,121,50,19,31,2021-05-11,Rome,Internazionali BNL d'Italia,Clay,1.36,3.2,1
Sinner J.,8,224,153,71,Nadal R.,2,1223,1017,206,2021-05-12,Rome,Internazionali BNL d'Italia,Clay,4.33,1.22,0
Berrettini M.,38,217,142,75,Millman J.,140,256,113,143,2021-05-12,Rome,Internazionali BNL d'Italia,Clay,1.14,5.5,1
Shapovalov D.,29,298,166,132,Travaglia S.,1024,81,27,54,2021-05-12,Rome,Internazionali BNL d'Italia,Clay,1.44,2.75,1
Cilic M.,100,853,543,310,Tsitsipas S.,5,390,264,126,2021-05-12,Rome,Internazionali BNL d'Italia,Clay,7.0,1.1,0
Goffin D.,123,522,296,226,Delbonis F.,131,340,152,188,2021-05-12,Rome,Internazionali BNL d'Italia,Clay,1.72,2.1,0
Karatsev A.,75,136,66,70,Medvedev D.,3,406,289,117,2021-05-12,Rome,Internazionali BNL d'Italia,Clay,1.8,2.0,1
Sonego L.,43,221,107,114,Mager G.,67,59,24,35,2021-05-12,Rome,Internazionali BNL d'Italia,Clay,1.66,2.2,1
Rublev A.,7,392,255,137,Struff J.L.,21,369,170,199,2021-05-12,Rome,Internazionali BNL d'Italia,Clay,1.16,5.0,1
Norrie C.,13,287,172,115,Davidovich Fokina A.,39,168,84,84,2021-05-12,Rome,Internazionali BNL d'Italia,Clay,2.5,1.53,0
Garin C.,101,190,103,87,Bautista Agut R.,25,379,234,145,2021-05-12,Rome,Internazionali BNL d'Italia,Clay,2.1,1.72,0
Thiem D.,116,517,327,190,Fucsovics M.,67,249,121,128,2021-05-12,Rome,Internazionali BNL d'Italia,Clay,1.28,3.75,1
Dellien H.,164,70,22,48,Zverev A.,19,500,346,154,2021-05-12,Rome,Internazionali BNL d'Italia,Clay,9.0,1.07,0
Zverev A.,19,500,346,154,Nishikori K.,439,617,408,209,2021-05-13,Rome,Internazionali BNL d'Italia,Clay,1.25,4.0,1
Bautista Agut R.,25,379,234,145,Rublev A.,7,392,255,137,2021-05-13,Rome,Internazionali BNL d'Italia,Clay,2.37,1.57,0
Auger-Aliassime F.,12,268,163,105,Delbonis F.,131,340,152,188,2021-05-13,Rome,Internazionali BNL d'Italia,Clay,1.57,2.37,0
Sonego L.,43,221,107,114,Thiem D.,116,517,327,190,2021-05-13,Rome,Internazionali BNL d'Italia,Clay,3.75,1.28,1
Berrettini M.,38,217,142,75,Tsitsipas S.,5,390,264,126,2021-05-13,Rome,Internazionali BNL d'Italia,Clay,3.0,1.4,0
Davidovich Fokina A.,39,168,84,84,Djokovic N.,2,1207,1012,195,2021-05-13,Rome,Internazionali BNL d'Italia,Clay,5.0,1.16,0
Karatsev A.,75,136,66,70,Opelka R.,17,168,88,80,2021-05-13,Rome,Internazionali BNL d'Italia,Clay,1.33,3.4,0
Nadal R.,2,1223,1017,206,Shapovalov D.,29,298,166,132,2021-05-13,Rome,Internazionali BNL d'Italia,Clay,1.07,9.0,1
Delbonis F.,131,340,152,188,Opelka R.,17,168,88,80,2021-05-14,Rome,Internazionali BNL d'Italia,Clay,1.61,2.3,0
Zverev A.,19,500,346,154,Nadal R.,2,1223,1017,206,2021-05-14,Rome,Internazionali BNL d'Italia,Clay,3.0,1.4,0
Djokovic N.,2,1207,1012,195,Tsitsipas S.,5,390,264,126,2021-05-15,Rome,Internazionali BNL d'Italia,Clay,1.57,2.37,1
Sonego L.,43,221,107,114,Rublev A.,7,392,255,137,2021-05-15,Rome,Internazionali BNL d'Italia,Clay,3.75,1.28,1
Nadal R.,2,1223,1017,206,Opelka R.,17,168,88,80,2021-05-15,Rome,Internazionali BNL d'Italia,Clay,1.08,8.0,1
Djokovic N.,2,1207,1012,195,Sonego L.,43,221,107,114,2021-05-15,Rome,Internazionali BNL d'Italia,Clay,1.16,5.0,1
Nadal R.,2,1223,1017,206,Djokovic N.,2,1207,1012,195,2021-05-16,Rome,Internazionali BNL d'Italia,Clay,1.5,2.62,1
Humbert U.,36,170,80,90,Nishioka Y.,31,215,99,116,2021-05-17,Lyon,Lyon Open,Clay,1.44,2.75,0
Korda S.,26,126,75,51,Herbert P.H.,157,202,89,113,2021-05-17,Lyon,Lyon Open,Clay,1.72,2.1,1
Koepfer D.,84,86,38,48,Paire B.,149,527,237,290,2021-05-17,Geneva,Geneva Open,Clay,1.4,3.0,1
Bedene A.,347,291,131,160,Simon G.,188,869,491,378,2021-05-17,Lyon,Lyon Open,Clay,1.66,2.2,1
Moutet C.,80,118,50,68,Norrie C.,13,287,172,115,2021-05-17,Lyon,Lyon Open,Clay,2.1,1.72,0
Mannarino A.,27,567,264,303,Cazaux A.,190,4,1,3,2021-05-17,Geneva,Geneva Open,Clay,1.66,2.2,0
Caruso S.,146,63,19,44,Sandgren T.,153,121,47,74,2021-05-17,Geneva,Geneva Open,Clay,1.57,2.37,0
Andujar P.,323,404,164,240,Thompson J.,71,221,96,125,2021-05-17,Geneva,Geneva Open,Clay,1.4,3.0,1
Lopez F.,634,863,441,422,Altmaier D.,51,79,28,51,2021-05-18,Geneva,Geneva Open,Clay,2.3,1.61,1
Auger-Aliassime F.,12,268,163,105,Musetti L.,18,143,79,64,2021-05-18,Lyon,Lyon Open,Clay,1.53,2.5,0
Sousa J.,147,436,189,247,Majchrzak K.,121,50,19,31,2021-05-18,Lyon,Lyon Open,Clay,2.62,1.5,0
Bonzi B.,107,83,37,46,Khachanov K.,11,378,217,161,2021-05-18,Lyon,Lyon Open,Clay,3.4,1.33,0
Monfils G.,323,816,510,306,Seyboth Wild T.,117,28,12,16,2021-05-18,Lyon,Lyon Open,Clay,1.5,2.62,1
Gasquet R.,48,948,581,367,Barrere G.,59,79,31,48,2021-05-18,Lyon,Lyon Open,Clay,1.57,2.37,1
Tsonga J.W.,297,672,444,228,Paul T.,14,204,111,93,2021-05-18,Lyon,Lyon Open,Clay,3.75,1.28,0
Cuevas P.,149,421,210,211,Opelka R.,17,168,88,80,2021-05-18,Geneva,Geneva Open,Clay,2.62,1.5,1
Andujar P.,323,404,164,240,Federer R.,8,1143,981,162,2021-05-18,Geneva,Geneva Open,Clay,3.5,1.3,1
Fognini F.,128,742,383,359,Pella G.,199,260,118,142,2021-05-18,Geneva,Geneva Open,Clay,1.44,2.75,1
Djere L.,38,243,120,123,Monteiro T.,121,171,69,102,2021-05-18,Geneva,Geneva Open,Clay,1.57,2.37,1
Cilic M.,100,853,543,310,Stricker D.,106,20,10,10,2021-05-18,Geneva,Geneva Open,Clay,1.25,4.0,0
Ivashka I.,113,159,78,81,Verdasco F.,244,962,537,425,2021-05-18,Geneva,Geneva Open,Clay,1.14,5.5,1
Fucsovics M.,67,249,121,128,Laaksonen H.,125,101,37,64,2021-05-18,Geneva,Geneva Open,Clay,1.22,4.33,1
Cecchinato M.,108,204,79,125,Travaglia S.,1024,81,27,54,2021-05-18,Geneva,Geneva Open,Clay,1.72,2.1,1
Ymer M.,59,130,58,72,Rinderknech A.,67,96,46,50,2021-05-19,Lyon,Lyon Open,Clay,1.8,2.0,0
Sinner J.,8,224,153,71,Karatsev A.,75,136,66,70,2021-05-19,Lyon,Lyon Open,Clay,1.61,2.3,1
Khachanov K.,11,378,217,161,Majchrzak K.,121,50,19,31,2021-05-19,Lyon,Lyon Open,Clay,1.44,2.75,1
Bedene A.,347,291,131,160,Goffin D.,123,522,296,226,2021-05-19,Lyon,Lyon Open,Clay,2.5,1.53,1
Korda S.,26,126,75,51,Musetti L.,18,143,79,64,2021-05-19,Lyon,Lyon Open,Clay,2.2,1.66,0
Dimitrov G.,20,651,389,262,Ivashka I.,113,159,78,81,2021-05-19,Geneva,Geneva Open,Clay,2.0,1.8,1
Ruud C.,4,275,176,99,Sandgren T.,153,121,47,74,2021-05-19,Geneva,Geneva Open,Clay,1.11,6.5,1
Koepfer D.,84,86,38,48,Lopez F.,634,863,441,422,2021-05-19,Geneva,Geneva Open,Clay,1.53,2.5,1
Fucsovics M.,67,249,121,128,Stricker D.,106,20,10,10,2021-05-19,Geneva,Geneva Open,Clay,1.33,3.4,0
Paul T.,14,204,111,93,Tsitsipas S.,5,390,264,126,2021-05-20,Lyon,Lyon Open,Clay,4.5,1.2,0
Gasquet R.,48,948,581,367,Schwartzman D.,95,428,233,195,2021-05-20,Lyon,Lyon Open,Clay,3.75,1.28,1
Nishioka Y.,31,215,99,116,Monfils G.,323,816,510,306,2021-05-20,Lyon,Lyon Open,Clay,2.75,1.44,1
Norrie C.,13,287,172,115,Thiem D.,116,517,327,190,2021-05-20,Lyon,Lyon Open,Clay,4.0,1.25,1
Shapovalov D.,29,298,166,132,Cecchinato M.,108,204,79,125,2021-05-20,Geneva,Geneva Open,Clay,1.44,2.75,1
Djere L.,38,243,120,123,Fognini F.,128,742,383,359,2021-05-20,Geneva,Geneva Open,Clay,2.1,1.72,1
Andujar P.,323,404,164,240,Stricker D.,106,20,10,10,2021-05-20,Geneva,Geneva Open,Clay,1.53,2.5,1
Ruud C.,4,275,176,99,Koepfer D.,84,86,38,48,2021-05-20,Geneva,Geneva Open,Clay,1.16,5.0,1
Cuevas P.,149,421,210,211,Dimitrov G.,20,651,389,262,2021-05-20,Geneva,Geneva Open,Clay,2.62,1.5,1
Shapovalov D.,29,298,166,132,Djere L.,38,243,120,123,2021-05-20,Geneva,Geneva Open,Clay,1.57,2.37,1
Cuevas P.,149,421,210,211,Cazaux A.,190,4,1,3,2021-05-20,Geneva,Geneva Open,Clay,1.5,2.62,1
Sinner J.,8,224,153,71,Rinderknech A.,67,96,46,50,2021-05-20,Lyon,Lyon Open,Clay,1.12,6.0,0
Tsitsipas S.,5,390,264,126,Nishioka Y.,31,215,99,116,2021-05-21,Lyon,Lyon Open,Clay,1.04,13.0,1
Musetti L.,18,143,79,64,Bedene A.,347,291,131,160,2021-05-21,Lyon,Lyon Open,Clay,1.57,2.37,1
Gasquet R.,48,948,581,367,Khachanov K.,11,378,217,161,2021-05-21,Lyon,Lyon Open,Clay,2.37,1.57,0
Cuevas P.,149,421,210,211,Shapovalov D.,29,298,166,132,2021-05-21,Geneva,Geneva Open,Clay,2.5,1.53,0
Andujar P.,323,404,164,240,Ruud C.,4,275,176,99,2021-05-21,Geneva,Geneva Open,Clay,4.5,1.2,0
Norrie C.,13,287,172,115,Rinderknech A.,67,96,46,50,2021-05-22,Lyon,Lyon Open,Clay,1.4,3.0,1
Musetti L.,18,143,79,64,Tsitsipas S.,5,390,264,126,2021-05-22,Lyon,Lyon Open,Clay,5.5,1.14,0
Khachanov K.,11,378,217,161,Norrie C.,13,287,172,115,2021-05-22,Lyon,Lyon Open,Clay,1.9,1.9,0
Shapovalov D.,29,298,166,132,Ruud C.,4,275,176,99,2021-05-22,Geneva,Geneva Open,Clay,2.3,1.61,0
Topo M.,478,4,0,4,Coria F.,108,99,43,56,2021-05-23,Belgrade,Belgrade Open,Clay,7.0,1.1,0
Krstin P.,285,5,1,4,Kwon S.W.,68,108,53,55,2021-05-23,Belgrade,Belgrade Open,Clay,6.0,1.12,1
Norrie C.,13,287,172,115,Tsitsipas S.,5,390,264,126,2021-05-23,Lyon,Lyon Open,Clay,5.0,1.16,0
Cobolli F.,148,14,5,9,Giron M.,69,150,68,82,2021-05-23,Parma,Emilia-Romagna Open,Clay,2.2,1.66,1
Sandgren T.,153,121,47,74,Chardy J.,542,591,289,302,2021-05-23,Belgrade,Belgrade Open,Clay,2.2,1.66,0
Travaglia S.,1024,81,27,54,Paul T.,14,204,111,93,2021-05-23,Parma,Emilia-Romagna Open,Clay,2.37,1.57,0
Cuevas P.,149,421,210,211,Kecmanovic M.,40,210,107,103,2021-05-24,Belgrade,Belgrade Open,Clay,2.2,1.66,1
Delbonis F.,131,340,152,188,Klein L.,142,7,2,5,2021-05-24,Belgrade,Belgrade Open,Clay,1.28,3.75,1
Lajovic D.,66,378,163,215,Berankis R.,212,249,104,145,2021-05-24,Belgrade,Belgrade Open,Clay,1.44,2.75,1
Verdasco F.,244,962,537,425,Pouille L.,675,259,134,125,2021-05-24,Belgrade,Belgrade Open,Clay,2.1,1.72,1
Martin A.,723,258,107,151,O Connell C.,74,65,26,39,2021-05-24,Belgrade,Belgrade Open,Clay,1.8,2.0,1
Albot R.,97,215,86,129,Monteiro T.,121,171,69,102,2021-05-24,Belgrade,Belgrade Open,Clay,3.4,1.33,0
Carballes Baena R.,64,207,91,116,Rinderknech A.,67,96,46,50,2021-05-24,Belgrade,Belgrade Open,Clay,1.66,2.2,1
Gerasimov E.,150,93,43,50,Moraing M.,253,3,1,2,2021-05-24,Belgrade,Belgrade Open,Clay,1.5,2.62,0
Molcan A.,120,86,45,41,Medjedovic H.,147,11,3,8,2021-05-24,Belgrade,Belgrade Open,Clay,1.3,3.5,1
Cecchinato M.,108,204,79,125,Brancaccio R.,336,1,0,1,2021-05-25,Parma,Emilia-Romagna Open,Clay,1.16,5.0,1
Seppi A.,141,758,363,395,Korda S.,26,126,75,51,2021-05-25,Parma,Emilia-Romagna Open,Clay,5.0,1.16,0
Musetti L.,18,143,79,64,Mager G.,67,59,24,35,2021-05-25,Parma,Emilia-Romagna Open,Clay,1.5,2.62,1
Ruusuvuori E.,55,158,79,79,Gombos N.,114,66,21,45,2021-05-25,Parma,Emilia-Romagna Open,Clay,2.75,1.44,0
Simon G.,188,869,491,378,Martinez P.,135,118,50,68,2021-05-25,Parma,Emilia-Romagna Open,Clay,3.4,1.33,0
Gasquet R.,48,948,581,367,Altmaier D.,51,79,28,51,2021-05-25,Parma,Emilia-Romagna Open,Clay,1.61,2.3,1
Vesely J.,528,288,130,158,Johnson S.,197,395,196,199,2021-05-25,Parma,Emilia-Romagna Open,Clay,1.36,3.2,1
Ymer M.,59,130,58,72,Munar J.,104,178,75,103,2021-05-25,Parma,Emilia-Romagna Open,Clay,2.5,1.53,0
Querrey S.,287,678,369,309,Nishioka Y.,31,215,99,116,2021-05-25,Parma,Emilia-Romagna Open,Clay,3.75,1.28,0
Bedene A.,347,291,131,160,Caruso S.,146,63,19,44,2021-05-25,Parma,Emilia-Romagna Open,Clay,1.36,3.2,1
Djokovic N.,2,1207,1012,195,Moraing M.,253,3,1,2,2021-05-25,Belgrade,Belgrade Open,Clay,1.01,26.0,1
Cuevas P.,149,421,210,211,Coria F.,108,99,43,56,2021-05-25,Belgrade,Belgrade Open,Clay,1.3,3.5,0
Molcan A.,120,86,45,41,Krstin P.,285,5,1,4,2021-05-25,Belgrade,Belgrade Open,Clay,1.25,4.0,1
Mannarino A.,27,567,264,303,Verdasco F.,244,962,537,425,2021-05-25,Belgrade,Belgrade Open,Clay,2.75,1.44,0
Korda S.,26,126,75,51,Sonego L.,43,221,107,114,2021-05-26,Parma,Emilia-Romagna Open,Clay,2.62,1.5,1
Musetti L.,18,143,79,64,Nishioka Y.,31,215,99,116,2021-05-26,Parma,Emilia-Romagna Open,Clay,1.33,3.4,0
Cecchinato M.,108,204,79,125,Bedene A.,347,291,131,160,2021-05-26,Parma,Emilia-Romagna Open,Clay,1.8,2.0,1
Paire B.,149,527,237,290,Munar J.,104,178,75,103,2021-05-26,Parma,Emilia-Romagna Open,Clay,3.0,1.4,0
Gasquet R.,48,948,581,367,Martinez P.,135,118,50,68,2021-05-26,Parma,Emilia-Romagna Open,Clay,2.5,1.53,1
Gombos N.,114,66,21,45,Ramos-Vinolas A.,82,437,204,233,2021-05-26,Parma,Emilia-Romagna Open,Clay,2.5,1.53,1
Cobolli F.,148,14,5,9,Struff J.L.,21,369,170,199,2021-05-26,Parma,Emilia-Romagna Open,Clay,4.0,1.25,0
Vesely J.,528,288,130,158,Paul T.,14,204,111,93,2021-05-26,Parma,Emilia-Romagna Open,Clay,3.4,1.33,0
Basilashvili N.,118,301,138,163,Martin A.,723,258,107,151,2021-05-26,Belgrade,Belgrade Open,Clay,1.44,2.75,0
Lajovic D.,66,378,163,215,Chardy J.,542,591,289,302,2021-05-26,Belgrade,Belgrade Open,Clay,1.8,2.0,1
Monfils G.,323,816,510,306,Carballes Baena R.,64,207,91,116,2021-05-26,Belgrade,Belgrade Open,Clay,1.9,1.9,0
Delbonis F.,131,340,152,188,Monteiro T.,121,171,69,102,2021-05-26,Belgrade,Belgrade Open,Clay,1.66,2.2,1
Gombos N.,114,66,21,45,Cecchinato M.,108,204,79,125,2021-05-27,Parma,Emilia-Romagna Open,Clay,2.75,1.44,0
Molcan A.,120,86,45,41,Verdasco F.,244,962,537,425,2021-05-27,Belgrade,Belgrade Open,Clay,2.0,1.8,1
Coria F.,108,99,43,56,Djokovic N.,2,1207,1012,195,2021-05-27,Belgrade,Belgrade Open,Clay,19.0,1.02,0
Martin A.,723,258,107,151,Lajovic D.,66,378,163,215,2021-05-27,Belgrade,Belgrade Open,Clay,3.4,1.33,1
Korda S.,26,126,75,51,Nishioka Y.,31,215,99,116,2021-05-27,Parma,Emilia-Romagna Open,Clay,1.44,2.75,1
Carballes Baena R.,64,207,91,116,Delbonis F.,131,340,152,188,2021-05-27,Belgrade,Belgrade Open,Clay,2.75,1.44,0
Gasquet R.,48,948,581,367,Munar J.,104,178,75,103,2021-05-27,Parma,Emilia-Romagna Open,Clay,2.3,1.61,0
Struff J.L.,21,369,170,199,Paul T.,14,204,111,93,2021-05-27,Parma,Emilia-Romagna Open,Clay,1.9,1.9,0
Cecchinato M.,108,204,79,125,Munar J.,104,178,75,103,2021-05-28,Parma,Emilia-Romagna Open,Clay,1.72,2.1,1
Paul T.,14,204,111,93,Korda S.,26,126,75,51,2021-05-28,Parma,Emilia-Romagna Open,Clay,2.2,1.66,0
Delbonis F.,131,340,152,188,Molcan A.,120,86,45,41,2021-05-28,Belgrade,Belgrade Open,Clay,1.53,2.5,0
Djokovic N.,2,1207,1012,195,Martin A.,723,258,107,151,2021-05-28,Belgrade,Belgrade Open,Clay,1.02,19.0,1
Djokovic N.,2,1207,1012,195,Molcan A.,120,86,45,41,2021-05-29,Belgrade,Belgrade Open,Clay,1.02,19.0,1
Cecchinato M.,108,204,79,125,Korda S.,26,126,75,51,2021-05-29,Parma,Emilia-Romagna Open,Clay,2.3,1.61,0
Tsitsipas S.,5,390,264,126,Chardy J.,542,591,289,302,2021-05-30,Paris,French Open,Clay,1.02,17.0,1
Van De Zandschulp B.,44,117,63,54,Hurkacz H.,17,238,137,101,2021-05-30,Paris,French Open,Clay,2.37,1.57,1
Taberner C.,181,37,13,24,Safiullin R.,92,42,20,22,2021-05-30,Paris,French Open,Clay,1.28,3.75,0
Kukushkin M.,221,352,141,211,Davidovich Fokina A.,39,168,84,84,2021-05-30,Paris,French Open,Clay,15.0,1.03,0
Zverev A.,19,500,346,154,Otte O.,233,78,33,45,2021-05-30,Paris,French Open,Clay,1.04,13.0,1
Djere L.,38,243,120,123,Moutet C.,80,118,50,68,2021-05-30,Paris,French Open,Clay,1.8,2.0,1
Giron M.,69,150,68,82,Dimitrov G.,20,651,389,262,2021-05-30,Paris,French Open,Clay,4.0,1.25,1
Ruusuvuori E.,55,158,79,79,Mcdonald M.,60,190,87,103,2021-05-30,Paris,French Open,Clay,3.5,1.3,0
Garin C.,101,190,103,87,Londero J.I.,142,83,34,49,2021-05-30,Paris,French Open,Clay,1.06,10.0,1
Giannessi A.,224,35,12,23,Nishikori K.,439,617,408,209,2021-05-30,Paris,French Open,Clay,6.0,1.12,0
Carreno Busta P.,16,352,214,138,Gombos N.,114,66,21,45,2021-05-30,Paris,French Open,Clay,1.12,6.0,1
Vesely J.,528,288,130,158,Khachanov K.,11,378,217,161,2021-05-30,Paris,French Open,Clay,3.5,1.3,0
Andujar P.,323,404,164,240,Thiem D.,116,517,327,190,2021-05-30,Paris,French Open,Clay,7.0,1.1,1
Kecmanovic M.,40,210,107,103,Evans D.,30,251,124,127,2021-05-30,Paris,French Open,Clay,2.5,1.53,1
Galan D.E.,76,78,33,45,Pella G.,199,260,118,142,2021-05-30,Paris,French Open,Clay,1.36,3.2,0
Bautista Agut R.,25,379,234,145,Vilella Martinez M.,167,10,4,6,2021-05-30,Paris,French Open,Clay,1.12,6.0,1
Laaksonen H.,125,101,37,64,Hanfmann Y.,50,99,50,49,2021-05-30,Paris,French Open,Clay,2.1,1.72,1
Gerasimov E.,150,93,43,50,Couacaud E.,158,9,2,7,2021-05-30,Paris,French Open,Clay,2.2,1.66,0
Barrere G.,59,79,31,48,Fognini F.,128,742,383,359,2021-05-30,Paris,French Open,Clay,4.0,1.25,0
Simon G.,188,869,491,378,Fucsovics M.,67,249,121,128,2021-05-30,Paris,French Open,Clay,7.0,1.1,0
Korda S.,26,126,75,51,Martinez P.,135,118,50,68,2021-05-31,Paris,French Open,Clay,1.33,3.4,0
Zapata Miralles B.,54,80,32,48,Alcaraz C.,1,164,130,34,2021-05-31,Paris,French Open,Clay,3.75,1.28,0
Cazaux A.,190,4,1,3,Majchrzak K.,121,50,19,31,2021-05-31,Paris,French Open,Clay,2.5,1.53,0
Federer R.,8,1143,981,162,Istomin D.,267,440,194,246,2021-05-31,Paris,French Open,Clay,1.12,6.0,1
Sonego L.,43,221,107,114,Harris L.,186,129,59,70,2021-05-31,Paris,French Open,Clay,1.14,5.5,0
Nishioka Y.,31,215,99,116,Tsonga J.W.,297,672,444,228,2021-05-31,Paris,French Open,Clay,1.22,4.33,1
Fritz T.,9,356,205,151,Sousa J.,147,436,189,247,2021-05-31,Paris,French Open,Clay,1.12,6.0,1
Bourgue M.,197,5,1,4,Koepfer D.,84,86,38,48,2021-05-31,Paris,French Open,Clay,4.0,1.25,0
Musetti L.,18,143,79,64,Goffin D.,123,522,296,226,2021-05-31,Paris,French Open,Clay,1.66,2.2,1
Lajovic D.,66,378,163,215,Basilashvili N.,118,301,138,163,2021-05-31,Paris,French Open,Clay,2.2,1.66,0
Rinderknech A.,67,96,46,50,Cilic M.,100,853,543,310,2021-05-31,Paris,French Open,Clay,2.1,1.72,0
Opelka R.,17,168,88,80,Martin A.,723,258,107,151,2021-05-31,Paris,French Open,Clay,1.4,3.0,1
Johnson S.,197,395,196,199,Tiafoe F.,10,303,158,145,2021-05-31,Paris,French Open,Clay,5.0,1.16,1
Bublik A.,25,219,110,109,Medvedev D.,3,406,289,117,2021-05-31,Paris,French Open,Clay,3.0,1.4,0
O Connell C.,74,65,26,39,Paul T.,14,204,111,93,2021-05-31,Paris,French Open,Clay,3.5,1.3,0
Norrie C.,13,287,172,115,Fratangelo B.,695,62,22,40,2021-05-31,Paris,French Open,Clay,1.2,4.5,1
Paire B.,149,527,237,290,Ruud C.,4,275,176,99,2021-05-31,Paris,French Open,Clay,11.0,1.05,0
Albot R.,97,215,86,129,Delbonis F.,131,340,152,188,2021-05-31,Paris,French Open,Clay,5.5,1.14,0
Isner J.,114,755,465,290,Querrey S.,287,678,369,309,2021-05-31,Paris,French Open,Clay,1.28,3.75,1
Mager G.,67,59,24,35,Gojowczyk P.,108,172,75,97,2021-05-31,Paris,French Open,Clay,2.62,1.5,1
Cerundolo F.,21,104,58,46,Monteiro T.,121,171,69,102,2021-05-31,Paris,French Open,Clay,2.2,1.66,0
Krajinovic F.,93,240,115,125,Marterer M.,144,91,31,60,2021-05-31,Paris,French Open,Clay,1.5,2.62,1
Herbert P.H.,157,202,89,113,Sinner J.,8,224,153,71,2021-05-31,Paris,French Open,Clay,6.5,1.11,0
Munar J.,104,178,75,103,Thompson J.,71,221,96,125,2021-05-31,Paris,French Open,Clay,1.08,8.0,1
Verdasco F.,244,962,537,425,Kohlschreiber P.,132,812,446,366,2021-06-01,Paris,French Open,Clay,2.1,1.72,0
Popyrin A.,90,140,59,81,Nadal R.,2,1223,1017,206,2021-06-01,Paris,French Open,Clay,23.0,1.01,0
Coria F.,108,99,43,56,Lopez F.,634,863,441,422,2021-06-01,Paris,French Open,Clay,1.57,2.37,1
Lu Y.,625,11,1,10,Schwartzman D.,95,428,233,195,2021-06-01,Paris,French Open,Clay,23.0,1.01,0
Sandgren T.,153,121,47,74,Djokovic N.,2,1207,1012,195,2021-06-01,Paris,French Open,Clay,0.967,29.0,0
Daniel T.,111,178,67,111,Berrettini M.,38,217,142,75,2021-06-01,Paris,French Open,Clay,9.0,1.07,0
Kwon S.W.,68,108,53,55,Anderson K.,652,598,347,251,2021-06-01,Paris,French Open,Clay,2.75,1.44,1
Cuevas P.,149,421,210,211,Pouille L.,675,259,134,125,2021-06-01,Paris,French Open,Clay,1.4,3.0,1
Gasquet R.,48,948,581,367,Gaston H.,109,58,24,34,2021-06-01,Paris,French Open,Clay,1.72,2.1,1
Bonzi B.,107,83,37,46,Bagnis F.,135,121,39,82,2021-06-01,Paris,French Open,Clay,2.1,1.72,0
Monfils G.,323,816,510,306,Ramos-Vinolas A.,82,437,204,233,2021-06-01,Paris,French Open,Clay,2.3,1.61,1
Struff J.L.,21,369,170,199,Rublev A.,7,392,255,137,2021-06-01,Paris,French Open,Clay,6.5,1.11,1
Caruso S.,146,63,19,44,Duckworth J.,123,143,55,88,2021-06-01,Paris,French Open,Clay,1.25,4.0,0
Mannarino A.,27,567,264,303,Bedene A.,347,291,131,160,2021-06-01,Paris,French Open,Clay,4.0,1.25,0
Karatsev A.,75,136,66,70,Brooksby J.,39,79,46,33,2021-06-01,Paris,French Open,Clay,1.14,5.5,1
Berankis R.,212,249,104,145,Humbert U.,36,170,80,90,2021-06-01,Paris,French Open,Clay,3.75,1.28,1
Travaglia S.,1024,81,27,54,De Minaur A.,19,272,161,111,2021-06-01,Paris,French Open,Clay,2.3,1.61,0
Carballes Baena R.,64,207,91,116,Ymer M.,59,130,58,72,2021-06-01,Paris,French Open,Clay,1.66,2.2,0
Cecchinato M.,108,204,79,125,Uchiyama Y.,314,33,9,24,2021-06-01,Paris,French Open,Clay,1.04,13.0,1
Seppi A.,141,758,363,395,Auger-Aliassime F.,12,268,163,105,2021-06-01,Paris,French Open,Clay,10.0,1.06,1
Opelka R.,17,168,88,80,Munar J.,104,178,75,103,2021-06-02,Paris,French Open,Clay,1.8,2.0,1
Giron M.,69,150,68,82,Pella G.,199,260,118,142,2021-06-02,Paris,French Open,Clay,2.75,1.44,1
Martinez P.,135,118,50,68,Tsitsipas S.,5,390,264,126,2021-06-02,Paris,French Open,Clay,11.0,1.05,0
Medvedev D.,3,406,289,117,Paul T.,14,204,111,93,2021-06-02,Paris,French Open,Clay,1.28,3.75,1
Couacaud E.,158,9,2,7,Carreno Busta P.,16,352,214,138,2021-06-02,Paris,French Open,Clay,13.0,1.04,0
Johnson S.,197,395,196,199,Monteiro T.,121,171,69,102,2021-06-02,Paris,French Open,Clay,5.0,1.16,1
Mcdonald M.,60,190,87,103,Garin C.,101,190,103,87,2021-06-02,Paris,French Open,Clay,3.75,1.28,0
Isner J.,114,755,465,290,Krajinovic F.,93,240,115,125,2021-06-02,Paris,French Open,Clay,2.0,1.8,1
Nishikori K.,439,617,408,209,Khachanov K.,11,378,217,161,2021-06-02,Paris,French Open,Clay,1.9,1.9,1
Van De Zandschulp B.,44,117,63,54,Davidovich Fokina A.,39,168,84,84,2021-06-02,Paris,French Open,Clay,4.5,1.2,0
Bautista Agut R.,25,379,234,145,Laaksonen H.,125,101,37,64,2021-06-02,Paris,French Open,Clay,1.08,8.0,0
Ruud C.,4,275,176,99,Majchrzak K.,121,50,19,31,2021-06-02,Paris,French Open,Clay,1.06,10.0,1
Zverev A.,19,500,346,154,Safiullin R.,92,42,20,22,2021-06-02,Paris,French Open,Clay,1.03,15.0,1
Kecmanovic M.,40,210,107,103,Djere L.,38,243,120,123,2021-06-02,Paris,French Open,Clay,2.2,1.66,0
Andujar P.,323,404,164,240,Delbonis F.,131,340,152,188,2021-06-02,Paris,French Open,Clay,2.2,1.66,0
Fucsovics M.,67,249,121,128,Fognini F.,128,742,383,359,2021-06-02,Paris,French Open,Clay,2.1,1.72,0
Gasquet R.,48,948,581,367,Nadal R.,2,1223,1017,206,2021-06-03,Paris,French Open,Clay,26.0,1.01,0
Basilashvili N.,118,301,138,163,Alcaraz C.,1,164,130,34,2021-06-03,Paris,French Open,Clay,2.1,1.72,0
Bagnis F.,135,121,39,82,Struff J.L.,21,369,170,199,2021-06-03,Paris,French Open,Clay,2.62,1.5,0
Federer R.,8,1143,981,162,Cilic M.,100,853,543,310,2021-06-03,Paris,French Open,Clay,1.53,2.5,1
De Minaur A.,19,272,161,111,Cecchinato M.,108,204,79,125,2021-06-03,Paris,French Open,Clay,1.9,1.9,0
Berankis R.,212,249,104,145,Duckworth J.,123,143,55,88,2021-06-03,Paris,French Open,Clay,1.44,2.75,1
Norrie C.,13,287,172,115,Harris L.,186,129,59,70,2021-06-03,Paris,French Open,Clay,1.4,3.0,1
Djokovic N.,2,1207,1012,195,Cuevas P.,149,421,210,211,2021-06-03,Paris,French Open,Clay,1.02,19.0,1
Nishioka Y.,31,215,99,116,Musetti L.,18,143,79,64,2021-06-03,Paris,French Open,Clay,2.75,1.44,0
Koepfer D.,84,86,38,48,Fritz T.,9,356,205,151,2021-06-03,Paris,French Open,Clay,2.75,1.44,1
Ymer M.,59,130,58,72,Monfils G.,323,816,510,306,2021-06-03,Paris,French Open,Clay,2.75,1.44,1
Schwartzman D.,95,428,233,195,Bedene A.,347,291,131,160,2021-06-03,Paris,French Open,Clay,1.33,3.4,1
Karatsev A.,75,136,66,70,Kohlschreiber P.,132,812,446,366,2021-06-03,Paris,French Open,Clay,1.08,8.0,0
Coria F.,108,99,43,56,Berrettini M.,38,217,142,75,2021-06-03,Paris,French Open,Clay,10.0,1.06,0
Kwon S.W.,68,108,53,55,Seppi A.,141,758,363,395,2021-06-03,Paris,French Open,Clay,1.8,2.0,1
Sinner J.,8,224,153,71,Mager G.,67,59,24,35,2021-06-03,Paris,French Open,Clay,1.12,6.0,1
Isner J.,114,755,465,290,Tsitsipas S.,5,390,264,126,2021-06-04,Paris,French Open,Clay,5.5,1.14,0
Opelka R.,17,168,88,80,Medvedev D.,3,406,289,117,2021-06-04,Paris,French Open,Clay,3.5,1.3,0
Johnson S.,197,395,196,199,Carreno Busta P.,16,352,214,138,2021-06-04,Paris,French Open,Clay,6.5,1.11,0
Garin C.,101,190,103,87,Giron M.,69,150,68,82,2021-06-04,Paris,French Open,Clay,1.3,3.5,1
Fognini F.,128,742,383,359,Delbonis F.,131,340,152,188,2021-06-04,Paris,French Open,Clay,1.53,2.5,0
Nishikori K.,439,617,408,209,Laaksonen H.,125,101,37,64,2021-06-04,Paris,French Open,Clay,1.36,3.2,1
Davidovich Fokina A.,39,168,84,84,Ruud C.,4,275,176,99,2021-06-04,Paris,French Open,Clay,4.0,1.25,1
Djere L.,38,243,120,123,Zverev A.,19,500,346,154,2021-06-04,Paris,French Open,Clay,5.0,1.16,0
Norrie C.,13,287,172,115,Nadal R.,2,1223,1017,206,2021-06-05,Paris,French Open,Clay,19.0,1.02,0
Koepfer D.,84,86,38,48,Federer R.,8,1143,981,162,2021-06-05,Paris,French Open,Clay,3.5,1.3,0
Berrettini M.,38,217,142,75,Kwon S.W.,68,108,53,55,2021-06-05,Paris,French Open,Clay,1.07,9.0,1
Berankis R.,212,249,104,145,Djokovic N.,2,1207,1012,195,2021-06-05,Paris,French Open,Clay,0.967,29.0,0
Alcaraz C.,1,164,130,34,Struff J.L.,21,369,170,199,2021-06-05,Paris,French Open,Clay,1.53,2.5,0
Kohlschreiber P.,132,812,446,366,Schwartzman D.,95,428,233,195,2021-06-05,Paris,French Open,Clay,5.0,1.16,0
Musetti L.,18,143,79,64,Cecchinato M.,108,204,79,125,2021-06-05,Paris,French Open,Clay,1.61,2.3,1
Ymer M.,59,130,58,72,Sinner J.,8,224,153,71,2021-06-05,Paris,French Open,Clay,6.0,1.12,0
Carreno Busta P.,16,352,214,138,Tsitsipas S.,5,390,264,126,2021-06-06,Paris,French Open,Clay,5.5,1.14,0
Medvedev D.,3,406,289,117,Garin C.,101,190,103,87,2021-06-06,Paris,French Open,Clay,1.36,3.2,1
Davidovich Fokina A.,39,168,84,84,Delbonis F.,131,340,152,188,2021-06-06,Paris,French Open,Clay,1.8,2.0,1
Nishikori K.,439,617,408,209,Zverev A.,19,500,346,154,2021-06-06,Paris,French Open,Clay,4.5,1.2,0
Nadal R.,2,1223,1017,206,Sinner J.,8,224,153,71,2021-06-07,Paris,French Open,Clay,1.1,7.0,1
Federer R.,8,1143,981,162,Berrettini M.,38,217,142,75,2021-06-07,Paris,French Open,Clay,,,0
Struff J.L.,21,369,170,199,Schwartzman D.,95,428,233,195,2021-06-07,Paris,French Open,Clay,2.75,1.44,0
Djokovic N.,2,1207,1012,195,Musetti L.,18,143,79,64,2021-06-07,Paris,French Open,Clay,1.05,11.0,1
Basilashvili N.,118,301,138,163,Brown D.,303,158,62,96,2021-06-08,Stuttgart,Mercedes Cup,Grass,1.72,2.1,1
Simon G.,188,869,491,378,Harris L.,186,129,59,70,2021-06-08,Stuttgart,Mercedes Cup,Grass,3.2,1.36,0
Fucsovics M.,67,249,121,128,Humbert U.,36,170,80,90,2021-06-08,Stuttgart,Mercedes Cup,Grass,2.1,1.72,0
Tsitsipas S.,5,390,264,126,Medvedev D.,3,406,289,117,2021-06-08,Paris,French Open,Clay,1.44,2.75,1
Davidovich Fokina A.,39,168,84,84,Zverev A.,19,500,346,154,2021-06-08,Paris,French Open,Clay,6.0,1.12,0
Molleker R.,251,15,4,11,Cilic M.,100,853,543,310,2021-06-08,Stuttgart,Mercedes Cup,Grass,9.0,1.07,0
Thompson J.,71,221,96,125,Pella G.,199,260,118,142,2021-06-09,Stuttgart,Mercedes Cup,Grass,1.53,2.5,1
Querrey S.,287,678,369,309,Celikbilek A.,230,9,4,5,2021-06-09,Stuttgart,Mercedes Cup,Grass,1.25,4.0,1
Hanfmann Y.,50,99,50,49,Chardy J.,542,591,289,302,2021-06-09,Stuttgart,Mercedes Cup,Grass,2.75,1.44,1
Lopez F.,634,863,441,422,Popyrin A.,90,140,59,81,2021-06-09,Stuttgart,Mercedes Cup,Grass,2.2,1.66,1
Schwartzman D.,95,428,233,195,Nadal R.,2,1223,1017,206,2021-06-09,Paris,French Open,Clay,10.0,1.06,0
Rodionov J.,118,26,9,17,Koepfer D.,84,86,38,48,2021-06-09,Stuttgart,Mercedes Cup,Grass,4.5,1.2,1
Djokovic N.,2,1207,1012,195,Berrettini M.,38,217,142,75,2021-06-09,Paris,French Open,Clay,1.16,5.0,1
Albot R.,97,215,86,129,Stricker D.,106,20,10,10,2021-06-09,Stuttgart,Mercedes Cup,Grass,1.8,2.0,0
Duckworth J.,123,143,55,88,Mannarino A.,27,567,264,303,2021-06-09,Stuttgart,Mercedes Cup,Grass,2.62,1.5,1
Gojowczyk P.,108,172,75,97,Ivashka I.,113,159,78,81,2021-06-09,Stuttgart,Mercedes Cup,Grass,,,1
Rodionov J.,118,26,9,17,Gojowczyk P.,108,172,75,97,2021-06-10,Stuttgart,Mercedes Cup,Grass,3.4,1.33,1
Thompson J.,71,221,96,125,De Minaur A.,19,272,161,111,2021-06-10,Stuttgart,Mercedes Cup,Grass,3.4,1.33,0
Hanfmann Y.,50,99,50,49,Humbert U.,36,170,80,90,2021-06-10,Stuttgart,Mercedes Cup,Grass,3.2,1.36,0
Basilashvili N.,118,301,138,163,Cilic M.,100,853,543,310,2021-06-10,Stuttgart,Mercedes Cup,Grass,3.2,1.36,0
Harris L.,186,129,59,70,Auger-Aliassime F.,12,268,163,105,2021-06-10,Stuttgart,Mercedes Cup,Grass,2.3,1.61,0
Querrey S.,287,678,369,309,Duckworth J.,123,143,55,88,2021-06-10,Stuttgart,Mercedes Cup,Grass,1.5,2.62,1
Stricker D.,106,20,10,10,Hurkacz H.,17,238,137,101,2021-06-10,Stuttgart,Mercedes Cup,Grass,2.75,1.44,1
Cilic M.,100,853,543,310,Shapovalov D.,29,298,166,132,2021-06-11,Stuttgart,Mercedes Cup,Grass,2.37,1.57,1
Auger-Aliassime F.,12,268,163,105,Humbert U.,36,170,80,90,2021-06-11,Stuttgart,Mercedes Cup,Grass,1.8,2.0,1
Querrey S.,287,678,369,309,Stricker D.,106,20,10,10,2021-06-11,Stuttgart,Mercedes Cup,Grass,1.57,2.37,1
De Minaur A.,19,272,161,111,Rodionov J.,118,26,9,17,2021-06-11,Stuttgart,Mercedes Cup,Grass,1.2,4.5,0
Tsitsipas S.,5,390,264,126,Zverev A.,19,500,346,154,2021-06-11,Paris,French Open,Clay,1.44,2.75,1
Nadal R.,2,1223,1017,206,Djokovic N.,2,1207,1012,195,2021-06-11,Paris,French Open,Clay,1.4,3.0,0
Lopez F.,634,863,441,422,Shapovalov D.,29,298,166,132,2021-06-11,Stuttgart,Mercedes Cup,Grass,2.1,1.72,0
Querrey S.,287,678,369,309,Auger-Aliassime F.,12,268,163,105,2021-06-12,Stuttgart,Mercedes Cup,Grass,2.62,1.5,0
Rodionov J.,118,26,9,17,Cilic M.,100,853,543,310,2021-06-12,Stuttgart,Mercedes Cup,Grass,4.33,1.22,0
Tsitsipas S.,5,390,264,126,Djokovic N.,2,1207,1012,195,2021-06-13,Paris,French Open,Clay,3.0,1.4,0
Auger-Aliassime F.,12,268,163,105,Cilic M.,100,853,543,310,2021-06-13,Stuttgart,Mercedes Cup,Grass,2.0,1.8,0
Sinner J.,8,224,153,71,Draper J.,55,51,29,22,2021-06-14,Queens Club,Queen's Club Championships,Grass,1.12,6.0,0
Mannarino A.,27,567,264,303,Broady L.,125,47,18,29,2021-06-14,Queens Club,Queen's Club Championships,Grass,1.57,2.37,1
Lopez F.,634,863,441,422,Marchenko I.,164,131,50,81,2021-06-14,Queens Club,Queen's Club Championships,Grass,1.4,3.0,1
Troicki V.,230,525,269,256,Sonego L.,43,221,107,114,2021-06-14,Queens Club,Queen's Club Championships,Grass,2.37,1.57,1
Karatsev A.,75,136,66,70,Tabilo A.,122,44,21,23,2021-06-14,Queens Club,Queen's Club Championships,Grass,1.2,4.5,1
Opelka R.,17,168,88,80,Millman J.,140,256,113,143,2021-06-14,Queens Club,Queen's Club Championships,Grass,1.36,3.2,0
Ramos-Vinolas A.,82,437,204,233,Norrie C.,13,287,172,115,2021-06-14,Queens Club,Queen's Club Championships,Grass,3.5,1.3,0
Goffin D.,123,522,296,226,Moutet C.,80,118,50,68,2021-06-14,Halle,Halle Open,Grass,1.36,3.2,0
Thompson J.,71,221,96,125,Altmaier D.,51,79,28,51,2021-06-14,Halle,Halle Open,Grass,1.36,3.2,1
Pospisil V.,99,280,122,158,Giron M.,69,150,68,82,2021-06-14,Halle,Halle Open,Grass,1.8,2.0,0
Ivashka I.,113,159,78,81,Federer R.,8,1143,981,162,2021-06-14,Halle,Halle Open,Grass,5.5,1.14,0
Korda S.,26,126,75,51,Bautista Agut R.,25,379,234,145,2021-06-14,Halle,Halle Open,Grass,2.75,1.44,1
Lacko L.,214,215,81,134,Pella G.,199,260,118,142,2021-06-15,Halle,Halle Open,Grass,1.9,1.9,1
Travaglia S.,1024,81,27,54,Berrettini M.,38,217,142,75,2021-06-15,Queens Club,Queen's Club Championships,Grass,4.5,1.2,0
Bublik A.,25,219,110,109,Chardy J.,542,591,289,302,2021-06-15,Queens Club,Queen's Club Championships,Grass,2.1,1.72,1
Djere L.,38,243,120,123,De Minaur A.,19,272,161,111,2021-06-15,Queens Club,Queen's Club Championships,Grass,7.0,1.1,0
Popyrin A.,90,140,59,81,Evans D.,30,251,124,127,2021-06-15,Queens Club,Queen's Club Championships,Grass,2.62,1.5,0
Tiafoe F.,10,303,158,145,Bedene A.,347,291,131,160,2021-06-15,Queens Club,Queen's Club Championships,Grass,1.53,2.5,1
Berankis R.,212,249,104,145,Nishikori K.,439,617,408,209,2021-06-15,Halle,Halle Open,Grass,3.2,1.36,0
Murray A.,44,932,687,245,Paire B.,149,527,237,290,2021-06-15,Queens Club,Queen's Club Championships,Grass,1.53,2.5,1
Vukic A.,62,36,15,21,Shapovalov D.,29,298,166,132,2021-06-15,Queens Club,Queen's Club Championships,Grass,5.5,1.14,0
Cilic M.,100,853,543,310,Ofner S.,61,34,16,18,2021-06-15,Queens Club,Queen's Club Championships,Grass,1.12,6.0,1
Rinderknech A.,67,96,46,50,Hanfmann Y.,50,99,50,49,2021-06-15,Halle,Halle Open,Grass,1.8,2.0,1
Querrey S.,287,678,369,309,Humbert U.,36,170,80,90,2021-06-15,Halle,Halle Open,Grass,2.37,1.57,0
Koepfer D.,84,86,38,48,Zverev A.,19,500,346,154,2021-06-15,Halle,Halle Open,Grass,4.5,1.2,0
Auger-Aliassime F.,12,268,163,105,Hurkacz H.,17,238,137,101,2021-06-15,Halle,Halle Open,Grass,1.57,2.37,1
Rublev A.,7,392,255,137,Khachanov K.,11,378,217,161,2021-06-15,Halle,Halle Open,Grass,1.53,2.5,1
Monfils G.,323,816,510,306,Harris L.,186,129,59,70,2021-06-15,Halle,Halle Open,Grass,2.2,1.66,0
Rodionov J.,118,26,9,17,Kohlschreiber P.,132,812,446,366,2021-06-15,Halle,Halle Open,Grass,3.0,1.4,0
Medvedev D.,3,406,289,117,Struff J.L.,21,369,170,199,2021-06-15,Halle,Halle Open,Grass,1.28,3.75,0
Lu Y.,625,11,1,10,Fognini F.,128,742,383,359,2021-06-15,Queens Club,Queen's Club Championships,Grass,3.5,1.3,0
Basilashvili N.,118,301,138,163,Simon G.,188,869,491,378,2021-06-15,Halle,Halle Open,Grass,1.53,2.5,1
Millman J.,140,256,113,143,De Minaur A.,19,272,161,111,2021-06-16,Queens Club,Queen's Club Championships,Grass,3.4,1.33,0
Norrie C.,13,287,172,115,Karatsev A.,75,136,66,70,2021-06-16,Queens Club,Queen's Club Championships,Grass,2.0,1.8,1
Federer R.,8,1143,981,162,Auger-Aliassime F.,12,268,163,105,2021-06-16,Halle,Halle Open,Grass,1.5,2.62,0
Struff J.L.,21,369,170,199,Giron M.,69,150,68,82,2021-06-16,Halle,Halle Open,Grass,1.36,3.2,0
Bublik A.,25,219,110,109,Draper J.,55,51,29,22,2021-06-16,Queens Club,Queen's Club Championships,Grass,1.5,2.62,0
Thompson J.,71,221,96,125,Rublev A.,7,392,255,137,2021-06-16,Halle,Halle Open,Grass,4.33,1.22,0
Moutet C.,80,118,50,68,Kohlschreiber P.,132,812,446,366,2021-06-16,Halle,Halle Open,Grass,2.62,1.5,0
Fognini F.,128,742,383,359,Cilic M.,100,853,543,310,2021-06-16,Queens Club,Queen's Club Championships,Grass,4.0,1.25,0
Berrettini M.,38,217,142,75,Murray A.,44,932,687,245,2021-06-17,Queens Club,Queen's Club Championships,Grass,1.33,3.4,1
Lopez F.,634,863,441,422,Shapovalov D.,29,298,166,132,2021-06-17,Queens Club,Queen's Club Championships,Grass,2.75,1.44,0
Troicki V.,230,525,269,256,Tiafoe F.,10,303,158,145,2021-06-17,Queens Club,Queen's Club Championships,Grass,2.75,1.44,0
Basilashvili N.,118,301,138,163,Rinderknech A.,67,96,46,50,2021-06-17,Halle,Halle Open,Grass,2.1,1.72,1
Zverev A.,19,500,346,154,Humbert U.,36,170,80,90,2021-06-17,Halle,Halle Open,Grass,1.4,3.0,0
Harris L.,186,129,59,70,Lacko L.,214,215,81,134,2021-06-17,Halle,Halle Open,Grass,1.28,3.75,1
Nishikori K.,439,617,408,209,Korda S.,26,126,75,51,2021-06-17,Halle,Halle Open,Grass,2.1,1.72,0
Evans D.,30,251,124,127,Mannarino A.,27,567,264,303,2021-06-17,Queens Club,Queen's Club Championships,Grass,1.53,2.5,1
Evans D.,30,251,124,127,Berrettini M.,38,217,142,75,2021-06-18,Queens Club,Queen's Club Championships,Grass,3.0,1.4,0
De Minaur A.,19,272,161,111,Cilic M.,100,853,543,310,2021-06-18,Queens Club,Queen's Club Championships,Grass,2.0,1.8,1
Draper J.,55,51,29,22,Norrie C.,13,287,172,115,2021-06-18,Queens Club,Queen's Club Championships,Grass,2.75,1.44,0
Kohlschreiber P.,132,812,446,366,Rublev A.,7,392,255,137,2021-06-18,Halle,Halle Open,Grass,3.75,1.28,0
Humbert U.,36,170,80,90,Korda S.,26,126,75,51,2021-06-18,Halle,Halle Open,Grass,1.66,2.2,1
Auger-Aliassime F.,12,268,163,105,Giron M.,69,150,68,82,2021-06-18,Halle,Halle Open,Grass,1.28,3.75,1
Basilashvili N.,118,301,138,163,Harris L.,186,129,59,70,2021-06-18,Halle,Halle Open,Grass,2.3,1.61,1
Humbert U.,36,170,80,90,Auger-Aliassime F.,12,268,163,105,2021-06-19,Halle,Halle Open,Grass,2.3,1.61,1
Rublev A.,7,392,255,137,Basilashvili N.,118,301,138,163,2021-06-19,Halle,Halle Open,Grass,1.22,4.33,1
Shapovalov D.,29,298,166,132,Norrie C.,13,287,172,115,2021-06-19,Queens Club,Queen's Club Championships,Grass,1.5,2.62,0
Shapovalov D.,29,298,166,132,Tiafoe F.,10,303,158,145,2021-06-19,Queens Club,Queen's Club Championships,Grass,1.4,3.0,1
Berrettini M.,38,217,142,75,De Minaur A.,19,272,161,111,2021-06-19,Queens Club,Queen's Club Championships,Grass,1.4,3.0,1
Struff J.L.,21,369,170,199,Mannarino A.,27,567,264,303,2021-06-20,Mallorca,Mallorca Championships,Grass,1.57,2.37,0
Andujar P.,323,404,164,240,Thompson J.,71,221,96,125,2021-06-20,Mallorca,Mallorca Championships,Grass,4.5,1.2,0
Humbert U.,36,170,80,90,Rublev A.,7,392,255,137,2021-06-20,Halle,Halle Open,Grass,3.0,1.4,1
Berrettini M.,38,217,142,75,Norrie C.,13,287,172,115,2021-06-20,Queens Club,Queen's Club Championships,Grass,1.28,3.75,1
Lopez F.,634,863,441,422,Kuhn N.,259,12,3,9,2021-06-21,Mallorca,Mallorca Championships,Grass,1.22,4.33,1
Caruso S.,146,63,19,44,Vesely J.,528,288,130,158,2021-06-21,Mallorca,Mallorca Championships,Grass,2.75,1.44,0
Khachanov K.,11,378,217,161,Pouille L.,675,259,134,125,2021-06-21,Mallorca,Mallorca Championships,Grass,1.36,3.2,1
Munar J.,104,178,75,103,Sandgren T.,153,121,47,74,2021-06-21,Mallorca,Mallorca Championships,Grass,2.37,1.57,0
Klein L.,142,7,2,5,Lajovic D.,66,378,163,215,2021-06-21,Mallorca,Mallorca Championships,Grass,2.0,1.8,1
Pella G.,199,260,118,142,Travaglia S.,1024,81,27,54,2021-06-21,Mallorca,Mallorca Championships,Grass,2.3,1.61,0
Moutet C.,80,118,50,68,Harris L.,186,129,59,70,2021-06-21,Mallorca,Mallorca Championships,Grass,2.62,1.5,1
Simon G.,188,869,491,378,Ruud C.,4,275,176,99,2021-06-21,Mallorca,Mallorca Championships,Grass,2.5,1.53,0
Gombos N.,114,66,21,45,Popyrin A.,90,140,59,81,2021-06-22,Eastbourne,Viking International,Grass,3.2,1.36,0
Lopez F.,634,863,441,422,Khachanov K.,11,378,217,161,2021-06-22,Mallorca,Mallorca Championships,Grass,2.37,1.57,1
Thiem D.,116,517,327,190,Mannarino A.,27,567,264,303,2021-06-22,Mallorca,Mallorca Championships,Grass,1.61,2.3,0
Gerasimov E.,150,93,43,50,Tsonga J.W.,297,672,444,228,2021-06-22,Eastbourne,Viking International,Grass,2.37,1.57,1
Ruud C.,4,275,176,99,Sandgren T.,153,121,47,74,2021-06-22,Mallorca,Mallorca Championships,Grass,1.5,2.62,1
Kecmanovic M.,40,210,107,103,Humbert U.,36,170,80,90,2021-06-22,Mallorca,Mallorca Championships,Grass,2.37,1.57,0
Querrey S.,287,678,369,309,Carballes Baena R.,64,207,91,116,2021-06-22,Mallorca,Mallorca Championships,Grass,1.28,3.75,1
Medvedev D.,3,406,289,117,Moutet C.,80,118,50,68,2021-06-22,Mallorca,Mallorca Championships,Grass,1.14,5.5,1
Gray A.,288,4,1,3,Ivashka I.,113,159,78,81,2021-06-22,Eastbourne,Viking International,Grass,6.5,1.11,0
Kukushkin M.,221,352,141,211,Bublik A.,25,219,110,109,2021-06-22,Eastbourne,Viking International,Grass,2.75,1.44,0
Purcell M.,78,28,9,19,Duckworth J.,123,143,55,88,2021-06-22,Eastbourne,Viking International,Grass,3.0,1.4,1
Ruusuvuori E.,55,158,79,79,Ramos-Vinolas A.,82,437,204,233,2021-06-22,Eastbourne,Viking International,Grass,1.61,2.3,1
Seppi A.,141,758,363,395,Nishioka Y.,31,215,99,116,2021-06-22,Eastbourne,Viking International,Grass,1.57,2.37,1
Ymer M.,59,130,58,72,Davidovich Fokina A.,39,168,84,84,2021-06-22,Eastbourne,Viking International,Grass,2.1,1.72,0
Fucsovics M.,67,249,121,128,Bedene A.,347,291,131,160,2021-06-22,Eastbourne,Viking International,Grass,2.0,1.8,1
Ward J.,340,65,15,50,Pospisil V.,99,280,122,158,2021-06-22,Eastbourne,Viking International,Grass,3.75,1.28,0
Tiafoe F.,10,303,158,145,Broady L.,125,47,18,29,2021-06-22,Eastbourne,Viking International,Grass,1.25,4.0,0
Millman J.,140,256,113,143,Clarke J.,156,13,2,11,2021-06-22,Eastbourne,Viking International,Grass,1.28,3.75,1
Monfils G.,323,816,510,306,Purcell M.,78,28,9,19,2021-06-23,Eastbourne,Viking International,Grass,1.44,2.75,0
Gerasimov E.,150,93,43,50,Bublik A.,25,219,110,109,2021-06-23,Eastbourne,Viking International,Grass,3.0,1.4,0
Fucsovics M.,67,249,121,128,Kwon S.W.,68,108,53,55,2021-06-23,Eastbourne,Viking International,Grass,1.57,2.37,0
Querrey S.,287,678,369,309,Humbert U.,36,170,80,90,2021-06-23,Mallorca,Mallorca Championships,Grass,2.3,1.61,1
Popyrin A.,90,140,59,81,Ivashka I.,113,159,78,81,2021-06-23,Eastbourne,Viking International,Grass,2.0,1.8,0
Vesely J.,528,288,130,158,Carreno Busta P.,16,352,214,138,2021-06-23,Mallorca,Mallorca Championships,Grass,2.2,1.66,0
Klein L.,142,7,2,5,Thompson J.,71,221,96,125,2021-06-23,Mallorca,Mallorca Championships,Grass,2.62,1.5,0
Travaglia S.,1024,81,27,54,Bautista Agut R.,25,379,234,145,2021-06-23,Mallorca,Mallorca Championships,Grass,3.75,1.28,0
Pospisil V.,99,280,122,158,Davidovich Fokina A.,39,168,84,84,2021-06-23,Eastbourne,Viking International,Grass,1.9,1.9,1
De Minaur A.,19,272,161,111,Broady L.,125,47,18,29,2021-06-23,Eastbourne,Viking International,Grass,1.16,5.0,1
Millman J.,140,256,113,143,Sonego L.,43,221,107,114,2021-06-23,Eastbourne,Viking International,Grass,2.0,1.8,0
Seppi A.,141,758,363,395,Ruusuvuori E.,55,158,79,79,2021-06-23,Eastbourne,Viking International,Grass,2.1,1.72,1
Carreno Busta P.,16,352,214,138,Thompson J.,71,221,96,125,2021-06-24,Mallorca,Mallorca Championships,Grass,1.53,2.5,1
Querrey S.,287,678,369,309,Bautista Agut R.,25,379,234,145,2021-06-24,Mallorca,Mallorca Championships,Grass,3.2,1.36,1
Mannarino A.,27,567,264,303,Lopez F.,634,863,441,422,2021-06-24,Mallorca,Mallorca Championships,Grass,2.1,1.72,1
Ruud C.,4,275,176,99,Medvedev D.,3,406,289,117,2021-06-24,Mallorca,Mallorca Championships,Grass,4.5,1.2,0
De Minaur A.,19,272,161,111,Pospisil V.,99,280,122,158,2021-06-24,Eastbourne,Viking International,Grass,1.44,2.75,1
Kwon S.W.,68,108,53,55,Ivashka I.,113,159,78,81,2021-06-24,Eastbourne,Viking International,Grass,2.37,1.57,1
Purcell M.,78,28,9,19,Seppi A.,141,758,363,395,2021-06-24,Eastbourne,Viking International,Grass,2.75,1.44,1
Bublik A.,25,219,110,109,Sonego L.,43,221,107,114,2021-06-24,Eastbourne,Viking International,Grass,1.8,2.0,0
Querrey S.,287,678,369,309,Mannarino A.,27,567,264,303,2021-06-25,Mallorca,Mallorca Championships,Grass,1.57,2.37,1
Kwon S.W.,68,108,53,55,De Minaur A.,19,272,161,111,2021-06-25,Eastbourne,Viking International,Grass,4.33,1.22,0
Purcell M.,78,28,9,19,Sonego L.,43,221,107,114,2021-06-25,Eastbourne,Viking International,Grass,4.33,1.22,0
Medvedev D.,3,406,289,117,Carreno Busta P.,16,352,214,138,2021-06-25,Mallorca,Mallorca Championships,Grass,1.2,4.5,1
Medvedev D.,3,406,289,117,Querrey S.,287,678,369,309,2021-06-26,Mallorca,Mallorca Championships,Grass,1.28,3.75,1
Sonego L.,43,221,107,114,De Minaur A.,19,272,161,111,2021-06-26,Eastbourne,Viking International,Grass,2.75,1.44,0
Broady L.,125,47,18,29,Cecchinato M.,108,204,79,125,2021-06-28,London,Wimbledon,Grass,1.4,3.0,1
Pospisil V.,99,280,122,158,Carballes Baena R.,64,207,91,116,2021-06-28,London,Wimbledon,Grass,1.25,4.0,1
Murray A.,44,932,687,245,Basilashvili N.,118,301,138,163,2021-06-28,London,Wimbledon,Grass,1.9,1.9,1
Martinez P.,135,118,50,68,Travaglia S.,1024,81,27,54,2021-06-28,London,Wimbledon,Grass,3.75,1.28,1
Opelka R.,17,168,88,80,Koepfer D.,84,86,38,48,2021-06-28,London,Wimbledon,Grass,1.61,2.3,0
Mcdonald M.,60,190,87,103,Khachanov K.,11,378,217,161,2021-06-28,London,Wimbledon,Grass,2.3,1.61,0
Delbonis F.,131,340,152,188,Rublev A.,7,392,255,137,2021-06-28,London,Wimbledon,Grass,15.0,1.03,0
Hanfmann Y.,50,99,50,49,Vesely J.,528,288,130,158,2021-06-28,London,Wimbledon,Grass,2.5,1.53,0
Bautista Agut R.,25,379,234,145,Millman J.,140,256,113,143,2021-06-28,London,Wimbledon,Grass,1.22,4.33,1
Sinner J.,8,224,153,71,Fucsovics M.,67,249,121,128,2021-06-28,London,Wimbledon,Grass,1.5,2.62,0
Seppi A.,141,758,363,395,Sousa J.,147,436,189,247,2021-06-28,London,Wimbledon,Grass,1.44,2.75,1
Davidovich Fokina A.,39,168,84,84,Kudla D.,137,198,70,128,2021-06-28,London,Wimbledon,Grass,1.9,1.9,0
Barrios M.,121,10,3,7,Anderson K.,652,598,347,251,2021-06-28,London,Wimbledon,Grass,4.0,1.25,0
Kecmanovic M.,40,210,107,103,Bagnis F.,135,121,39,82,2021-06-28,London,Wimbledon,Grass,1.1,7.0,1
Tsitsipas S.,5,390,264,126,Tiafoe F.,10,303,158,145,2021-06-28,London,Wimbledon,Grass,1.14,5.5,0
Djokovic N.,2,1207,1012,195,Draper J.,55,51,29,22,2021-06-28,London,Wimbledon,Grass,1.01,26.0,1
Kohlschreiber P.,132,812,446,366,Shapovalov D.,29,298,166,132,2021-06-29,London,Wimbledon,Grass,4.33,1.22,0
Rinderknech A.,67,96,46,50,Otte O.,233,78,33,45,2021-06-29,London,Wimbledon,Grass,1.61,2.3,0
Djere L.,38,243,120,123,Cuevas P.,149,421,210,211,2021-06-29,London,Wimbledon,Grass,2.5,1.53,1
Masur D.,222,6,1,5,Kwon S.W.,68,108,53,55,2021-06-29,London,Wimbledon,Grass,3.75,1.28,0
Lu Y.,625,11,1,10,Polmans M.,165,19,5,14,2021-06-29,London,Wimbledon,Grass,3.2,1.36,0
Andujar P.,323,404,164,240,Herbert P.H.,157,202,89,113,2021-06-29,London,Wimbledon,Grass,4.5,1.2,1
Lajovic D.,66,378,163,215,Simon G.,188,869,491,378,2021-06-29,London,Wimbledon,Grass,2.37,1.57,1
Krajinovic F.,93,240,115,125,Bolt A.,345,40,13,27,2021-06-29,London,Wimbledon,Grass,2.37,1.57,0
Gombos N.,114,66,21,45,Sandgren T.,153,121,47,74,2021-06-29,London,Wimbledon,Grass,2.37,1.57,0
Clarke J.,156,13,2,11,Gerasimov E.,150,93,43,50,2021-06-29,London,Wimbledon,Grass,3.0,1.4,0
Harris L.,186,129,59,70,Berankis R.,212,249,104,145,2021-06-29,London,Wimbledon,Grass,1.53,2.5,1
Gasquet R.,48,948,581,367,Sugita Y.,131,129,47,82,2021-06-29,London,Wimbledon,Grass,1.22,4.33,1
Musetti L.,18,143,79,64,Hurkacz H.,17,238,137,101,2021-06-29,London,Wimbledon,Grass,2.75,1.44,0
Lopez F.,634,863,441,422,Evans D.,30,251,124,127,2021-06-29,London,Wimbledon,Grass,2.75,1.44,0
Fognini F.,128,742,383,359,Ramos-Vinolas A.,82,437,204,233,2021-06-29,London,Wimbledon,Grass,1.36,3.2,1
Griekspoor T.,37,97,47,50,Zverev A.,19,500,346,154,2021-06-29,London,Wimbledon,Grass,11.0,1.05,0
De Minaur A.,19,272,161,111,Korda S.,26,126,75,51,2021-06-29,London,Wimbledon,Grass,1.57,2.37,0
Mannarino A.,27,567,264,303,Federer R.,8,1143,981,162,2021-06-29,London,Wimbledon,Grass,5.5,1.14,0
Struff J.L.,21,369,170,199,Medvedev D.,3,406,289,117,2021-06-29,London,Wimbledon,Grass,5.5,1.14,0
Hoang A.,155,19,6,13,Zhang Zh.,53,44,20,24,2021-06-29,London,Wimbledon,Grass,1.8,2.0,1
Paire B.,149,527,237,290,Schwartzman D.,95,428,233,195,2021-06-29,London,Wimbledon,Grass,5.5,1.14,0
Lajovic D.,66,378,163,215,Evans D.,30,251,124,127,2021-06-30,London,Wimbledon,Grass,7.0,1.1,0
Kyrgios N.,25,303,195,108,Humbert U.,36,170,80,90,2021-06-30,London,Wimbledon,Grass,2.5,1.53,1
Bonzi B.,107,83,37,46,Trungelliti M.,240,33,13,20,2021-06-30,London,Wimbledon,Grass,1.25,4.0,1
Monfils G.,323,816,510,306,O Connell C.,74,65,26,39,2021-06-30,London,Wimbledon,Grass,1.9,1.9,1
Bublik A.,25,219,110,109,Kukushkin M.,221,352,141,211,2021-06-30,London,Wimbledon,Grass,1.22,4.33,1
Anderson K.,652,598,347,251,Djokovic N.,2,1207,1012,195,2021-06-30,London,Wimbledon,Grass,19.0,1.02,0
Seppi A.,141,758,363,395,Kudla D.,137,198,70,128,2021-06-30,London,Wimbledon,Grass,2.2,1.66,0
Vesely J.,528,288,130,158,Fucsovics M.,67,249,121,128,2021-06-30,London,Wimbledon,Grass,2.5,1.53,0
Pospisil V.,99,280,122,158,Tiafoe F.,10,303,158,145,2021-06-30,London,Wimbledon,Grass,2.0,1.8,0
Andujar P.,323,404,164,240,Shapovalov D.,29,298,166,132,2021-06-30,London,Wimbledon,Grass,9.0,1.07,0
Djere L.,38,243,120,123,Fognini F.,128,742,383,359,2021-06-30,London,Wimbledon,Grass,3.4,1.33,0
Kwon S.W.,68,108,53,55,Koepfer D.,84,86,38,48,2021-06-30,London,Wimbledon,Grass,2.37,1.57,0
Auger-Aliassime F.,12,268,163,105,Monteiro T.,121,171,69,102,2021-06-30,London,Wimbledon,Grass,1.08,8.0,1
Schwartzman D.,95,428,233,195,Broady L.,125,47,18,29,2021-06-30,London,Wimbledon,Grass,1.22,4.33,1
Korda S.,26,126,75,51,Hoang A.,155,19,6,13,2021-06-30,London,Wimbledon,Grass,1.08,8.0,1
Otte O.,233,78,33,45,Murray A.,44,932,687,245,2021-06-30,London,Wimbledon,Grass,3.4,1.33,0
Rublev A.,7,392,255,137,Harris L.,186,129,59,70,2021-06-30,London,Wimbledon,Grass,1.16,5.0,1
Gerasimov E.,150,93,43,50,Khachanov K.,11,378,217,161,2021-06-30,London,Wimbledon,Grass,4.5,1.2,0
Fritz T.,9,356,205,151,Nakashima B.,70,106,57,49,2021-06-30,London,Wimbledon,Grass,2.75,1.44,1
Johnson S.,197,395,196,199,Novak D.,166,58,15,43,2021-06-30,London,Wimbledon,Grass,1.8,2.0,1
Sonego L.,43,221,107,114,Sousa P.,475,36,9,27,2021-06-30,London,Wimbledon,Grass,1.03,15.0,1
Caruso S.,146,63,19,44,Cilic M.,100,853,543,310,2021-06-30,London,Wimbledon,Grass,10.0,1.06,0
Ruud C.,4,275,176,99,Thompson J.,71,221,96,125,2021-06-30,London,Wimbledon,Grass,1.5,2.62,0
Popyrin A.,90,140,59,81,Nishikori K.,439,617,408,209,2021-06-30,London,Wimbledon,Grass,3.0,1.4,0
Munar J.,104,178,75,103,Ivashka I.,113,159,78,81,2021-06-30,London,Wimbledon,Grass,3.2,1.36,0
Moutet C.,80,118,50,68,Bedene A.,347,291,131,160,2021-06-30,London,Wimbledon,Grass,2.0,1.8,0
Van De Zandschulp B.,44,117,63,54,Barrere G.,59,79,31,48,2021-06-30,London,Wimbledon,Grass,2.37,1.57,1
Karatsev A.,75,136,66,70,Chardy J.,542,591,289,302,2021-06-30,London,Wimbledon,Grass,1.66,2.2,0
Isner J.,114,755,465,290,Nishioka Y.,31,215,99,116,2021-06-30,London,Wimbledon,Grass,1.14,5.5,0
Uchiyama Y.,314,33,9,24,Alcaraz C.,1,164,130,34,2021-06-30,London,Wimbledon,Grass,2.75,1.44,0
Pella G.,199,260,118,142,Berrettini M.,38,217,142,75,2021-06-30,London,Wimbledon,Grass,17.0,1.02,0
Ruusuvuori E.,55,158,79,79,Giron M.,69,150,68,82,2021-06-30,London,Wimbledon,Grass,2.2,1.66,0
Verdasco F.,244,962,537,425,Dimitrov G.,20,651,389,262,2021-06-30,London,Wimbledon,Grass,4.0,1.25,0
Ymer M.,59,130,58,72,Tsonga J.W.,297,672,444,228,2021-06-30,London,Wimbledon,Grass,1.9,1.9,1
Garin C.,101,190,103,87,Zapata Miralles B.,54,80,32,48,2021-06-30,London,Wimbledon,Grass,1.53,2.5,1
Albot R.,97,215,86,129,Duckworth J.,123,143,55,88,2021-06-30,London,Wimbledon,Grass,2.37,1.57,0
Mager G.,67,59,24,35,Londero J.I.,142,83,34,49,2021-06-30,London,Wimbledon,Grass,1.5,2.62,1
Pouille L.,675,259,134,125,Norrie C.,13,287,172,115,2021-06-30,London,Wimbledon,Grass,4.33,1.22,0
Carreno Busta P.,16,352,214,138,Querrey S.,287,678,369,309,2021-06-30,London,Wimbledon,Grass,2.1,1.72,0
Coria F.,108,99,43,56,Galan D.E.,76,78,33,45,2021-06-30,London,Wimbledon,Grass,4.33,1.22,0
Ymer M.,59,130,58,72,Auger-Aliassime F.,12,268,163,105,2021-07-01,London,Wimbledon,Grass,8.0,1.08,0
Fritz T.,9,356,205,151,Johnson S.,197,395,196,199,2021-07-01,London,Wimbledon,Grass,1.61,2.3,1
Mager G.,67,59,24,35,Kyrgios N.,25,303,195,108,2021-07-01,London,Wimbledon,Grass,6.0,1.12,0
Federer R.,8,1143,981,162,Gasquet R.,48,948,581,367,2021-07-01,London,Wimbledon,Grass,1.2,4.5,1
Bonzi B.,107,83,37,46,Cilic M.,100,853,543,310,2021-07-01,London,Wimbledon,Grass,4.5,1.2,0
Hurkacz H.,17,238,137,101,Giron M.,69,150,68,82,2021-07-01,London,Wimbledon,Grass,1.4,3.0,1
Alcaraz C.,1,164,130,34,Medvedev D.,3,406,289,117,2021-07-01,London,Wimbledon,Grass,11.0,1.05,0
Dimitrov G.,20,651,389,262,Bublik A.,25,219,110,109,2021-07-01,London,Wimbledon,Grass,2.0,1.8,0
Sonego L.,43,221,107,114,Galan D.E.,76,78,33,45,2021-07-01,London,Wimbledon,Grass,1.1,7.0,1
Nishioka Y.,31,215,99,116,Bedene A.,347,291,131,160,2021-07-01,London,Wimbledon,Grass,2.75,1.44,0
Nishikori K.,439,617,408,209,Thompson J.,71,221,96,125,2021-07-01,London,Wimbledon,Grass,1.22,4.33,0
Norrie C.,13,287,172,115,Bolt A.,345,40,13,27,2021-07-01,London,Wimbledon,Grass,1.3,3.5,1
Martinez P.,135,118,50,68,Monfils G.,323,816,510,306,2021-07-01,London,Wimbledon,Grass,2.75,1.44,1
Van De Zandschulp B.,44,117,63,54,Berrettini M.,38,217,142,75,2021-07-01,London,Wimbledon,Grass,11.0,1.05,0
Kecmanovic M.,40,210,107,103,Bautista Agut R.,25,379,234,145,2021-07-01,London,Wimbledon,Grass,3.75,1.28,0
Duckworth J.,123,143,55,88,Querrey S.,287,678,369,309,2021-07-01,London,Wimbledon,Grass,3.75,1.28,1
Polmans M.,165,19,5,14,Garin C.,101,190,103,87,2021-07-01,London,Wimbledon,Grass,3.4,1.33,0
Sandgren T.,153,121,47,74,Zverev A.,19,500,346,154,2021-07-01,London,Wimbledon,Grass,8.0,1.08,0
Chardy J.,542,591,289,302,Ivashka I.,113,159,78,81,2021-07-01,London,Wimbledon,Grass,2.2,1.66,0
Kudla D.,137,198,70,128,Djokovic N.,2,1207,1012,195,2021-07-02,London,Wimbledon,Grass,19.0,1.02,0
Shapovalov D.,29,298,166,132,Murray A.,44,932,687,245,2021-07-02,London,Wimbledon,Grass,1.28,3.75,1
Evans D.,30,251,124,127,Korda S.,26,126,75,51,2021-07-02,London,Wimbledon,Grass,1.72,2.1,0
Bautista Agut R.,25,379,234,145,Koepfer D.,84,86,38,48,2021-07-02,London,Wimbledon,Grass,1.36,3.2,1
Garin C.,101,190,103,87,Martinez P.,135,118,50,68,2021-07-02,London,Wimbledon,Grass,1.4,3.0,1
Schwartzman D.,95,428,233,195,Fucsovics M.,67,249,121,128,2021-07-02,London,Wimbledon,Grass,1.9,1.9,0
Tiafoe F.,10,303,158,145,Khachanov K.,11,378,217,161,2021-07-02,London,Wimbledon,Grass,1.66,2.2,0
Rublev A.,7,392,255,137,Fognini F.,128,742,383,359,2021-07-02,London,Wimbledon,Grass,1.12,6.0,1
Berrettini M.,38,217,142,75,Bedene A.,347,291,131,160,2021-07-03,London,Wimbledon,Grass,1.16,5.0,1
Thompson J.,71,221,96,125,Ivashka I.,113,159,78,81,2021-07-03,London,Wimbledon,Grass,2.3,1.61,0
Duckworth J.,123,143,55,88,Sonego L.,43,221,107,114,2021-07-03,London,Wimbledon,Grass,3.0,1.4,0
Bublik A.,25,219,110,109,Hurkacz H.,17,238,137,101,2021-07-03,London,Wimbledon,Grass,2.2,1.66,0
Zverev A.,19,500,346,154,Fritz T.,9,356,205,151,2021-07-03,London,Wimbledon,Grass,1.08,8.0,1
Kyrgios N.,25,303,195,108,Auger-Aliassime F.,12,268,163,105,2021-07-03,London,Wimbledon,Grass,2.1,1.72,0
Norrie C.,13,287,172,115,Federer R.,8,1143,981,162,2021-07-03,London,Wimbledon,Grass,2.75,1.44,0
Cilic M.,100,853,543,310,Medvedev D.,3,406,289,117,2021-07-03,London,Wimbledon,Grass,5.0,1.16,0
Sonego L.,43,221,107,114,Federer R.,8,1143,981,162,2021-07-05,London,Wimbledon,Grass,3.5,1.3,0
Djokovic N.,2,1207,1012,195,Garin C.,101,190,103,87,2021-07-05,London,Wimbledon,Grass,1.01,21.0,1
Rublev A.,7,392,255,137,Fucsovics M.,67,249,121,128,2021-07-05,London,Wimbledon,Grass,1.14,5.5,0
Auger-Aliassime F.,12,268,163,105,Zverev A.,19,500,346,154,2021-07-05,London,Wimbledon,Grass,3.5,1.3,1
Korda S.,26,126,75,51,Khachanov K.,11,378,217,161,2021-07-05,London,Wimbledon,Grass,1.9,1.9,0
Shapovalov D.,29,298,166,132,Bautista Agut R.,25,379,234,145,2021-07-05,London,Wimbledon,Grass,1.66,2.2,1
Berrettini M.,38,217,142,75,Ivashka I.,113,159,78,81,2021-07-05,London,Wimbledon,Grass,1.12,6.0,1
Hurkacz H.,17,238,137,101,Medvedev D.,3,406,289,117,2021-07-06,London,Wimbledon,Grass,5.0,1.16,1
Shapovalov D.,29,298,166,132,Khachanov K.,11,378,217,161,2021-07-07,London,Wimbledon,Grass,1.3,3.5,1
Djokovic N.,2,1207,1012,195,Fucsovics M.,67,249,121,128,2021-07-07,London,Wimbledon,Grass,1.03,15.0,1
Federer R.,8,1143,981,162,Hurkacz H.,17,238,137,101,2021-07-07,London,Wimbledon,Grass,1.4,3.0,0
Berrettini M.,38,217,142,75,Auger-Aliassime F.,12,268,163,105,2021-07-07,London,Wimbledon,Grass,1.25,4.0,1
Djokovic N.,2,1207,1012,195,Shapovalov D.,29,298,166,132,2021-07-09,London,Wimbledon,Grass,1.08,8.0,1
Berrettini M.,38,217,142,75,Hurkacz H.,17,238,137,101,2021-07-09,London,Wimbledon,Grass,1.44,2.75,1
Djokovic N.,2,1207,1012,195,Berrettini M.,38,217,142,75,2021-07-11,London,Wimbledon,Grass,1.22,4.5,1
Seyboth Wild T.,117,28,12,16,Kuhn N.,259,12,3,9,2021-07-12,Hamburg,European Open,Clay,1.28,3.75,1
Rodionov J.,118,26,9,17,Sugita Y.,131,129,47,82,2021-07-12,Newport,Hall of Fame Championships,Grass,1.61,2.3,0
Marchenko I.,164,131,50,81,Anderson K.,652,598,347,251,2021-07-12,Newport,Hall of Fame Championships,Grass,3.4,1.33,0
Stebe C.M.,231,76,28,48,Thompson J.,71,221,96,125,2021-07-12,Newport,Hall of Fame Championships,Grass,4.0,1.25,0
Berankis R.,212,249,104,145,Paire B.,149,527,237,290,2021-07-12,Hamburg,European Open,Clay,1.66,2.2,0
Kohlschreiber P.,132,812,446,366,Munar J.,104,178,75,103,2021-07-12,Hamburg,European Open,Clay,2.1,1.72,1
Baez S.,72,95,47,48,Moutet C.,80,118,50,68,2021-07-12,Hamburg,European Open,Clay,1.9,1.9,1
Kudla D.,137,198,70,128,Johnson S.,197,395,196,199,2021-07-12,Newport,Hall of Fame Championships,Grass,1.66,2.2,1
Brooksby J.,39,79,46,33,Donskoy E.,149,162,50,112,2021-07-12,Newport,Hall of Fame Championships,Grass,1.57,2.37,1
Monteiro T.,121,171,69,102,Hanfmann Y.,50,99,50,49,2021-07-12,Bastad,Nordea Open,Clay,1.8,2.0,0
Gasquet R.,48,948,581,367,Cecchinato M.,108,204,79,125,2021-07-12,Bastad,Nordea Open,Clay,2.0,1.8,0
Daniel T.,111,178,67,111,Ymer E.,186,81,24,57,2021-07-12,Bastad,Nordea Open,Clay,2.1,1.72,0
Albot R.,97,215,86,129,Rune H.,6,131,83,48,2021-07-13,Bastad,Nordea Open,Clay,2.75,1.44,0
Cuevas P.,149,421,210,211,Gombos N.,114,66,21,45,2021-07-13,Bastad,Nordea Open,Clay,1.44,2.75,0
Martinez P.,135,118,50,68,Novak D.,166,58,15,43,2021-07-13,Bastad,Nordea Open,Clay,1.44,2.75,1
Rinderknech A.,67,96,46,50,Sousa P.,475,36,9,27,2021-07-13,Bastad,Nordea Open,Clay,1.25,4.0,1
Nagal S.,503,17,3,14,Varillas J. P.,1345,20,9,11,2021-07-13,Hamburg,European Open,Clay,2.37,1.57,0
Lopez F.,634,863,441,422,Taberner C.,181,37,13,24,2021-07-13,Hamburg,European Open,Clay,3.5,1.3,0
Altmaier D.,51,79,28,51,Krajinovic F.,93,240,115,125,2021-07-13,Hamburg,European Open,Clay,1.8,2.0,0
Vesely J.,528,288,130,158,Caruso S.,146,63,19,44,2021-07-13,Bastad,Nordea Open,Clay,1.9,1.9,1
Molcan A.,120,86,45,41,Mager G.,67,59,24,35,2021-07-13,Hamburg,European Open,Clay,1.61,2.3,1
Struff J.L.,21,369,170,199,Djere L.,38,243,120,123,2021-07-13,Hamburg,European Open,Clay,1.72,2.1,0
Marterer M.,144,91,31,60,Koepfer D.,84,86,38,48,2021-07-13,Hamburg,European Open,Clay,2.62,1.5,0
Lajovic D.,66,378,163,215,Pouille L.,675,259,134,125,2021-07-13,Hamburg,European Open,Clay,1.57,2.37,1
Delbonis F.,131,340,152,188,Zhang Zh.,53,44,20,24,2021-07-13,Hamburg,European Open,Clay,1.3,3.5,1
Bagnis F.,135,121,39,82,Carballes Baena R.,64,207,91,116,2021-07-13,Bastad,Nordea Open,Clay,1.8,2.0,0
Ofner S.,61,34,16,18,Uchiyama Y.,314,33,9,24,2021-07-13,Newport,Hall of Fame Championships,Grass,1.44,2.75,1
Schnur B.,233,19,4,15,Jung J.,276,32,10,22,2021-07-13,Newport,Hall of Fame Championships,Grass,1.8,2.0,0
Ruusuvuori E.,55,158,79,79,Ymer M.,59,130,58,72,2021-07-13,Bastad,Nordea Open,Clay,2.5,1.53,1
Musetti L.,18,143,79,64,Laaksonen H.,125,101,37,64,2021-07-13,Bastad,Nordea Open,Clay,1.4,3.0,0
Karlovic I.,221,674,351,323,Zapata Miralles B.,54,80,32,48,2021-07-13,Newport,Hall of Fame Championships,Grass,2.37,1.57,1
Coria F.,108,99,43,56,Cerundolo F.,21,104,58,46,2021-07-13,Bastad,Nordea Open,Clay,1.66,2.2,1
Krueger M.,228,24,7,17,Gojowczyk P.,108,172,75,97,2021-07-13,Newport,Hall of Fame Championships,Grass,2.37,1.57,0
Bolt A.,345,40,13,27,Sock J.,166,324,177,147,2021-07-13,Newport,Hall of Fame Championships,Grass,1.66,2.2,0
Sousa J.,147,436,189,247,Sandgren T.,153,121,47,74,2021-07-13,Newport,Hall of Fame Championships,Grass,2.5,1.53,0
Cressy M.,96,96,42,54,Lorenzi P.,171,284,104,180,2021-07-13,Newport,Hall of Fame Championships,Grass,1.22,4.33,1
Thompson J.,71,221,96,125,Sugita Y.,131,129,47,82,2021-07-14,Newport,Hall of Fame Championships,Grass,1.28,3.75,1
Kudla D.,137,198,70,128,Brooksby J.,39,79,46,33,2021-07-14,Newport,Hall of Fame Championships,Grass,1.53,2.5,0
Ofner S.,61,34,16,18,Anderson K.,652,598,347,251,2021-07-14,Newport,Hall of Fame Championships,Grass,2.75,1.44,0
Jung J.,276,32,10,22,Sandgren T.,153,121,47,74,2021-07-14,Newport,Hall of Fame Championships,Grass,2.75,1.44,1
Querrey S.,287,678,369,309,Cressy M.,96,96,42,54,2021-07-14,Newport,Hall of Fame Championships,Grass,1.4,3.0,0
Gojowczyk P.,108,172,75,97,Pospisil V.,99,280,122,158,2021-07-14,Newport,Hall of Fame Championships,Grass,2.75,1.44,1
Nishioka Y.,31,215,99,116,Sock J.,166,324,177,147,2021-07-14,Newport,Hall of Fame Championships,Grass,2.1,1.72,0
Karlovic I.,221,674,351,323,Bublik A.,25,219,110,109,2021-07-14,Newport,Hall of Fame Championships,Grass,3.5,1.3,0
Rinderknech A.,67,96,46,50,Millman J.,140,256,113,143,2021-07-14,Bastad,Nordea Open,Clay,1.44,2.75,1
Hanfmann Y.,50,99,50,49,Vesely J.,528,288,130,158,2021-07-14,Bastad,Nordea Open,Clay,1.53,2.5,1
Krajinovic F.,93,240,115,125,Kohlschreiber P.,132,812,446,366,2021-07-14,Hamburg,European Open,Clay,1.8,2.0,1
Seyboth Wild T.,117,28,12,16,Djere L.,38,243,120,123,2021-07-14,Hamburg,European Open,Clay,4.0,1.25,0
Cecchinato M.,108,204,79,125,Coria F.,108,99,43,56,2021-07-14,Bastad,Nordea Open,Clay,1.57,2.37,0
Garin C.,101,190,103,87,Martinez P.,135,118,50,68,2021-07-14,Bastad,Nordea Open,Clay,1.57,2.37,1
Tsitsipas S.,5,390,264,126,Koepfer D.,84,86,38,48,2021-07-14,Hamburg,European Open,Clay,1.12,6.0,1
Ramos-Vinolas A.,82,437,204,233,Delbonis F.,131,340,152,188,2021-07-15,Hamburg,European Open,Clay,2.3,1.61,0
Rune H.,6,131,83,48,Ruud C.,4,275,176,99,2021-07-15,Bastad,Nordea Open,Clay,6.0,1.12,0
Carballes Baena R.,64,207,91,116,Fognini F.,128,742,383,359,2021-07-15,Bastad,Nordea Open,Clay,2.62,1.5,1
Ruusuvuori E.,55,158,79,79,Gombos N.,114,66,21,45,2021-07-15,Bastad,Nordea Open,Clay,2.1,1.72,0
Lajovic D.,66,378,163,215,Molcan A.,120,86,45,41,2021-07-15,Hamburg,European Open,Clay,1.8,2.0,1
Laaksonen H.,125,101,37,64,Ymer E.,186,81,24,57,2021-07-15,Bastad,Nordea Open,Clay,1.66,2.2,1
Jung J.,276,32,10,22,Bublik A.,25,219,110,109,2021-07-15,Newport,Hall of Fame Championships,Grass,3.5,1.3,0
Sock J.,166,324,177,147,Anderson K.,652,598,347,251,2021-07-15,Newport,Hall of Fame Championships,Grass,2.5,1.53,0
Taberner C.,181,37,13,24,Carreno Busta P.,16,352,214,138,2021-07-15,Hamburg,European Open,Clay,3.75,1.28,0
Varillas J. P.,1345,20,9,11,Paire B.,149,527,237,290,2021-07-15,Hamburg,European Open,Clay,1.44,2.75,0
Baez S.,72,95,47,48,Basilashvili N.,118,301,138,163,2021-07-15,Hamburg,European Open,Clay,2.37,1.57,0
Brooksby J.,39,79,46,33,Gojowczyk P.,108,172,75,97,2021-07-16,Newport,Hall of Fame Championships,Grass,1.72,2.1,1
Thompson J.,71,221,96,125,Cressy M.,96,96,42,54,2021-07-16,Newport,Hall of Fame Championships,Grass,1.44,2.75,1
Hanfmann Y.,50,99,50,49,Rinderknech A.,67,96,46,50,2021-07-16,Bastad,Nordea Open,Clay,1.8,2.0,1
Garin C.,101,190,103,87,Coria F.,108,99,43,56,2021-07-16,Bastad,Nordea Open,Clay,1.33,3.4,0
Laaksonen H.,125,101,37,64,Ruud C.,4,275,176,99,2021-07-16,Bastad,Nordea Open,Clay,5.5,1.14,0
Gombos N.,114,66,21,45,Carballes Baena R.,64,207,91,116,2021-07-16,Bastad,Nordea Open,Clay,1.8,2.0,0
Basilashvili N.,118,301,138,163,Djere L.,38,243,120,123,2021-07-16,Hamburg,European Open,Clay,2.5,1.53,0
Tsitsipas S.,5,390,264,126,Krajinovic F.,93,240,115,125,2021-07-16,Hamburg,European Open,Clay,1.14,5.5,0
Carreno Busta P.,16,352,214,138,Lajovic D.,66,378,163,215,2021-07-16,Hamburg,European Open,Clay,1.3,3.5,1
Delbonis F.,131,340,152,188,Paire B.,149,527,237,290,2021-07-16,Hamburg,European Open,Clay,1.22,4.33,1
Thompson J.,71,221,96,125,Brooksby J.,39,79,46,33,2021-07-17,Newport,Hall of Fame Championships,Grass,1.8,2.0,0
Anderson K.,652,598,347,251,Bublik A.,25,219,110,109,2021-07-17,Newport,Hall of Fame Championships,Grass,2.0,1.8,1
Krajinovic F.,93,240,115,125,Djere L.,38,243,120,123,2021-07-17,Hamburg,European Open,Clay,1.66,2.2,1
Delbonis F.,131,340,152,188,Carreno Busta P.,16,352,214,138,2021-07-17,Hamburg,European Open,Clay,2.62,1.5,0
Ruud C.,4,275,176,99,Carballes Baena R.,64,207,91,116,2021-07-17,Bastad,Nordea Open,Clay,1.14,5.5,1
Hanfmann Y.,50,99,50,49,Coria F.,108,99,43,56,2021-07-17,Bastad,Nordea Open,Clay,1.8,2.0,0
Krajinovic F.,93,240,115,125,Carreno Busta P.,16,352,214,138,2021-07-18,Hamburg,European Open,Clay,2.2,1.66,0
Ruud C.,4,275,176,99,Coria F.,108,99,43,56,2021-07-18,Bastad,Nordea Open,Clay,1.14,5.5,1
Brooksby J.,39,79,46,33,Anderson K.,652,598,347,251,2021-07-18,Newport,Hall of Fame Championships,Grass,2.3,1.61,0
Travaglia S.,1024,81,27,54,Munar J.,104,178,75,103,2021-07-19,Umag,Croatia Open,Clay,2.62,1.5,1
Ymer M.,59,130,58,72,Couacaud E.,158,9,2,7,2021-07-19,Gstaad,Suisse Open Gstaad,Clay,1.4,3.0,1
Paire B.,149,527,237,290,Kovalik J.,172,68,24,44,2021-07-19,Gstaad,Suisse Open Gstaad,Clay,1.57,2.37,1
Lopez F.,634,863,441,422,Huesler M.A.,88,58,21,37,2021-07-19,Gstaad,Suisse Open Gstaad,Clay,2.0,1.8,1
Nikles J.,317,4,1,3,Kopriva V.,159,9,5,4,2021-07-19,Gstaad,Suisse Open Gstaad,Clay,3.2,1.36,0
Taberner C.,181,37,13,24,Serdarusic N.,702,9,1,8,2021-07-19,Umag,Croatia Open,Clay,1.22,4.33,1
Bergs Z.,175,15,4,11,Otte O.,233,78,33,45,2021-07-19,Gstaad,Suisse Open Gstaad,Clay,2.75,1.44,1
Albot R.,97,215,86,129,Rune H.,6,131,83,48,2021-07-19,Umag,Croatia Open,Clay,3.4,1.33,1
Ehrat S.,408,3,0,3,Polmans M.,165,19,5,14,2021-07-19,Gstaad,Suisse Open Gstaad,Clay,2.0,1.8,0
Delbonis F.,131,340,152,188,Riedi L.,135,5,1,4,2021-07-20,Gstaad,Suisse Open Gstaad,Clay,1.06,10.0,1
Cuevas P.,149,421,210,211,Zapata Miralles B.,54,80,32,48,2021-07-20,Umag,Croatia Open,Clay,1.72,2.1,0
Giannessi A.,224,35,12,23,Vesely J.,528,288,130,158,2021-07-20,Umag,Croatia Open,Clay,2.1,1.72,1
Moutet C.,80,118,50,68,Altmaier D.,51,79,28,51,2021-07-20,Umag,Croatia Open,Clay,2.1,1.72,0
Collarini A.,210,1,0,1,Ajdukovic D.,299,4,1,3,2021-07-20,Umag,Croatia Open,Clay,2.0,1.8,0
Dzumhur D.,202,234,107,127,Horansky F.,185,8,1,7,2021-07-20,Umag,Croatia Open,Clay,1.61,2.3,1
Olivo R.,179,55,23,32,Martin A.,723,258,107,151,2021-07-20,Umag,Croatia Open,Clay,2.1,1.72,0
Kokkinakis T.,86,124,55,69,Kudla D.,137,198,70,128,2021-07-20,Los Cabos,Mifel Open,Hard,1.5,2.62,0
Johnson S.,197,395,196,199,Lopez Villasenor G.,654,4,0,4,2021-07-20,Los Cabos,Mifel Open,Hard,1.11,6.5,1
Nakashima B.,70,106,57,49,Wolf J.J.,45,75,39,36,2021-07-20,Los Cabos,Mifel Open,Hard,1.2,4.5,1
Seppi A.,141,758,363,395,Bolt A.,345,40,13,27,2021-07-20,Los Cabos,Mifel Open,Hard,1.72,2.1,0
Ofner S.,61,34,16,18,Rodionov J.,118,26,9,17,2021-07-20,Los Cabos,Mifel Open,Hard,1.61,2.3,1
Djere L.,38,243,120,123,Seyboth Wild T.,117,28,12,16,2021-07-20,Gstaad,Suisse Open Gstaad,Clay,1.25,4.0,1
Cecchinato M.,108,204,79,125,Bedene A.,347,291,131,160,2021-07-20,Umag,Croatia Open,Clay,1.66,2.2,1
Zuk K.,172,3,0,3,Novak D.,166,58,15,43,2021-07-20,Gstaad,Suisse Open Gstaad,Clay,1.72,2.1,0
Jung J.,276,32,10,22,Donskoy E.,149,162,50,112,2021-07-20,Los Cabos,Mifel Open,Hard,1.44,2.75,0
Pouille L.,675,259,134,125,Alcaraz C.,1,164,130,34,2021-07-20,Umag,Croatia Open,Clay,4.33,1.22,0
Cerundolo J.M.,106,29,12,17,Gaston H.,109,58,24,34,2021-07-20,Gstaad,Suisse Open Gstaad,Clay,2.1,1.72,0
Griekspoor T.,37,97,47,50,Londero J.I.,142,83,34,49,2021-07-20,Gstaad,Suisse Open Gstaad,Clay,1.72,2.1,1
Stricker D.,106,20,10,10,Rinderknech A.,67,96,46,50,2021-07-20,Gstaad,Suisse Open Gstaad,Clay,2.0,1.8,0
Mager G.,67,59,24,35,Martinez P.,135,118,50,68,2021-07-20,Umag,Croatia Open,Clay,2.37,1.57,1
Djere L.,38,243,120,123,Bergs Z.,175,15,4,11,2021-07-21,Gstaad,Suisse Open Gstaad,Clay,1.25,4.0,1
Gaston H.,109,58,24,34,Delbonis F.,131,340,152,188,2021-07-21,Gstaad,Suisse Open Gstaad,Clay,3.75,1.28,1
Rinderknech A.,67,96,46,50,Bautista Agut R.,25,379,234,145,2021-07-21,Gstaad,Suisse Open Gstaad,Clay,2.75,1.44,1
Polmans M.,165,19,5,14,Garin C.,101,190,103,87,2021-07-21,Gstaad,Suisse Open Gstaad,Clay,5.0,1.16,0
Mejia N.,301,1,0,1,Gomez E.,155,26,7,19,2021-07-21,Los Cabos,Mifel Open,Hard,2.5,1.53,0
Karlovic I.,221,674,351,323,Thompson J.,71,221,96,125,2021-07-21,Los Cabos,Mifel Open,Hard,3.5,1.3,0
Gasquet R.,48,948,581,367,Giannessi A.,224,35,12,23,2021-07-21,Umag,Croatia Open,Clay,1.5,2.62,1
Uchiyama Y.,314,33,9,24,Sarkissian A.,478,6,2,4,2021-07-21,Los Cabos,Mifel Open,Hard,1.5,2.62,1
Gojowczyk P.,108,172,75,97,Marchenko I.,164,131,50,81,2021-07-21,Los Cabos,Mifel Open,Hard,1.66,2.2,0
Cecchinato M.,108,204,79,125,Dzumhur D.,202,234,107,127,2021-07-21,Umag,Croatia Open,Clay,1.36,3.2,0
Ajdukovic D.,299,4,1,3,Ramos-Vinolas A.,82,437,204,233,2021-07-21,Umag,Croatia Open,Clay,3.4,1.33,0
Travaglia S.,1024,81,27,54,Taberner C.,181,37,13,24,2021-07-21,Umag,Croatia Open,Clay,2.2,1.66,1
Mcdonald M.,60,190,87,103,Escobedo E.,377,57,20,37,2021-07-21,Los Cabos,Mifel Open,Hard,1.53,2.5,0
Ebden M.,432,203,75,128,Ymer E.,186,81,24,57,2021-07-21,Los Cabos,Mifel Open,Hard,1.61,2.3,0
Alcaraz C.,1,164,130,34,Martin A.,723,258,107,151,2021-07-22,Umag,Croatia Open,Clay,1.16,5.0,1
Lajovic D.,66,378,163,215,Zapata Miralles B.,54,80,32,48,2021-07-22,Umag,Croatia Open,Clay,1.66,2.2,1
Mager G.,67,59,24,35,Altmaier D.,51,79,28,51,2021-07-22,Umag,Croatia Open,Clay,1.72,2.1,0
Krajinovic F.,93,240,115,125,Albot R.,97,215,86,129,2021-07-22,Umag,Croatia Open,Clay,1.16,5.0,1
Escobedo E.,377,57,20,37,Kudla D.,137,198,70,128,2021-07-22,Los Cabos,Mifel Open,Hard,2.2,1.66,1
Ymer M.,59,130,58,72,Lopez F.,634,863,441,422,2021-07-22,Gstaad,Suisse Open Gstaad,Clay,1.61,2.3,1
Kopriva V.,159,9,5,4,Shapovalov D.,29,298,166,132,2021-07-22,Gstaad,Suisse Open Gstaad,Clay,5.0,1.16,1
Bolt A.,345,40,13,27,Gomez E.,155,26,7,19,2021-07-22,Los Cabos,Mifel Open,Hard,1.72,2.1,1
Thompson J.,71,221,96,125,Ofner S.,61,34,16,18,2021-07-22,Los Cabos,Mifel Open,Hard,1.61,2.3,1
Paire B.,149,527,237,290,Griekspoor T.,37,97,47,50,2021-07-22,Gstaad,Suisse Open Gstaad,Clay,1.9,1.9,1
Ymer E.,186,81,24,57,Norrie C.,13,287,172,115,2021-07-22,Los Cabos,Mifel Open,Hard,4.5,1.2,0
Uchiyama Y.,314,33,9,24,Johnson S.,197,395,196,199,2021-07-22,Los Cabos,Mifel Open,Hard,2.75,1.44,0
Isner J.,114,755,465,290,Donskoy E.,149,162,50,112,2021-07-22,Los Cabos,Mifel Open,Hard,1.16,5.0,1
Fritz T.,9,356,205,151,Marchenko I.,164,131,50,81,2021-07-22,Los Cabos,Mifel Open,Hard,1.2,4.5,1
Ruud C.,4,275,176,99,Novak D.,166,58,15,43,2021-07-22,Gstaad,Suisse Open Gstaad,Clay,1.08,8.0,1
Nakashima B.,70,106,57,49,Querrey S.,287,678,369,309,2021-07-22,Los Cabos,Mifel Open,Hard,1.57,2.37,1
Rinderknech A.,67,96,46,50,Djere L.,38,243,120,123,2021-07-23,Gstaad,Suisse Open Gstaad,Clay,2.2,1.66,0
Dzumhur D.,202,234,107,127,Gasquet R.,48,948,581,367,2021-07-23,Umag,Croatia Open,Clay,2.3,1.61,0
Lajovic D.,66,378,163,215,Altmaier D.,51,79,28,51,2021-07-23,Umag,Croatia Open,Clay,1.53,2.5,0
Travaglia S.,1024,81,27,54,Ramos-Vinolas A.,82,437,204,233,2021-07-23,Umag,Croatia Open,Clay,2.2,1.66,0
Krajinovic F.,93,240,115,125,Alcaraz C.,1,164,130,34,2021-07-23,Umag,Croatia Open,Clay,2.1,1.72,0
Gaston H.,109,58,24,34,Garin C.,101,190,103,87,2021-07-23,Gstaad,Suisse Open Gstaad,Clay,3.75,1.28,1
Ymer M.,59,130,58,72,Kopriva V.,159,9,5,4,2021-07-23,Gstaad,Suisse Open Gstaad,Clay,1.57,2.37,0
Bolt A.,345,40,13,27,Isner J.,114,755,465,290,2021-07-23,Los Cabos,Mifel Open,Hard,3.4,1.33,0
Fritz T.,9,356,205,151,Johnson S.,197,395,196,199,2021-07-23,Los Cabos,Mifel Open,Hard,1.44,2.75,1
Escobedo E.,377,57,20,37,Norrie C.,13,287,172,115,2021-07-23,Los Cabos,Mifel Open,Hard,4.0,1.25,0
Nakashima B.,70,106,57,49,Thompson J.,71,221,96,125,2021-07-23,Los Cabos,Mifel Open,Hard,1.53,2.5,1
Paire B.,149,527,237,290,Ruud C.,4,275,176,99,2021-07-23,Gstaad,Suisse Open Gstaad,Clay,4.5,1.2,0
Gaston H.,109,58,24,34,Djere L.,38,243,120,123,2021-07-24,Gstaad,Suisse Open Gstaad,Clay,3.0,1.4,1
Ruud C.,4,275,176,99,Kopriva V.,159,9,5,4,2021-07-24,Gstaad,Suisse Open Gstaad,Clay,1.11,6.5,1
Isner J.,114,755,465,290,Nakashima B.,70,106,57,49,2021-07-24,Los Cabos,Mifel Open,Hard,1.5,2.62,0
Norrie C.,13,287,172,115,Fritz T.,9,356,205,151,2021-07-24,Los Cabos,Mifel Open,Hard,1.53,2.5,1
Gasquet R.,48,948,581,367,Altmaier D.,51,79,28,51,2021-07-24,Umag,Croatia Open,Clay,1.72,2.1,1
Alcaraz C.,1,164,130,34,Ramos-Vinolas A.,82,437,204,233,2021-07-24,Umag,Croatia Open,Clay,1.44,2.75,1
Ruud C.,4,275,176,99,Gaston H.,109,58,24,34,2021-07-25,Gstaad,Suisse Open Gstaad,Clay,1.14,5.5,1
Nakashima B.,70,106,57,49,Norrie C.,13,287,172,115,2021-07-25,Los Cabos,Mifel Open,Hard,3.0,1.4,0
Gasquet R.,48,948,581,367,Alcaraz C.,1,164,130,34,2021-07-25,Umag,Croatia Open,Clay,4.0,1.25,0
Cuevas P.,149,421,210,211,Ymer M.,59,130,58,72,2021-07-26,Kitzbuhel,Generali Open,Clay,1.5,2.62,0
Pouille L.,675,259,134,125,Martinez P.,135,118,50,68,2021-07-26,Kitzbuhel,Generali Open,Clay,2.37,1.57,0
Vesely J.,528,288,130,158,Gulbis E.,191,453,221,232,2021-07-26,Kitzbuhel,Generali Open,Clay,1.53,2.5,1
Fratangelo B.,695,62,22,40,Seppi A.,141,758,363,395,2021-07-26,Atlanta,BB&T Atlanta Open,Hard,1.57,2.37,1
Popyrin A.,90,140,59,81,Johnson S.,197,395,196,199,2021-07-26,Atlanta,BB&T Atlanta Open,Hard,1.61,2.3,0
Thompson J.,71,221,96,125,Harris L.,186,129,59,70,2021-07-26,Atlanta,BB&T Atlanta Open,Hard,2.2,1.66,1
Seyboth Wild T.,117,28,12,16,Taberner C.,181,37,13,24,2021-07-26,Kitzbuhel,Generali Open,Clay,2.62,1.5,0
Munar J.,104,178,75,103,Kovalik J.,172,68,24,44,2021-07-26,Kitzbuhel,Generali Open,Clay,1.4,3.0,0
Mager G.,67,59,24,35,Novak D.,166,58,15,43,2021-07-27,Kitzbuhel,Generali Open,Clay,1.61,2.3,1
Altmaier D.,51,79,28,51,Djere L.,38,243,120,123,2021-07-27,Kitzbuhel,Generali Open,Clay,2.62,1.5,1
Albot R.,97,215,86,129,Cecchinato M.,108,204,79,125,2021-07-27,Kitzbuhel,Generali Open,Clay,2.75,1.44,0
Neumayer L.,980,1,0,1,Vilella Martinez M.,167,10,4,6,2021-07-27,Kitzbuhel,Generali Open,Clay,5.0,1.16,0
Rune H.,6,131,83,48,Travaglia S.,1024,81,27,54,2021-07-27,Kitzbuhel,Generali Open,Clay,2.1,1.72,1
Rinderknech A.,67,96,46,50,Delbonis F.,131,340,152,188,2021-07-27,Kitzbuhel,Generali Open,Clay,2.3,1.61,1
Erler A.,337,2,1,1,Alcaraz C.,1,164,130,34,2021-07-27,Kitzbuhel,Generali Open,Clay,11.0,1.05,1
Mcdonald M.,60,190,87,103,Ruusuvuori E.,55,158,79,79,2021-07-27,Atlanta,BB&T Atlanta Open,Hard,1.8,2.0,0
Gojowczyk P.,108,172,75,97,Querrey S.,287,678,369,309,2021-07-27,Atlanta,BB&T Atlanta Open,Hard,1.9,1.9,1
Kudla D.,137,198,70,128,O Connell C.,74,65,26,39,2021-07-27,Atlanta,BB&T Atlanta Open,Hard,2.0,1.8,0
Fritz T.,9,356,205,151,Donskoy E.,149,162,50,112,2021-07-27,Atlanta,BB&T Atlanta Open,Hard,1.2,4.5,1
Uchiyama Y.,314,33,9,24,Paire B.,149,527,237,290,2021-07-27,Atlanta,BB&T Atlanta Open,Hard,2.37,1.57,0
Wolf J.J.,45,75,39,36,Isner J.,114,755,465,290,2021-07-27,Atlanta,BB&T Atlanta Open,Hard,4.0,1.25,0
Johnson S.,197,395,196,199,Fritz T.,9,356,205,151,2021-07-28,Atlanta,BB&T Atlanta Open,Hard,2.75,1.44,0
Krajinovic F.,93,240,115,125,Taberner C.,181,37,13,24,2021-07-28,Kitzbuhel,Generali Open,Clay,1.36,3.2,1
Kovalik J.,172,68,24,44,Vesely J.,528,288,130,158,2021-07-28,Kitzbuhel,Generali Open,Clay,2.2,1.66,1
Rinderknech A.,67,96,46,50,Rune H.,6,131,83,48,2021-07-28,Kitzbuhel,Generali Open,Clay,1.5,2.62,1
Bautista Agut R.,25,379,234,145,Martinez P.,135,118,50,68,2021-07-28,Kitzbuhel,Generali Open,Clay,1.44,2.75,0
Nakashima B.,70,106,57,49,Bryde T.,1164,1,0,1,2021-07-28,Atlanta,BB&T Atlanta Open,Hard,1.04,13.0,1
Berankis R.,212,249,104,145,Sock J.,166,324,177,147,2021-07-28,Atlanta,BB&T Atlanta Open,Hard,2.37,1.57,0
Anderson K.,652,598,347,251,Kyrgios N.,25,303,195,108,2021-07-28,Atlanta,BB&T Atlanta Open,Hard,2.2,1.66,0
Mager G.,67,59,24,35,Ramos-Vinolas A.,82,437,204,233,2021-07-28,Kitzbuhel,Generali Open,Clay,2.1,1.72,1
Thompson J.,71,221,96,125,Gojowczyk P.,108,172,75,97,2021-07-28,Atlanta,BB&T Atlanta Open,Hard,1.66,2.2,1
Cecchinato M.,108,204,79,125,Altmaier D.,51,79,28,51,2021-07-28,Kitzbuhel,Generali Open,Clay,2.1,1.72,0
Ymer M.,59,130,58,72,Erler A.,337,2,1,1,2021-07-28,Kitzbuhel,Generali Open,Clay,1.36,3.2,1
Vilella Martinez M.,167,10,4,6,Ruud C.,4,275,176,99,2021-07-28,Kitzbuhel,Generali Open,Clay,6.5,1.11,0
Raonic M.,849,540,361,179,Nakashima B.,70,106,57,49,2021-07-29,Atlanta,BB&T Atlanta Open,Hard,1.44,2.75,0
Martinez P.,135,118,50,68,Kovalik J.,172,68,24,44,2021-07-29,Kitzbuhel,Generali Open,Clay,1.4,3.0,1
Altmaier D.,51,79,28,51,Mager G.,67,59,24,35,2021-07-29,Kitzbuhel,Generali Open,Clay,1.57,2.37,1
Rinderknech A.,67,96,46,50,Krajinovic F.,93,240,115,125,2021-07-29,Kitzbuhel,Generali Open,Clay,2.62,1.5,1
Ymer M.,59,130,58,72,Ruud C.,4,275,176,99,2021-07-29,Kitzbuhel,Generali Open,Clay,4.5,1.2,0
Ruusuvuori E.,55,158,79,79,Paire B.,149,527,237,290,2021-07-29,Atlanta,BB&T Atlanta Open,Hard,1.53,2.5,1
Fratangelo B.,695,62,22,40,Opelka R.,17,168,88,80,2021-07-29,Atlanta,BB&T Atlanta Open,Hard,2.2,1.66,0
Sinner J.,8,224,153,71,O Connell C.,74,65,26,39,2021-07-29,Atlanta,BB&T Atlanta Open,Hard,1.33,3.4,0
Altmaier D.,51,79,28,51,Martinez P.,135,118,50,68,2021-07-30,Kitzbuhel,Generali Open,Clay,2.1,1.72,0
Ruud C.,4,275,176,99,Rinderknech A.,67,96,46,50,2021-07-30,Kitzbuhel,Generali Open,Clay,1.57,2.37,1
Norrie C.,13,287,172,115,Ruusuvuori E.,55,158,79,79,2021-07-30,Atlanta,BB&T Atlanta Open,Hard,1.25,4.0,0
Opelka R.,17,168,88,80,Fritz T.,9,356,205,151,2021-07-30,Atlanta,BB&T Atlanta Open,Hard,2.3,1.61,0
Thompson J.,71,221,96,125,Nakashima B.,70,106,57,49,2021-07-30,Atlanta,BB&T Atlanta Open,Hard,2.2,1.66,0
Kyrgios N.,25,303,195,108,Norrie C.,13,287,172,115,2021-07-30,Atlanta,BB&T Atlanta Open,Hard,1.66,2.2,0
Isner J.,114,755,465,290,Sock J.,166,324,177,147,2021-07-30,Atlanta,BB&T Atlanta Open,Hard,1.4,3.0,1
Ruusuvuori E.,55,158,79,79,Nakashima B.,70,106,57,49,2021-07-31,Atlanta,BB&T Atlanta Open,Hard,1.72,2.1,0
Isner J.,114,755,465,290,O Connell C.,74,65,26,39,2021-07-31,Atlanta,BB&T Atlanta Open,Hard,1.5,2.62,1
Martinez P.,135,118,50,68,Ruud C.,4,275,176,99,2021-07-31,Kitzbuhel,Generali Open,Clay,3.4,1.33,0
Isner J.,114,755,465,290,Fritz T.,9,356,205,151,2021-08-01,Atlanta,BB&T Atlanta Open,Hard,2.0,1.8,1
Nakashima B.,70,106,57,49,Isner J.,114,755,465,290,2021-08-01,Atlanta,BB&T Atlanta Open,Hard,2.0,1.8,0
Ivashka I.,113,159,78,81,Gerasimov E.,150,93,43,50,2021-08-02,Washington,Citi Open,Hard,1.44,2.75,1
Giron M.,69,150,68,82,Marchenko I.,164,131,50,81,2021-08-02,Washington,Citi Open,Hard,1.4,3.0,1
Brooksby J.,39,79,46,33,Anderson K.,652,598,347,251,2021-08-02,Washington,Citi Open,Hard,2.3,1.61,1
Paul T.,14,204,111,93,Galan D.E.,76,78,33,45,2021-08-02,Washington,Citi Open,Hard,1.4,3.0,0
Krueger M.,228,24,7,17,Berankis R.,212,249,104,145,2021-08-02,Washington,Citi Open,Hard,2.2,1.66,0
Seppi A.,141,758,363,395,Uchiyama Y.,314,33,9,24,2021-08-02,Washington,Citi Open,Hard,1.61,2.3,1
Ramanathan R.,435,40,14,26,Johnson S.,197,395,196,199,2021-08-03,Washington,Citi Open,Hard,3.0,1.4,0
Auger-Aliassime F.,12,268,163,105,Seppi A.,141,758,363,395,2021-08-03,Washington,Citi Open,Hard,1.2,4.5,1
Norrie C.,13,287,172,115,Giron M.,69,150,68,82,2021-08-03,Washington,Citi Open,Hard,1.3,3.5,1
Pospisil V.,99,280,122,158,Korda S.,26,126,75,51,2021-08-03,Washington,Citi Open,Hard,2.75,1.44,0
Ymer E.,186,81,24,57,Thompson J.,71,221,96,125,2021-08-03,Washington,Citi Open,Hard,2.5,1.53,1
Duckworth J.,123,143,55,88,Sandgren T.,153,121,47,74,2021-08-03,Washington,Citi Open,Hard,1.72,2.1,0
Gomez E.,155,26,7,19,Pospisil V.,99,280,122,158,2021-08-03,Washington,Citi Open,Hard,2.5,1.53,0
Lopez F.,634,863,441,422,Kudla D.,137,198,70,128,2021-08-03,Washington,Citi Open,Hard,2.37,1.57,0
Gunneswaran P.,228,28,7,21,Ruusuvuori E.,55,158,79,79,2021-08-03,Washington,Citi Open,Hard,3.75,1.28,0
Nishioka Y.,31,215,99,116,Sock J.,166,324,177,147,2021-08-03,Washington,Citi Open,Hard,2.1,1.72,0
Querrey S.,287,678,369,309,Nishikori K.,439,617,408,209,2021-08-03,Washington,Citi Open,Hard,2.5,1.53,0
Nakashima B.,70,106,57,49,Popyrin A.,90,140,59,81,2021-08-03,Washington,Citi Open,Hard,1.8,2.0,1
Paire B.,149,527,237,290,Mcdonald M.,60,190,87,103,2021-08-04,Washington,Citi Open,Hard,2.75,1.44,0
Sandgren T.,153,121,47,74,Harris L.,186,129,59,70,2021-08-04,Washington,Citi Open,Hard,2.75,1.44,0
Bublik A.,25,219,110,109,Nishikori K.,439,617,408,209,2021-08-04,Washington,Citi Open,Hard,2.62,1.5,0
Dimitrov G.,20,651,389,262,Ivashka I.,113,159,78,81,2021-08-04,Washington,Citi Open,Hard,2.2,1.66,0
Sinner J.,8,224,153,71,Ruusuvuori E.,55,158,79,79,2021-08-04,Washington,Citi Open,Hard,1.57,2.37,1
Galan D.E.,76,78,33,45,Opelka R.,17,168,88,80,2021-08-04,Washington,Citi Open,Hard,3.4,1.33,0
Fritz T.,9,356,205,151,Kudla D.,137,198,70,128,2021-08-04,Washington,Citi Open,Hard,1.4,3.0,0
Ymer E.,186,81,24,57,Millman J.,140,256,113,143,2021-08-04,Washington,Citi Open,Hard,2.2,1.66,0
Evans D.,30,251,124,127,Nakashima B.,70,106,57,49,2021-08-04,Washington,Citi Open,Hard,2.1,1.72,0
De Minaur A.,19,272,161,111,Johnson S.,197,395,196,199,2021-08-04,Washington,Citi Open,Hard,1.4,3.0,0
Brooksby J.,39,79,46,33,Tiafoe F.,10,303,158,145,2021-08-04,Washington,Citi Open,Hard,2.0,1.8,1
Berankis R.,212,249,104,145,Kecmanovic M.,40,210,107,103,2021-08-04,Washington,Citi Open,Hard,2.37,1.57,1
Mcdonald M.,60,190,87,103,Kyrgios N.,25,303,195,108,2021-08-04,Washington,Citi Open,Hard,2.75,1.44,1
Auger-Aliassime F.,12,268,163,105,Brooksby J.,39,79,46,33,2021-08-05,Washington,Citi Open,Hard,1.57,2.37,0
Millman J.,140,256,113,143,Opelka R.,17,168,88,80,2021-08-05,Washington,Citi Open,Hard,2.3,1.61,1
Sinner J.,8,224,153,71,Korda S.,26,126,75,51,2021-08-05,Washington,Citi Open,Hard,1.72,2.1,1
Norrie C.,13,287,172,115,Nishikori K.,439,617,408,209,2021-08-05,Washington,Citi Open,Hard,1.8,2.0,0
Nakashima B.,70,106,57,49,Kudla D.,137,198,70,128,2021-08-05,Washington,Citi Open,Hard,1.4,3.0,0
Nadal R.,2,1223,1017,206,Sock J.,166,324,177,147,2021-08-05,Washington,Citi Open,Hard,1.1,7.0,1
Berankis R.,212,249,104,145,Johnson S.,197,395,196,199,2021-08-05,Washington,Citi Open,Hard,2.2,1.66,0
Nadal R.,2,1223,1017,206,Harris L.,186,129,59,70,2021-08-06,Washington,Citi Open,Hard,1.25,4.0,0
Mcdonald M.,60,190,87,103,Ivashka I.,113,159,78,81,2021-08-06,Washington,Citi Open,Hard,2.37,1.57,1
Millman J.,140,256,113,143,Brooksby J.,39,79,46,33,2021-08-06,Washington,Citi Open,Hard,3.0,1.4,0
Sinner J.,8,224,153,71,Johnson S.,197,395,196,199,2021-08-06,Washington,Citi Open,Hard,1.33,3.4,1
Harris L.,186,129,59,70,Nishikori K.,439,617,408,209,2021-08-07,Washington,Citi Open,Hard,2.37,1.57,0
Mcdonald M.,60,190,87,103,Kudla D.,137,198,70,128,2021-08-07,Washington,Citi Open,Hard,1.53,2.5,1
Sinner J.,8,224,153,71,Brooksby J.,39,79,46,33,2021-08-07,Washington,Citi Open,Hard,1.57,2.37,1
Mcdonald M.,60,190,87,103,Nishikori K.,439,617,408,209,2021-08-07,Washington,Citi Open,Hard,2.75,1.44,1
Mcdonald M.,60,190,87,103,Sinner J.,8,224,153,71,2021-08-08,Washington,Citi Open,Hard,4.0,1.25,0
Bublik A.,25,219,110,109,Evans D.,30,251,124,127,2021-08-09,Toronto,Canadian Open,Hard,1.8,2.0,1
Millman J.,140,256,113,143,Berankis R.,212,249,104,145,2021-08-09,Toronto,Canadian Open,Hard,1.9,1.9,1
Fritz T.,9,356,205,151,Duckworth J.,123,143,55,88,2021-08-09,Toronto,Canadian Open,Hard,1.36,3.2,0
Harris L.,186,129,59,70,Schnur B.,233,19,4,15,2021-08-09,Toronto,Canadian Open,Hard,1.28,3.75,1
Humbert U.,36,170,80,90,Sonego L.,43,221,107,114,2021-08-09,Toronto,Canadian Open,Hard,1.5,2.62,1
Struff J.L.,21,369,170,199,Fognini F.,128,742,383,359,2021-08-09,Toronto,Canadian Open,Hard,1.9,1.9,0
Ramos-Vinolas A.,82,437,204,233,Cilic M.,100,853,543,310,2021-08-09,Toronto,Canadian Open,Hard,3.4,1.33,0
Cilic M.,100,853,543,310,Ruud C.,4,275,176,99,2021-08-10,Toronto,Canadian Open,Hard,2.1,1.72,0
Bublik A.,25,219,110,109,Medvedev D.,3,406,289,117,2021-08-10,Toronto,Canadian Open,Hard,4.5,1.2,0
Paire B.,149,527,237,290,Mcdonald M.,60,190,87,103,2021-08-10,Toronto,Canadian Open,Hard,2.37,1.57,1
Tiafoe F.,10,303,158,145,Nishioka Y.,31,215,99,116,2021-08-10,Toronto,Canadian Open,Hard,1.53,2.5,1
Khachanov K.,11,378,217,161,Norrie C.,13,287,172,115,2021-08-10,Toronto,Canadian Open,Hard,1.8,2.0,1
Isner J.,114,755,465,290,Davidovich Fokina A.,39,168,84,84,2021-08-10,Toronto,Canadian Open,Hard,1.61,2.3,1
Nishikori K.,439,617,408,209,Kecmanovic M.,40,210,107,103,2021-08-10,Toronto,Canadian Open,Hard,1.4,3.0,1
Ruusuvuori E.,55,158,79,79,Lajovic D.,66,378,163,215,2021-08-10,Toronto,Canadian Open,Hard,1.33,3.4,0
Opelka R.,17,168,88,80,Kyrgios N.,25,303,195,108,2021-08-10,Toronto,Canadian Open,Hard,2.1,1.72,1
Pospisil V.,99,280,122,158,Paul T.,14,204,111,93,2021-08-10,Toronto,Canadian Open,Hard,1.8,2.0,0
Brooksby J.,39,79,46,33,Basilashvili N.,118,301,138,163,2021-08-10,Toronto,Canadian Open,Hard,1.44,2.75,0
Karatsev A.,75,136,66,70,Khachanov K.,11,378,217,161,2021-08-11,Toronto,Canadian Open,Hard,2.37,1.57,0
Hurkacz H.,17,238,137,101,Nishikori K.,439,617,408,209,2021-08-11,Toronto,Canadian Open,Hard,1.9,1.9,1
Paul T.,14,204,111,93,Bautista Agut R.,25,379,234,145,2021-08-11,Toronto,Canadian Open,Hard,2.75,1.44,0
Paire B.,149,527,237,290,Schwartzman D.,95,428,233,195,2021-08-11,Toronto,Canadian Open,Hard,3.2,1.36,0
Basilashvili N.,118,301,138,163,De Minaur A.,19,272,161,111,2021-08-11,Toronto,Canadian Open,Hard,2.5,1.53,1
Fognini F.,128,742,383,359,Rublev A.,7,392,255,137,2021-08-11,Toronto,Canadian Open,Hard,4.0,1.25,0
Tsitsipas S.,5,390,264,126,Humbert U.,36,170,80,90,2021-08-11,Toronto,Canadian Open,Hard,1.36,2.5,1
Harris L.,186,129,59,70,Lopez F.,634,863,441,422,2021-08-11,Toronto,Canadian Open,Hard,1.25,4.0,1
Isner J.,114,755,465,290,Garin C.,101,190,103,87,2021-08-11,Toronto,Canadian Open,Hard,1.44,2.75,1
Sinner J.,8,224,153,71,Duckworth J.,123,143,55,88,2021-08-11,Toronto,Canadian Open,Hard,1.2,4.5,0
Opelka R.,17,168,88,80,Dimitrov G.,20,651,389,262,2021-08-11,Toronto,Canadian Open,Hard,1.53,2.5,1
Auger-Aliassime F.,12,268,163,105,Lajovic D.,66,378,163,215,2021-08-11,Toronto,Canadian Open,Hard,1.25,4.0,0
Opelka R.,17,168,88,80,Harris L.,186,129,59,70,2021-08-12,Toronto,Canadian Open,Hard,1.9,1.9,1
Tiafoe F.,10,303,158,145,Monfils G.,323,816,510,306,2021-08-12,Toronto,Canadian Open,Hard,1.4,3.0,0
Bautista Agut R.,25,379,234,145,Schwartzman D.,95,428,233,195,2021-08-12,Toronto,Canadian Open,Hard,1.8,2.0,1
Rublev A.,7,392,255,137,Isner J.,114,755,465,290,2021-08-12,Toronto,Canadian Open,Hard,1.44,2.75,0
Khachanov K.,11,378,217,161,Tsitsipas S.,5,390,264,126,2021-08-12,Toronto,Canadian Open,Hard,2.5,1.36,0
Ruud C.,4,275,176,99,Lajovic D.,66,378,163,215,2021-08-12,Toronto,Canadian Open,Hard,1.36,3.2,1
Millman J.,140,256,113,143,Monfils G.,323,816,510,306,2021-08-12,Toronto,Canadian Open,Hard,1.61,2.3,0
Shapovalov D.,29,298,166,132,Tiafoe F.,10,303,158,145,2021-08-12,Toronto,Canadian Open,Hard,2.5,3.2,0
Duckworth J.,123,143,55,88,Medvedev D.,3,406,289,117,2021-08-13,Toronto,Canadian Open,Hard,8.0,1.08,0
Basilashvili N.,118,301,138,163,Hurkacz H.,17,238,137,101,2021-08-13,Toronto,Canadian Open,Hard,2.2,1.66,0
Ruud C.,4,275,176,99,Tsitsipas S.,5,390,264,126,2021-08-13,Toronto,Canadian Open,Hard,2.5,1.25,0
Bautista Agut R.,25,379,234,145,Opelka R.,17,168,88,80,2021-08-13,Toronto,Canadian Open,Hard,1.66,2.2,0
Opelka R.,17,168,88,80,Tsitsipas S.,5,390,264,126,2021-08-14,Toronto,Canadian Open,Hard,4.33,1.22,1
Monfils G.,323,816,510,306,Isner J.,114,755,465,290,2021-08-14,Toronto,Canadian Open,Hard,2.62,1.5,0
Hurkacz H.,17,238,137,101,Medvedev D.,3,406,289,117,2021-08-14,Toronto,Canadian Open,Hard,4.33,1.22,0
Medvedev D.,3,406,289,117,Isner J.,114,755,465,290,2021-08-15,Toronto,Canadian Open,Hard,1.3,3.5,1
Medvedev D.,3,406,289,117,Opelka R.,17,168,88,80,2021-08-15,Toronto,Canadian Open,Hard,1.16,5.0,1
Kecmanovic M.,40,210,107,103,Paire B.,149,527,237,290,2021-08-15,Cincinnati,Western & Southern Financial Group Masters,Hard,1.57,2.37,0
Evans D.,30,251,124,127,Schwartzman D.,95,428,233,195,2021-08-16,Cincinnati,Western & Southern Financial Group Masters,Hard,2.75,1.44,0
Harris L.,186,129,59,70,Nishioka Y.,31,215,99,116,2021-08-16,Cincinnati,Western & Southern Financial Group Masters,Hard,1.4,3.0,1
Fucsovics M.,67,249,121,128,Auger-Aliassime F.,12,268,163,105,2021-08-16,Cincinnati,Western & Southern Financial Group Masters,Hard,2.75,1.44,0
Fritz T.,9,356,205,151,Ramos-Vinolas A.,82,437,204,233,2021-08-16,Cincinnati,Western & Southern Financial Group Masters,Hard,1.36,3.2,0
Pella G.,199,260,118,142,Goffin D.,123,522,296,226,2021-08-16,Cincinnati,Western & Southern Financial Group Masters,Hard,3.5,1.3,1
Fognini F.,128,742,383,359,Basilashvili N.,118,301,138,163,2021-08-16,Cincinnati,Western & Southern Financial Group Masters,Hard,2.1,1.72,1
Sinner J.,8,224,153,71,Delbonis F.,131,340,152,188,2021-08-16,Cincinnati,Western & Southern Financial Group Masters,Hard,1.14,5.5,1
Koepfer D.,84,86,38,48,Struff J.L.,21,369,170,199,2021-08-16,Cincinnati,Western & Southern Financial Group Masters,Hard,2.2,1.66,1
Giron M.,69,150,68,82,Bublik A.,25,219,110,109,2021-08-17,Cincinnati,Western & Southern Financial Group Masters,Hard,2.37,1.57,0
Moutet C.,80,118,50,68,Opelka R.,17,168,88,80,2021-08-17,Cincinnati,Western & Southern Financial Group Masters,Hard,2.75,1.44,0
Sonego L.,43,221,107,114,Alcaraz C.,1,164,130,34,2021-08-17,Cincinnati,Western & Southern Financial Group Masters,Hard,2.2,1.66,1
Norrie C.,13,287,172,115,Isner J.,114,755,465,290,2021-08-17,Cincinnati,Western & Southern Financial Group Masters,Hard,1.9,1.9,0
Cilic M.,100,853,543,310,Karatsev A.,75,136,66,70,2021-08-17,Cincinnati,Western & Southern Financial Group Masters,Hard,2.0,1.8,1
Djere L.,38,243,120,123,Korda S.,26,126,75,51,2021-08-17,Cincinnati,Western & Southern Financial Group Masters,Hard,4.5,1.2,0
Mcdonald M.,60,190,87,103,Nakashima B.,70,106,57,49,2021-08-17,Cincinnati,Western & Southern Financial Group Masters,Hard,2.2,1.66,1
Hurkacz H.,17,238,137,101,Davidovich Fokina A.,39,168,84,84,2021-08-17,Cincinnati,Western & Southern Financial Group Masters,Hard,1.36,3.2,1
Anderson K.,652,598,347,251,Khachanov K.,11,378,217,161,2021-08-17,Cincinnati,Western & Southern Financial Group Masters,Hard,2.3,1.61,0
Gasquet R.,48,948,581,367,Murray A.,44,932,687,245,2021-08-17,Cincinnati,Western & Southern Financial Group Masters,Hard,1.72,2.1,0
De Minaur A.,19,272,161,111,Krajinovic F.,93,240,115,125,2021-08-17,Cincinnati,Western & Southern Financial Group Masters,Hard,1.66,2.2,1
Dimitrov G.,20,651,389,262,Bautista Agut R.,25,379,234,145,2021-08-17,Cincinnati,Western & Southern Financial Group Masters,Hard,2.62,1.5,1
Zverev A.,19,500,346,154,Harris L.,186,129,59,70,2021-08-18,Cincinnati,Western & Southern Financial Group Masters,Hard,1.3,3.5,1
Sinner J.,8,224,153,71,Isner J.,114,755,465,290,2021-08-18,Cincinnati,Western & Southern Financial Group Masters,Hard,1.66,2.2,0
Medvedev D.,3,406,289,117,Mcdonald M.,60,190,87,103,2021-08-18,Cincinnati,Western & Southern Financial Group Masters,Hard,1.16,5.0,1
Ruud C.,4,275,176,99,Opelka R.,17,168,88,80,2021-08-18,Cincinnati,Western & Southern Financial Group Masters,Hard,1.72,2.1,1
Rublev A.,7,392,255,137,Cilic M.,100,853,543,310,2021-08-18,Cincinnati,Western & Southern Financial Group Masters,Hard,1.3,3.5,1
Hurkacz H.,17,238,137,101,Murray A.,44,932,687,245,2021-08-18,Cincinnati,Western & Southern Financial Group Masters,Hard,1.33,3.4,1
Fognini F.,128,742,383,359,Pella G.,199,260,118,142,2021-08-18,Cincinnati,Western & Southern Financial Group Masters,Hard,1.3,3.5,0
Bublik A.,25,219,110,109,Dimitrov G.,20,651,389,262,2021-08-18,Cincinnati,Western & Southern Financial Group Masters,Hard,2.1,1.72,0
Koepfer D.,84,86,38,48,Carreno Busta P.,16,352,214,138,2021-08-18,Cincinnati,Western & Southern Financial Group Masters,Hard,3.5,1.3,0
Paire B.,149,527,237,290,Shapovalov D.,29,298,166,132,2021-08-18,Cincinnati,Western & Southern Financial Group Masters,Hard,3.75,1.28,1
Berrettini M.,38,217,142,75,Ramos-Vinolas A.,82,437,204,233,2021-08-18,Cincinnati,Western & Southern Financial Group Masters,Hard,1.14,5.5,1
Paul T.,14,204,111,93,Garin C.,101,190,103,87,2021-08-18,Cincinnati,Western & Southern Financial Group Masters,Hard,1.72,2.1,1
Tiafoe F.,10,303,158,145,Humbert U.,36,170,80,90,2021-08-18,Cincinnati,Western & Southern Financial Group Masters,Hard,2.5,1.53,1
Lajovic D.,66,378,163,215,Monfils G.,323,816,510,306,2021-08-18,Cincinnati,Western & Southern Financial Group Masters,Hard,2.3,1.61,0
Sonego L.,43,221,107,114,Paul T.,14,204,111,93,2021-08-18,Cincinnati,Western & Southern Financial Group Masters,Hard,1.72,2.1,1
Auger-Aliassime F.,12,268,163,105,Khachanov K.,11,378,217,161,2021-08-18,Cincinnati,Western & Southern Financial Group Masters,Hard,2.37,1.57,1
De Minaur A.,19,272,161,111,Monfils G.,323,816,510,306,2021-08-18,Cincinnati,Western & Southern Financial Group Masters,Hard,1.72,2.1,0
Carreno Busta P.,16,352,214,138,Hurkacz H.,17,238,137,101,2021-08-19,Cincinnati,Western & Southern Financial Group Masters,Hard,2.0,1.8,1
Zverev A.,19,500,346,154,Pella G.,199,260,118,142,2021-08-19,Cincinnati,Western & Southern Financial Group Masters,Hard,1.08,8.0,1
Monfils G.,323,816,510,306,Rublev A.,7,392,255,137,2021-08-19,Cincinnati,Western & Southern Financial Group Masters,Hard,3.5,1.3,0
Schwartzman D.,95,428,233,195,Ruud C.,4,275,176,99,2021-08-19,Cincinnati,Western & Southern Financial Group Masters,Hard,2.0,1.8,0
Dimitrov G.,20,651,389,262,Medvedev D.,3,406,289,117,2021-08-19,Cincinnati,Western & Southern Financial Group Masters,Hard,5.0,1.16,0
Korda S.,26,126,75,51,Tsitsipas S.,5,390,264,126,2021-08-19,Cincinnati,Western & Southern Financial Group Masters,Hard,3.5,1.3,0
Tiafoe F.,10,303,158,145,Schwartzman D.,95,428,233,195,2021-08-19,Cincinnati,Western & Southern Financial Group Masters,Hard,2.1,1.72,0
Isner J.,114,755,465,290,Paire B.,149,527,237,290,2021-08-19,Cincinnati,Western & Southern Financial Group Masters,Hard,1.36,3.2,0
Tsitsipas S.,5,390,264,126,Sonego L.,43,221,107,114,2021-08-20,Cincinnati,Western & Southern Financial Group Masters,Hard,1.16,5.0,1
Auger-Aliassime F.,12,268,163,105,Berrettini M.,38,217,142,75,2021-08-20,Cincinnati,Western & Southern Financial Group Masters,Hard,2.5,1.53,1
Paire B.,149,527,237,290,Rublev A.,7,392,255,137,2021-08-20,Cincinnati,Western & Southern Financial Group Masters,Hard,4.5,1.2,0
Medvedev D.,3,406,289,117,Carreno Busta P.,16,352,214,138,2021-08-20,Cincinnati,Western & Southern Financial Group Masters,Hard,1.28,3.75,1
Zverev A.,19,500,346,154,Tsitsipas S.,5,390,264,126,2021-08-21,Cincinnati,Western & Southern Financial Group Masters,Hard,1.66,2.2,1
Rublev A.,7,392,255,137,Medvedev D.,3,406,289,117,2021-08-21,Cincinnati,Western & Southern Financial Group Masters,Hard,4.33,1.22,1
Auger-Aliassime F.,12,268,163,105,Tsitsipas S.,5,390,264,126,2021-08-21,Cincinnati,Western & Southern Financial Group Masters,Hard,3.2,1.36,0
Zverev A.,19,500,346,154,Ruud C.,4,275,176,99,2021-08-21,Cincinnati,Western & Southern Financial Group Masters,Hard,1.25,4.0,1
Zverev A.,19,500,346,154,Rublev A.,7,392,255,137,2021-08-22,Cincinnati,Western & Southern Financial Group Masters,Hard,1.4,3.0,1
Sandgren T.,153,121,47,74,Cecchinato M.,108,204,79,125,2021-08-22,Winston-Salem,Winston-Salem Open at Wake Forest University,Hard,1.36,3.2,0
Gerasimov E.,150,93,43,50,Gombos N.,114,66,21,45,2021-08-22,Winston-Salem,Winston-Salem Open at Wake Forest University,Hard,1.53,2.5,1
Monteiro T.,121,171,69,102,Duckworth J.,123,143,55,88,2021-08-22,Winston-Salem,Winston-Salem Open at Wake Forest University,Hard,3.75,1.28,1
Ivashka I.,113,159,78,81,Seppi A.,141,758,363,395,2021-08-23,Winston-Salem,Winston-Salem Open at Wake Forest University,Hard,1.33,3.4,1
Pouille L.,675,259,134,125,Lopez F.,634,863,441,422,2021-08-23,Winston-Salem,Winston-Salem Open at Wake Forest University,Hard,1.66,2.2,1
Munar J.,104,178,75,103,Watanuki Y.,99,25,11,14,2021-08-23,Winston-Salem,Winston-Salem Open at Wake Forest University,Hard,1.36,3.2,0
Kudla D.,137,198,70,128,Ruusuvuori E.,55,158,79,79,2021-08-23,Winston-Salem,Winston-Salem Open at Wake Forest University,Hard,2.37,1.57,0
Thompson J.,71,221,96,125,Pella G.,199,260,118,142,2021-08-23,Winston-Salem,Winston-Salem Open at Wake Forest University,Hard,1.72,2.1,1
Wu T.L.,175,6,1,5,Mager G.,67,59,24,35,2021-08-23,Winston-Salem,Winston-Salem Open at Wake Forest University,Hard,2.2,1.66,0
Rinderknech A.,67,96,46,50,Simon G.,188,869,491,378,2021-08-23,Winston-Salem,Winston-Salem Open at Wake Forest University,Hard,1.33,3.4,0
Giron M.,69,150,68,82,Bagnis F.,135,121,39,82,2021-08-23,Winston-Salem,Winston-Salem Open at Wake Forest University,Hard,1.25,4.0,1
Murray A.,44,932,687,245,Rubin N.,306,29,8,21,2021-08-23,Winston-Salem,Winston-Salem Open at Wake Forest University,Hard,,,1
Ymer M.,59,130,58,72,Travaglia S.,1024,81,27,54,2021-08-23,Winston-Salem,Winston-Salem Open at Wake Forest University,Hard,1.72,2.1,1
Kwon S.W.,68,108,53,55,Albot R.,97,215,86,129,2021-08-23,Winston-Salem,Winston-Salem Open at Wake Forest University,Hard,1.36,3.2,1
Coria F.,108,99,43,56,Musetti L.,18,143,79,64,2021-08-23,Winston-Salem,Winston-Salem Open at Wake Forest University,Hard,3.4,1.33,1
Ymer M.,59,130,58,72,Ramos-Vinolas A.,82,437,204,233,2021-08-24,Winston-Salem,Winston-Salem Open at Wake Forest University,Hard,1.8,2.0,1
Watanuki Y.,99,25,11,14,Fucsovics M.,67,249,121,128,2021-08-24,Winston-Salem,Winston-Salem Open at Wake Forest University,Hard,4.0,1.25,0
Pouille L.,675,259,134,125,Evans D.,30,251,124,127,2021-08-24,Winston-Salem,Winston-Salem Open at Wake Forest University,Hard,3.0,1.4,0
Cilic M.,100,853,543,310,Ivashka I.,113,159,78,81,2021-08-24,Winston-Salem,Winston-Salem Open at Wake Forest University,Hard,1.72,2.1,0
Mager G.,67,59,24,35,Struff J.L.,21,369,170,199,2021-08-24,Winston-Salem,Winston-Salem Open at Wake Forest University,Hard,2.75,1.44,0
Bublik A.,25,219,110,109,Ruusuvuori E.,55,158,79,79,2021-08-24,Winston-Salem,Winston-Salem Open at Wake Forest University,Hard,2.0,1.8,0
Paire B.,149,527,237,290,Simon G.,188,869,491,378,2021-08-24,Winston-Salem,Winston-Salem Open at Wake Forest University,Hard,1.72,2.1,1
Kwon S.W.,68,108,53,55,Carreno Busta P.,16,352,214,138,2021-08-24,Winston-Salem,Winston-Salem Open at Wake Forest University,Hard,4.33,1.22,0
Gasquet R.,48,948,581,367,Gerasimov E.,150,93,43,50,2021-08-24,Winston-Salem,Winston-Salem Open at Wake Forest University,Hard,1.5,2.62,1
Cecchinato M.,108,204,79,125,Koepfer D.,84,86,38,48,2021-08-24,Winston-Salem,Winston-Salem Open at Wake Forest University,Hard,3.0,1.4,0
Johnson S.,197,395,196,199,Popyrin A.,90,140,59,81,2021-08-24,Winston-Salem,Winston-Salem Open at Wake Forest University,Hard,1.36,3.2,0
Herbert P.H.,157,202,89,113,Coria F.,108,99,43,56,2021-08-24,Winston-Salem,Winston-Salem Open at Wake Forest University,Hard,1.44,2.75,1
Purcell M.,78,28,9,19,Ymer M.,59,130,58,72,2021-08-25,Winston-Salem,Winston-Salem Open at Wake Forest University,Hard,2.75,1.44,0
Evans D.,30,251,124,127,Gasquet R.,48,948,581,367,2021-08-25,Winston-Salem,Winston-Salem Open at Wake Forest University,Hard,1.72,2.1,0
Ruusuvuori E.,55,158,79,79,Paire B.,149,527,237,290,2021-08-25,Winston-Salem,Winston-Salem Open at Wake Forest University,Hard,1.66,2.2,1
Struff J.L.,21,369,170,199,Ivashka I.,113,159,78,81,2021-08-25,Winston-Salem,Winston-Salem Open at Wake Forest University,Hard,2.0,1.8,0
Carreno Busta P.,16,352,214,138,Koepfer D.,84,86,38,48,2021-08-25,Winston-Salem,Winston-Salem Open at Wake Forest University,Hard,1.25,4.0,1
Tiafoe F.,10,303,158,145,Murray A.,44,932,687,245,2021-08-25,Winston-Salem,Winston-Salem Open at Wake Forest University,Hard,1.72,2.1,1
Alcaraz C.,1,164,130,34,Popyrin A.,90,140,59,81,2021-08-25,Winston-Salem,Winston-Salem Open at Wake Forest University,Hard,1.72,2.1,1
Giron M.,69,150,68,82,Delbonis F.,131,340,152,188,2021-08-25,Winston-Salem,Winston-Salem Open at Wake Forest University,Hard,1.36,3.2,1
Thompson J.,71,221,96,125,Purcell M.,78,28,9,19,2021-08-25,Winston-Salem,Winston-Salem Open at Wake Forest University,Hard,1.36,3.2,0
Nava E.,242,13,2,11,Monteiro T.,121,171,69,102,2021-08-25,Winston-Salem,Winston-Salem Open at Wake Forest University,Hard,6.0,1.12,0
Ruusuvuori E.,55,158,79,79,Gasquet R.,48,948,581,367,2021-08-26,Winston-Salem,Winston-Salem Open at Wake Forest University,Hard,1.57,2.37,1
Ivashka I.,113,159,78,81,Carreno Busta P.,16,352,214,138,2021-08-26,Winston-Salem,Winston-Salem Open at Wake Forest University,Hard,2.62,1.5,1
Herbert P.H.,157,202,89,113,Giron M.,69,150,68,82,2021-08-26,Winston-Salem,Winston-Salem Open at Wake Forest University,Hard,2.75,1.44,0
Monteiro T.,121,171,69,102,Tiafoe F.,10,303,158,145,2021-08-26,Winston-Salem,Winston-Salem Open at Wake Forest University,Hard,4.33,1.22,0
Fucsovics M.,67,249,121,128,Alcaraz C.,1,164,130,34,2021-08-26,Winston-Salem,Winston-Salem Open at Wake Forest University,Hard,2.0,1.8,0
Ymer M.,59,130,58,72,Tiafoe F.,10,303,158,145,2021-08-27,Winston-Salem,Winston-Salem Open at Wake Forest University,Hard,2.75,1.44,1
Alcaraz C.,1,164,130,34,Giron M.,69,150,68,82,2021-08-27,Winston-Salem,Winston-Salem Open at Wake Forest University,Hard,1.57,2.37,1
Ivashka I.,113,159,78,81,Ruusuvuori E.,55,158,79,79,2021-08-28,Winston-Salem,Winston-Salem Open at Wake Forest University,Hard,1.57,2.37,1
Ymer M.,59,130,58,72,Alcaraz C.,1,164,130,34,2021-08-28,Winston-Salem,Winston-Salem Open at Wake Forest University,Hard,2.75,1.44,1
Ivashka I.,113,159,78,81,Ymer M.,59,130,58,72,2021-08-28,Winston-Salem,Winston-Salem Open at Wake Forest University,Hard,1.44,2.75,1
Sugita Y.,131,129,47,82,Ruud C.,4,275,176,99,2021-08-30,New York,US Open,Hard,10.0,1.06,0
Mannarino A.,27,567,264,303,Herbert P.H.,157,202,89,113,2021-08-30,New York,US Open,Hard,2.75,1.44,1
Murray A.,44,932,687,245,Tsitsipas S.,5,390,264,126,2021-08-30,New York,US Open,Hard,9.0,1.07,0
Riffice S.,542,1,0,1,Dimitrov G.,20,651,389,262,2021-08-30,New York,US Open,Hard,11.0,1.05,0
Trungelliti M.,240,33,13,20,Davidovich Fokina A.,39,168,84,84,2021-08-30,New York,US Open,Hard,5.5,1.14,1
Molcan A.,120,86,45,41,Ilkel C.,382,17,1,16,2021-08-30,New York,US Open,Hard,1.3,3.5,1
Kecmanovic M.,40,210,107,103,Rinderknech A.,67,96,46,50,2021-08-30,New York,US Open,Hard,1.8,2.0,0
Majchrzak K.,121,50,19,31,Ruusuvuori E.,55,158,79,79,2021-08-30,New York,US Open,Hard,2.75,1.44,0
Hoang A.,155,19,6,13,Giron M.,69,150,68,82,2021-08-30,New York,US Open,Hard,4.33,1.22,0
Albot R.,97,215,86,129,Popyrin A.,90,140,59,81,2021-08-30,New York,US Open,Hard,4.33,1.22,0
Halys Q.,79,72,23,49,Koepfer D.,84,86,38,48,2021-08-30,New York,US Open,Hard,3.0,1.4,0
Norrie C.,13,287,172,115,Alcaraz C.,1,164,130,34,2021-08-30,New York,US Open,Hard,1.44,2.75,0
Van De Zandschulp B.,44,117,63,54,Taberner C.,181,37,13,24,2021-08-30,New York,US Open,Hard,1.36,3.2,1
Nakashima B.,70,106,57,49,Isner J.,114,755,465,290,2021-08-30,New York,US Open,Hard,2.5,1.53,1
Kukushkin M.,221,352,141,211,Andujar P.,323,404,164,240,2021-08-30,New York,US Open,Hard,1.5,2.62,0
Gombos N.,114,66,21,45,Garin C.,101,190,103,87,2021-08-30,New York,US Open,Hard,3.5,1.3,0
Paire B.,149,527,237,290,Lajovic D.,66,378,163,215,2021-08-30,New York,US Open,Hard,1.53,2.5,0
Daniel T.,111,178,67,111,Bagnis F.,135,121,39,82,2021-08-30,New York,US Open,Hard,1.57,2.37,0
Schwartzman D.,95,428,233,195,Berankis R.,212,249,104,145,2021-08-30,New York,US Open,Hard,1.14,5.5,1
Evans D.,30,251,124,127,Monteiro T.,121,171,69,102,2021-08-30,New York,US Open,Hard,1.28,3.75,1
Zapata Miralles B.,54,80,32,48,Lopez F.,634,863,441,422,2021-08-30,New York,US Open,Hard,1.66,2.2,1
Anderson K.,652,598,347,251,Vesely J.,528,288,130,158,2021-08-30,New York,US Open,Hard,1.3,3.5,1
Humbert U.,36,170,80,90,Gojowczyk P.,108,172,75,97,2021-08-30,New York,US Open,Hard,1.2,4.5,0
Auger-Aliassime F.,12,268,163,105,Donskoy E.,149,162,50,112,2021-08-30,New York,US Open,Hard,1.07,9.0,1
Cilic M.,100,853,543,310,Kohlschreiber P.,132,812,446,366,2021-08-30,New York,US Open,Hard,1.4,3.0,0
Rublev A.,7,392,255,137,Karlovic I.,221,674,351,323,2021-08-30,New York,US Open,Hard,1.05,11.0,1
Martinez P.,135,118,50,68,Duckworth J.,123,143,55,88,2021-08-30,New York,US Open,Hard,2.75,1.44,1
Millman J.,140,256,113,143,Laaksonen H.,125,101,37,64,2021-08-30,New York,US Open,Hard,1.53,2.5,0
Carballes Baena R.,64,207,91,116,Paul T.,14,204,111,93,2021-08-31,New York,US Open,Hard,5.0,1.16,1
Cressy M.,96,96,42,54,Carreno Busta P.,16,352,214,138,2021-08-31,New York,US Open,Hard,7.0,1.1,1
Sinner J.,8,224,153,71,Purcell M.,78,28,9,19,2021-08-31,New York,US Open,Hard,1.08,8.0,1
Shapovalov D.,29,298,166,132,Delbonis F.,131,340,152,188,2021-08-31,New York,US Open,Hard,1.1,7.0,1
Korda S.,26,126,75,51,Basilashvili N.,118,301,138,163,2021-08-31,New York,US Open,Hard,1.4,3.0,0
Mager G.,67,59,24,35,Thompson J.,71,221,96,125,2021-08-31,New York,US Open,Hard,3.4,1.33,0
Moutet C.,80,118,50,68,Travaglia S.,1024,81,27,54,2021-08-31,New York,US Open,Hard,1.61,2.3,1
Chardy J.,542,591,289,302,Berrettini M.,38,217,142,75,2021-08-31,New York,US Open,Hard,7.0,1.1,0
Struff J.L.,21,369,170,199,Griekspoor T.,37,97,47,50,2021-08-31,New York,US Open,Hard,1.3,3.5,0
Sock J.,166,324,177,147,Nishioka Y.,31,215,99,116,2021-08-31,New York,US Open,Hard,2.0,1.8,1
Marterer M.,144,91,31,60,Johnson S.,197,395,196,199,2021-08-31,New York,US Open,Hard,2.62,1.5,0
Sandgren T.,153,121,47,74,Ivashka I.,113,159,78,81,2021-08-31,New York,US Open,Hard,4.0,1.25,0
Fognini F.,128,742,383,359,Pospisil V.,99,280,122,158,2021-08-31,New York,US Open,Hard,1.57,2.37,0
Svajda Z.,233,8,2,6,Cecchinato M.,108,204,79,125,2021-08-31,New York,US Open,Hard,2.75,1.44,1
Brooksby J.,39,79,46,33,Ymer M.,59,130,58,72,2021-08-31,New York,US Open,Hard,1.4,3.0,1
Sonego L.,43,221,107,114,Otte O.,233,78,33,45,2021-08-31,New York,US Open,Hard,1.33,3.4,0
Monfils G.,323,816,510,306,Coria F.,108,99,43,56,2021-08-31,New York,US Open,Hard,1.12,6.0,1
Hanfmann Y.,50,99,50,49,Bublik A.,25,219,110,109,2021-08-31,New York,US Open,Hard,5.0,1.16,0
Fucsovics M.,67,249,121,128,Seppi A.,141,758,363,395,2021-08-31,New York,US Open,Hard,1.16,5.0,0
Eubanks C.,29,64,28,36,Tiafoe F.,10,303,158,145,2021-08-31,New York,US Open,Hard,4.5,1.2,0
Krajinovic F.,93,240,115,125,Pella G.,199,260,118,142,2021-08-31,New York,US Open,Hard,1.3,3.5,0
Kyrgios N.,25,303,195,108,Bautista Agut R.,25,379,234,145,2021-08-31,New York,US Open,Hard,2.37,1.57,0
Medvedev D.,3,406,289,117,Gasquet R.,48,948,581,367,2021-08-31,New York,US Open,Hard,1.04,13.0,1
Musetti L.,18,143,79,64,Nava E.,242,13,2,11,2021-08-31,New York,US Open,Hard,1.4,3.0,1
Goffin D.,123,522,296,226,Mcdonald M.,60,190,87,103,2021-08-31,New York,US Open,Hard,3.0,1.4,0
Opelka R.,17,168,88,80,Kwon S.W.,68,108,53,55,2021-08-31,New York,US Open,Hard,1.3,3.5,1
Djere L.,38,243,120,123,Kudla D.,137,198,70,128,2021-08-31,New York,US Open,Hard,2.5,1.53,0
Ramos-Vinolas A.,82,437,204,233,Pouille L.,675,259,134,125,2021-08-31,New York,US Open,Hard,1.61,2.3,1
Harris L.,186,129,59,70,Khachanov K.,11,378,217,161,2021-08-31,New York,US Open,Hard,2.75,1.44,1
Nishikori K.,439,617,408,209,Caruso S.,146,63,19,44,2021-08-31,New York,US Open,Hard,1.11,6.5,1
Escobedo E.,377,57,20,37,Cuevas P.,149,421,210,211,2021-08-31,New York,US Open,Hard,1.57,2.37,1
Zverev A.,19,500,346,154,Querrey S.,287,678,369,309,2021-08-31,New York,US Open,Hard,1.04,13.0,1
Hurkacz H.,17,238,137,101,Gerasimov E.,150,93,43,50,2021-08-31,New York,US Open,Hard,1.12,6.0,1
Karatsev A.,75,136,66,70,Munar J.,104,178,75,103,2021-08-31,New York,US Open,Hard,1.25,4.0,1
Garin C.,101,190,103,87,Laaksonen H.,125,101,37,64,2021-09-01,New York,US Open,Hard,1.57,2.37,0
Pella G.,199,260,118,142,Tiafoe F.,10,303,158,145,2021-09-01,New York,US Open,Hard,3.2,1.36,0
Bautista Agut R.,25,379,234,145,Ruusuvuori E.,55,158,79,79,2021-09-01,New York,US Open,Hard,1.5,2.62,1
Auger-Aliassime F.,12,268,163,105,Zapata Miralles B.,54,80,32,48,2021-09-01,New York,US Open,Hard,1.11,6.5,1
Bagnis F.,135,121,39,82,Trungelliti M.,240,33,13,20,2021-09-01,New York,US Open,Hard,1.72,2.1,1
Andujar P.,323,404,164,240,Kohlschreiber P.,132,812,446,366,2021-09-01,New York,US Open,Hard,3.5,1.3,1
Gojowczyk P.,108,172,75,97,Lajovic D.,66,378,163,215,2021-09-01,New York,US Open,Hard,2.2,1.66,1
Koepfer D.,84,86,38,48,Medvedev D.,3,406,289,117,2021-09-01,New York,US Open,Hard,17.0,1.02,0
Giron M.,69,150,68,82,Evans D.,30,251,124,127,2021-09-01,New York,US Open,Hard,2.0,1.8,0
Molcan A.,120,86,45,41,Nakashima B.,70,106,57,49,2021-09-01,New York,US Open,Hard,3.5,1.3,1
Rinderknech A.,67,96,46,50,Alcaraz C.,1,164,130,34,2021-09-01,New York,US Open,Hard,3.4,1.33,0
Dimitrov G.,20,651,389,262,Popyrin A.,90,140,59,81,2021-09-01,New York,US Open,Hard,1.5,2.62,0
Martinez P.,135,118,50,68,Rublev A.,7,392,255,137,2021-09-01,New York,US Open,Hard,13.0,1.04,0
De Minaur A.,19,272,161,111,Fritz T.,9,356,205,151,2021-09-01,New York,US Open,Hard,1.57,2.37,0
Rune H.,6,131,83,48,Djokovic N.,2,1207,1012,195,2021-09-01,New York,US Open,Hard,23.0,1.01,0
Van De Zandschulp B.,44,117,63,54,Ruud C.,4,275,176,99,2021-09-01,New York,US Open,Hard,8.0,1.08,1
Fritz T.,9,356,205,151,Brooksby J.,39,79,46,33,2021-09-02,New York,US Open,Hard,1.9,1.9,0
Bublik A.,25,219,110,109,Sock J.,166,324,177,147,2021-09-02,New York,US Open,Hard,1.72,2.1,0
Sinner J.,8,224,153,71,Svajda Z.,233,8,2,6,2021-09-02,New York,US Open,Hard,1.05,11.0,1
Nishikori K.,439,617,408,209,Mcdonald M.,60,190,87,103,2021-09-02,New York,US Open,Hard,1.57,2.37,1
Harris L.,186,129,59,70,Escobedo E.,377,57,20,37,2021-09-02,New York,US Open,Hard,1.25,4.0,1
Monfils G.,323,816,510,306,Johnson S.,197,395,196,199,2021-09-02,New York,US Open,Hard,1.36,3.2,1
Hurkacz H.,17,238,137,101,Seppi A.,141,758,363,395,2021-09-02,New York,US Open,Hard,1.11,6.5,0
Kudla D.,137,198,70,128,Otte O.,233,78,33,45,2021-09-02,New York,US Open,Hard,1.57,2.37,0
Ivashka I.,113,159,78,81,Pospisil V.,99,280,122,158,2021-09-02,New York,US Open,Hard,1.22,4.33,1
Berrettini M.,38,217,142,75,Moutet C.,80,118,50,68,2021-09-02,New York,US Open,Hard,1.12,6.0,1
Cressy M.,96,96,42,54,Basilashvili N.,118,301,138,163,2021-09-02,New York,US Open,Hard,2.75,1.44,0
Thompson J.,71,221,96,125,Karatsev A.,75,136,66,70,2021-09-02,New York,US Open,Hard,3.0,1.4,0
Musetti L.,18,143,79,64,Opelka R.,17,168,88,80,2021-09-02,New York,US Open,Hard,4.33,1.22,0
Tsitsipas S.,5,390,264,126,Mannarino A.,27,567,264,303,2021-09-02,New York,US Open,Hard,1.05,11.0,1
Anderson K.,652,598,347,251,Schwartzman D.,95,428,233,195,2021-09-02,New York,US Open,Hard,2.75,1.44,0
Zverev A.,19,500,346,154,Ramos-Vinolas A.,82,437,204,233,2021-09-02,New York,US Open,Hard,1.02,17.0,1
Van De Zandschulp B.,44,117,63,54,Bagnis F.,135,121,39,82,2021-09-03,New York,US Open,Hard,1.36,3.2,1
Molcan A.,120,86,45,41,Schwartzman D.,95,428,233,195,2021-09-03,New York,US Open,Hard,4.5,1.2,0
Alcaraz C.,1,164,130,34,Tsitsipas S.,5,390,264,126,2021-09-03,New York,US Open,Hard,4.5,1.2,1
Medvedev D.,3,406,289,117,Andujar P.,323,404,164,240,2021-09-03,New York,US Open,Hard,1.01,23.0,1
Carballes Baena R.,64,207,91,116,Shapovalov D.,29,298,166,132,2021-09-03,New York,US Open,Hard,8.0,1.08,0
Gojowczyk P.,108,172,75,97,Laaksonen H.,125,101,37,64,2021-09-03,New York,US Open,Hard,2.3,1.61,1
Djokovic N.,2,1207,1012,195,Griekspoor T.,37,97,47,50,2021-09-03,New York,US Open,Hard,1.01,26.0,1
Evans D.,30,251,124,127,Popyrin A.,90,140,59,81,2021-09-03,New York,US Open,Hard,1.72,2.1,1
Djokovic N.,2,1207,1012,195,Nishikori K.,439,617,408,209,2021-09-04,New York,US Open,Hard,1.03,15.0,1
Brooksby J.,39,79,46,33,Karatsev A.,75,136,66,70,2021-09-04,New York,US Open,Hard,1.72,2.1,1
Seppi A.,141,758,363,395,Otte O.,233,78,33,45,2021-09-04,New York,US Open,Hard,2.1,1.72,0
Sinner J.,8,224,153,71,Monfils G.,323,816,510,306,2021-09-04,New York,US Open,Hard,1.57,2.37,1
Rublev A.,7,392,255,137,Tiafoe F.,10,303,158,145,2021-09-04,New York,US Open,Hard,1.25,4.0,0
Berrettini M.,38,217,142,75,Ivashka I.,113,159,78,81,2021-09-04,New York,US Open,Hard,1.44,2.75,1
Auger-Aliassime F.,12,268,163,105,Bautista Agut R.,25,379,234,145,2021-09-04,New York,US Open,Hard,2.0,1.8,1
Shapovalov D.,29,298,166,132,Harris L.,186,129,59,70,2021-09-05,New York,US Open,Hard,1.53,2.5,0
Opelka R.,17,168,88,80,Basilashvili N.,118,301,138,163,2021-09-05,New York,US Open,Hard,1.53,2.5,1
Zverev A.,19,500,346,154,Sock J.,166,324,177,147,2021-09-05,New York,US Open,Hard,1.03,15.0,1
Van De Zandschulp B.,44,117,63,54,Schwartzman D.,95,428,233,195,2021-09-05,New York,US Open,Hard,4.0,1.25,1
Evans D.,30,251,124,127,Medvedev D.,3,406,289,117,2021-09-05,New York,US Open,Hard,15.0,1.03,0
Alcaraz C.,1,164,130,34,Gojowczyk P.,108,172,75,97,2021-09-05,New York,US Open,Hard,1.22,4.33,1
Berrettini M.,38,217,142,75,Otte O.,233,78,33,45,2021-09-06,New York,US Open,Hard,1.11,6.5,1
Opelka R.,17,168,88,80,Harris L.,186,129,59,70,2021-09-06,New York,US Open,Hard,2.0,1.8,0
Tiafoe F.,10,303,158,145,Auger-Aliassime F.,12,268,163,105,2021-09-06,New York,US Open,Hard,2.37,1.57,0
Zverev A.,19,500,346,154,Sinner J.,8,224,153,71,2021-09-06,New York,US Open,Hard,1.16,5.0,1
Brooksby J.,39,79,46,33,Djokovic N.,2,1207,1012,195,2021-09-07,New York,US Open,Hard,15.0,1.03,0
Van De Zandschulp B.,44,117,63,54,Medvedev D.,3,406,289,117,2021-09-07,New York,US Open,Hard,19.0,1.02,0
Alcaraz C.,1,164,130,34,Auger-Aliassime F.,12,268,163,105,2021-09-08,New York,US Open,Hard,2.75,1.44,0
Harris L.,186,129,59,70,Zverev A.,19,500,346,154,2021-09-08,New York,US Open,Hard,6.0,1.12,0
Berrettini M.,38,217,142,75,Djokovic N.,2,1207,1012,195,2021-09-09,New York,US Open,Hard,7.0,1.1,0
Auger-Aliassime F.,12,268,163,105,Medvedev D.,3,406,289,117,2021-09-10,New York,US Open,Hard,5.0,1.16,0
Djokovic N.,2,1207,1012,195,Zverev A.,19,500,346,154,2021-09-11,New York,US Open,Hard,1.4,3.0,1
Djokovic N.,2,1207,1012,195,Medvedev D.,3,406,289,117,2021-09-12,New York,US Open,Hard,1.4,3.0,0
Djere L.,38,243,120,123,Galan D.E.,76,78,33,45,2021-09-20,Nur-Sultan,Astana Open,Hard,1.61,2.3,1
Kecmanovic M.,40,210,107,103,Verdasco F.,244,962,537,425,2021-09-20,Nur-Sultan,Astana Open,Hard,1.4,3.0,1
Pospisil V.,99,280,122,158,Barrere G.,59,79,31,48,2021-09-20,Metz,Open de Moselle,Hard,1.61,2.3,1
Seppi A.,141,758,363,395,Skatov T.,147,5,1,4,2021-09-20,Nur-Sultan,Astana Open,Hard,1.3,3.5,0
Sonego L.,43,221,107,114,Fucsovics M.,67,249,121,128,2021-09-20,Metz,Open de Moselle,Hard,2.1,1.72,1
Basilashvili N.,118,301,138,163,Mager G.,67,59,24,35,2021-09-20,Metz,Open de Moselle,Hard,1.36,3.2,1
Vesely J.,528,288,130,158,Munar J.,104,178,75,103,2021-09-20,Nur-Sultan,Astana Open,Hard,1.53,2.5,0
Ivashka I.,113,159,78,81,Ymer E.,186,81,24,57,2021-09-21,Nur-Sultan,Astana Open,Hard,1.2,4.5,1
Musetti L.,18,143,79,64,Polmans M.,165,19,5,14,2021-09-21,Nur-Sultan,Astana Open,Hard,1.36,3.2,1
Millman J.,140,256,113,143,Popko D.,188,2,0,2,2021-09-21,Nur-Sultan,Astana Open,Hard,1.44,2.75,1
Gerasimov E.,150,93,43,50,Paire B.,149,527,237,290,2021-09-21,Nur-Sultan,Astana Open,Hard,1.8,2.0,1
Struff J.L.,21,369,170,199,Ymer M.,59,130,58,72,2021-09-21,Metz,Open de Moselle,Hard,1.66,2.2,0
Humbert U.,36,170,80,90,Murray A.,44,932,687,245,2021-09-21,Metz,Open de Moselle,Hard,1.61,2.3,0
Simon G.,188,869,491,378,Davidovich Fokina A.,39,168,84,84,2021-09-21,Metz,Open de Moselle,Hard,3.4,1.33,0
Zapata Miralles B.,54,80,32,48,Rune H.,6,131,83,48,2021-09-21,Metz,Open de Moselle,Hard,2.37,1.57,0
Muller A.,81,22,9,13,Khachanov K.,11,378,217,161,2021-09-21,Metz,Open de Moselle,Hard,5.0,1.16,0
Kohlschreiber P.,132,812,446,366,Cecchinato M.,108,204,79,125,2021-09-21,Metz,Open de Moselle,Hard,1.3,3.5,1
Giron M.,69,150,68,82,Rinderknech A.,67,96,46,50,2021-09-21,Metz,Open de Moselle,Hard,2.37,1.57,1
Kukushkin M.,221,352,141,211,Duckworth J.,123,143,55,88,2021-09-22,Nur-Sultan,Astana Open,Hard,3.0,1.4,0
Bonzi B.,107,83,37,46,Ruusuvuori E.,55,158,79,79,2021-09-22,Nur-Sultan,Astana Open,Hard,2.2,1.66,0
Kwon S.W.,68,108,53,55,Donskoy E.,149,162,50,112,2021-09-22,Nur-Sultan,Astana Open,Hard,1.61,2.3,1
Djere L.,38,243,120,123,Musetti L.,18,143,79,64,2021-09-22,Nur-Sultan,Astana Open,Hard,2.1,1.72,1
Skatov T.,147,5,1,4,Ivashka I.,113,159,78,81,2021-09-22,Nur-Sultan,Astana Open,Hard,8.0,1.08,0
Berankis R.,212,249,104,145,Taberner C.,181,37,13,24,2021-09-22,Nur-Sultan,Astana Open,Hard,1.57,2.37,0
Gojowczyk P.,108,172,75,97,Hoang A.,155,19,6,13,2021-09-22,Metz,Open de Moselle,Hard,1.44,2.75,1
Munar J.,104,178,75,103,Millman J.,140,256,113,143,2021-09-22,Nur-Sultan,Astana Open,Hard,2.1,1.72,0
Pouille L.,675,259,134,125,Schnur B.,233,19,4,15,2021-09-22,Metz,Open de Moselle,Hard,1.36,3.2,1
Sonego L.,43,221,107,114,Rune H.,6,131,83,48,2021-09-22,Metz,Open de Moselle,Hard,1.53,2.5,0
Murray A.,44,932,687,245,Pospisil V.,99,280,122,158,2021-09-22,Metz,Open de Moselle,Hard,1.61,2.3,1
Carreno Busta P.,16,352,214,138,Ymer M.,59,130,58,72,2021-09-22,Metz,Open de Moselle,Hard,1.44,2.75,1
Krajinovic F.,93,240,115,125,Duckworth J.,123,143,55,88,2021-09-23,Nur-Sultan,Astana Open,Hard,1.66,2.2,0
De Minaur A.,19,272,161,111,Giron M.,69,150,68,82,2021-09-23,Metz,Open de Moselle,Hard,1.57,2.37,0
Gojowczyk P.,108,172,75,97,Khachanov K.,11,378,217,161,2021-09-23,Metz,Open de Moselle,Hard,3.2,1.36,1
Hurkacz H.,17,238,137,101,Pouille L.,675,259,134,125,2021-09-23,Metz,Open de Moselle,Hard,1.36,3.2,1
Monfils G.,323,816,510,306,Kohlschreiber P.,132,812,446,366,2021-09-23,Metz,Open de Moselle,Hard,1.36,3.2,1
Basilashvili N.,118,301,138,163,Davidovich Fokina A.,39,168,84,84,2021-09-23,Metz,Open de Moselle,Hard,1.61,2.3,1
Kecmanovic M.,40,210,107,103,Bublik A.,25,219,110,109,2021-09-23,Nur-Sultan,Astana Open,Hard,2.2,1.66,0
Karatsev A.,75,136,66,70,Ruusuvuori E.,55,158,79,79,2021-09-23,Nur-Sultan,Astana Open,Hard,1.9,1.9,0
Gerasimov E.,150,93,43,50,Taberner C.,181,37,13,24,2021-09-23,Nur-Sultan,Astana Open,Hard,1.61,2.3,0
Kwon S.W.,68,108,53,55,Lajovic D.,66,378,163,215,2021-09-23,Nur-Sultan,Astana Open,Hard,1.5,2.62,1
Kwon S.W.,68,108,53,55,Djere L.,38,243,120,123,2021-09-24,Nur-Sultan,Astana Open,Hard,1.44,2.75,1
Duckworth J.,123,143,55,88,Millman J.,140,256,113,143,2021-09-24,Nur-Sultan,Astana Open,Hard,1.72,2.1,1
Ruusuvuori E.,55,158,79,79,Ivashka I.,113,159,78,81,2021-09-24,Nur-Sultan,Astana Open,Hard,2.75,1.44,0
Bublik A.,25,219,110,109,Taberner C.,181,37,13,24,2021-09-24,Nur-Sultan,Astana Open,Hard,1.28,3.75,1
Rune H.,6,131,83,48,Carreno Busta P.,16,352,214,138,2021-09-24,Metz,Open de Moselle,Hard,2.62,1.5,0
Basilashvili N.,118,301,138,163,Monfils G.,323,816,510,306,2021-09-24,Metz,Open de Moselle,Hard,2.62,1.5,0
Murray A.,44,932,687,245,Hurkacz H.,17,238,137,101,2021-09-24,Metz,Open de Moselle,Hard,2.2,1.66,0
Gojowczyk P.,108,172,75,97,Giron M.,69,150,68,82,2021-09-24,Metz,Open de Moselle,Hard,1.8,2.0,1
Monfils G.,323,816,510,306,Carreno Busta P.,16,352,214,138,2021-09-25,Metz,Open de Moselle,Hard,2.0,1.8,0
Gojowczyk P.,108,172,75,97,Hurkacz H.,17,238,137,101,2021-09-25,Metz,Open de Moselle,Hard,3.2,1.36,0
Bublik A.,25,219,110,109,Kwon S.W.,68,108,53,55,2021-09-25,Nur-Sultan,Astana Open,Hard,1.44,2.75,0
Duckworth J.,123,143,55,88,Ivashka I.,113,159,78,81,2021-09-25,Nur-Sultan,Astana Open,Hard,3.5,1.3,1
Duckworth J.,123,143,55,88,Kwon S.W.,68,108,53,55,2021-09-26,Nur-Sultan,Astana Open,Hard,1.8,2.0,0
Hurkacz H.,17,238,137,101,Carreno Busta P.,16,352,214,138,2021-09-26,Metz,Open de Moselle,Hard,1.9,1.9,1
Karatsev A.,75,136,66,70,Delbonis F.,131,340,152,188,2021-09-27,San Diego,San Diego Open,Hard,1.25,4.0,1
Andreev A.,319,8,2,6,Kecmanovic M.,40,210,107,103,2021-09-27,Sofia,Sofia Open,Hard,6.0,1.12,0
Mannarino A.,27,567,264,303,Mager G.,67,59,24,35,2021-09-27,Sofia,Sofia Open,Hard,1.5,2.62,0
Paire B.,149,527,237,290,Davidovich Fokina A.,39,168,84,84,2021-09-27,Sofia,Sofia Open,Hard,2.75,1.44,1
Kuzmanov D.,207,12,4,8,Musetti L.,18,143,79,64,2021-09-28,Sofia,Sofia Open,Hard,3.75,1.28,1
Millman J.,140,256,113,143,Ymer M.,59,130,58,72,2021-09-28,Sofia,Sofia Open,Hard,2.3,1.61,1
Giron M.,69,150,68,82,Munar J.,104,178,75,103,2021-09-28,Sofia,Sofia Open,Hard,1.4,3.0,1
Martinez P.,135,118,50,68,Djere L.,38,243,120,123,2021-09-28,Sofia,Sofia Open,Hard,1.61,2.3,0
Pospisil V.,99,280,122,158,Gerasimov E.,150,93,43,50,2021-09-28,Sofia,Sofia Open,Hard,1.72,2.1,0
Korda S.,26,126,75,51,Paul T.,14,204,111,93,2021-09-28,San Diego,San Diego Open,Hard,1.53,2.5,1
Fucsovics M.,67,249,121,128,Dimitrov G.,20,651,389,262,2021-09-28,San Diego,San Diego Open,Hard,1.8,2.0,0
Koepfer D.,84,86,38,48,Norrie C.,13,287,172,115,2021-09-28,San Diego,San Diego Open,Hard,2.5,1.53,0
Sonego L.,43,221,107,114,Basilashvili N.,118,301,138,163,2021-09-28,San Diego,San Diego Open,Hard,1.8,2.0,1
Fritz T.,9,356,205,151,Caruso S.,146,63,19,44,2021-09-28,San Diego,San Diego Open,Hard,1.14,5.5,1
Nakashima B.,70,106,57,49,Fognini F.,128,742,383,359,2021-09-28,San Diego,San Diego Open,Hard,1.53,2.5,1
Ruusuvuori E.,55,158,79,79,Duckworth J.,123,143,55,88,2021-09-29,Sofia,Sofia Open,Hard,1.53,2.5,0
Andujar P.,323,404,164,240,Ivashka I.,113,159,78,81,2021-09-29,Sofia,Sofia Open,Hard,5.5,1.14,0
Marchenko I.,164,131,50,81,Seppi A.,141,758,363,395,2021-09-29,Sofia,Sofia Open,Hard,2.1,1.72,1
Majchrzak K.,121,50,19,31,Kuzmanov D.,207,12,4,8,2021-09-29,Sofia,Sofia Open,Hard,1.3,3.5,1
Mager G.,67,59,24,35,Kecmanovic M.,40,210,107,103,2021-09-29,Sofia,Sofia Open,Hard,2.75,1.44,1
Harris L.,186,129,59,70,Eubanks C.,29,64,28,36,2021-09-29,San Diego,San Diego Open,Hard,1.22,4.33,1
Murray A.,44,932,687,245,Kudla D.,137,198,70,128,2021-09-29,San Diego,San Diego Open,Hard,1.36,3.2,1
Gaio F.,174,18,3,15,Schwartzman D.,95,428,233,195,2021-09-29,San Diego,San Diego Open,Hard,5.0,1.16,0
Anderson K.,652,598,347,251,Evans D.,30,251,124,127,2021-09-29,San Diego,San Diego Open,Hard,1.9,1.9,0
Hurkacz H.,17,238,137,101,Bolt A.,345,40,13,27,2021-09-29,San Diego,San Diego Open,Hard,1.22,4.33,1
Lazarov A.,301,6,1,5,Krajinovic F.,93,240,115,125,2021-09-29,Sofia,Sofia Open,Hard,8.0,1.08,0
Sinner J.,8,224,153,71,Gerasimov E.,150,93,43,50,2021-09-30,Sofia,Sofia Open,Hard,1.2,4.5,1
Nakashima B.,70,106,57,49,Rublev A.,7,392,255,137,2021-09-30,San Diego,San Diego Open,Hard,3.5,1.3,0
Schwartzman D.,95,428,233,195,Harris L.,186,129,59,70,2021-09-30,San Diego,San Diego Open,Hard,1.9,1.9,1
Karatsev A.,75,136,66,70,Hurkacz H.,17,238,137,101,2021-09-30,San Diego,San Diego Open,Hard,2.75,1.44,1
Shapovalov D.,29,298,166,132,Fritz T.,9,356,205,151,2021-09-30,San Diego,San Diego Open,Hard,1.61,2.3,1
Korda S.,26,126,75,51,Sonego L.,43,221,107,114,2021-09-30,San Diego,San Diego Open,Hard,1.61,2.3,0
Millman J.,140,256,113,143,Marchenko I.,164,131,50,81,2021-09-30,Sofia,Sofia Open,Hard,1.57,2.37,1
Giron M.,69,150,68,82,De Minaur A.,19,272,161,111,2021-09-30,Sofia,Sofia Open,Hard,2.37,1.57,1
Duckworth J.,123,143,55,88,Paire B.,149,527,237,290,2021-09-30,Sofia,Sofia Open,Hard,1.8,2.0,1
Djere L.,38,243,120,123,Krajinovic F.,93,240,115,125,2021-09-30,Sofia,Sofia Open,Hard,2.62,1.5,0
Ivashka I.,113,159,78,81,Monfils G.,323,816,510,306,2021-09-30,Sofia,Sofia Open,Hard,1.72,2.1,0
Evans D.,30,251,124,127,Norrie C.,13,287,172,115,2021-09-30,San Diego,San Diego Open,Hard,2.37,1.57,0
Mager G.,67,59,24,35,Monfils G.,323,816,510,306,2021-10-01,Sofia,Sofia Open,Hard,3.4,1.33,0
Millman J.,140,256,113,143,Giron M.,69,150,68,82,2021-10-01,Sofia,Sofia Open,Hard,2.37,1.57,0
Shapovalov D.,29,298,166,132,Norrie C.,13,287,172,115,2021-10-01,San Diego,San Diego Open,Hard,1.8,2.0,0
Rublev A.,7,392,255,137,Schwartzman D.,95,428,233,195,2021-10-01,San Diego,San Diego Open,Hard,1.3,3.5,1
Duckworth J.,123,143,55,88,Sinner J.,8,224,153,71,2021-10-01,Sofia,Sofia Open,Hard,3.5,1.3,0
Dimitrov G.,20,651,389,262,Holmgren A.,901,1,0,1,2021-10-01,San Diego,San Diego Open,Hard,1.1,7.0,1
Murray A.,44,932,687,245,Ruud C.,4,275,176,99,2021-10-01,San Diego,San Diego Open,Hard,2.1,1.72,0
Majchrzak K.,121,50,19,31,Krajinovic F.,93,240,115,125,2021-10-01,Sofia,Sofia Open,Hard,2.62,1.5,0
Krajinovic F.,93,240,115,125,Sinner J.,8,224,153,71,2021-10-02,Sofia,Sofia Open,Hard,3.0,1.4,0
Rublev A.,7,392,255,137,Norrie C.,13,287,172,115,2021-10-02,San Diego,San Diego Open,Hard,1.33,3.4,0
Karatsev A.,75,136,66,70,Dimitrov G.,20,651,389,262,2021-10-02,San Diego,San Diego Open,Hard,1.66,2.2,0
Sonego L.,43,221,107,114,Ruud C.,4,275,176,99,2021-10-02,San Diego,San Diego Open,Hard,2.5,1.53,0
Giron M.,69,150,68,82,Monfils G.,323,816,510,306,2021-10-02,Sofia,Sofia Open,Hard,2.75,1.44,0
Sinner J.,8,224,153,71,Monfils G.,323,816,510,306,2021-10-03,Sofia,Sofia Open,Hard,1.57,2.37,1
Dimitrov G.,20,651,389,262,Ruud C.,4,275,176,99,2021-10-03,San Diego,San Diego Open,Hard,2.75,1.44,0
Ruud C.,4,275,176,99,Norrie C.,13,287,172,115,2021-10-04,San Diego,San Diego Open,Hard,1.9,1.9,1
Nishikori K.,439,617,408,209,Sousa J.,147,436,189,247,2021-10-07,Indian Wells,BNP Paribas Open,Hard,1.14,5.5,1
Djere L.,38,243,120,123,Cressy M.,96,96,42,54,2021-10-07,Indian Wells,BNP Paribas Open,Hard,1.9,1.9,0
Van De Zandschulp B.,44,117,63,54,Giron M.,69,150,68,82,2021-10-07,Indian Wells,BNP Paribas Open,Hard,1.8,2.0,0
Kwon S.W.,68,108,53,55,Pella G.,199,260,118,142,2021-10-07,Indian Wells,BNP Paribas Open,Hard,1.5,2.62,0
Mcdonald M.,60,190,87,103,Duckworth J.,123,143,55,88,2021-10-07,Indian Wells,BNP Paribas Open,Hard,1.9,1.9,1
Monteiro T.,121,171,69,102,Sandgren T.,153,121,47,74,2021-10-07,Indian Wells,BNP Paribas Open,Hard,2.0,1.8,0
Kohlschreiber P.,132,812,446,366,Daniel T.,111,178,67,111,2021-10-07,Indian Wells,BNP Paribas Open,Hard,1.36,3.2,0
Taberner C.,181,37,13,24,Munar J.,104,178,75,103,2021-10-07,Indian Wells,BNP Paribas Open,Hard,2.2,1.66,1
Altmaier D.,51,79,28,51,Querrey S.,287,678,369,309,2021-10-07,Indian Wells,BNP Paribas Open,Hard,2.2,1.66,1
Popyrin A.,90,140,59,81,Kecmanovic M.,40,210,107,103,2021-10-07,Indian Wells,BNP Paribas Open,Hard,1.8,2.0,1
Paul T.,14,204,111,93,Lopez F.,634,863,441,422,2021-10-07,Indian Wells,BNP Paribas Open,Hard,1.25,4.0,1
Rune H.,6,131,83,48,Escobedo E.,377,57,20,37,2021-10-08,Indian Wells,BNP Paribas Open,Hard,1.44,2.75,0
Bagnis F.,135,121,39,82,Gomez E.,155,26,7,19,2021-10-08,Indian Wells,BNP Paribas Open,Hard,2.3,1.61,0
Ilkel C.,382,17,1,16,Brooksby J.,39,79,46,33,2021-10-08,Indian Wells,BNP Paribas Open,Hard,5.5,1.14,0
Ramos-Vinolas A.,82,437,204,233,Musetti L.,18,143,79,64,2021-10-08,Indian Wells,BNP Paribas Open,Hard,2.0,1.8,1
Galan D.E.,76,78,33,45,Struff J.L.,21,369,170,199,2021-10-08,Indian Wells,BNP Paribas Open,Hard,3.0,1.4,0
Thompson J.,71,221,96,125,Anderson K.,652,598,347,251,2021-10-08,Indian Wells,BNP Paribas Open,Hard,2.37,1.57,0
Tabilo A.,122,44,21,23,Kudla D.,137,198,70,128,2021-10-08,Indian Wells,BNP Paribas Open,Hard,2.3,1.61,1
Wolf J.J.,45,75,39,36,Pospisil V.,99,280,122,158,2021-10-08,Indian Wells,BNP Paribas Open,Hard,2.1,1.72,0
Koepfer D.,84,86,38,48,Ruusuvuori E.,55,158,79,79,2021-10-08,Indian Wells,BNP Paribas Open,Hard,2.75,1.44,0
Johnson S.,197,395,196,199,Davidovich Fokina A.,39,168,84,84,2021-10-08,Indian Wells,BNP Paribas Open,Hard,2.2,1.66,0
Paire B.,149,527,237,290,Tiafoe F.,10,303,158,145,2021-10-08,Indian Wells,BNP Paribas Open,Hard,3.4,1.33,0
Olivo R.,179,55,23,32,Carballes Baena R.,64,207,91,116,2021-10-08,Indian Wells,BNP Paribas Open,Hard,3.2,1.36,0
Caruso S.,146,63,19,44,Svajda Z.,233,8,2,6,2021-10-08,Indian Wells,BNP Paribas Open,Hard,1.8,2.0,1
Nishioka Y.,31,215,99,116,Delbonis F.,131,340,152,188,2021-10-08,Indian Wells,BNP Paribas Open,Hard,1.61,2.3,1
Evans D.,30,251,124,127,Nishikori K.,439,617,408,209,2021-10-09,Indian Wells,BNP Paribas Open,Hard,2.2,1.66,1
Pospisil V.,99,280,122,158,Shapovalov D.,29,298,166,132,2021-10-09,Indian Wells,BNP Paribas Open,Hard,3.4,1.33,0
Sandgren T.,153,121,47,74,Norrie C.,13,287,172,115,2021-10-09,Indian Wells,BNP Paribas Open,Hard,5.0,1.16,0
Ruud C.,4,275,176,99,Carballes Baena R.,64,207,91,116,2021-10-09,Indian Wells,BNP Paribas Open,Hard,1.08,8.0,1
Tiafoe F.,10,303,158,145,Korda S.,26,126,75,51,2021-10-09,Indian Wells,BNP Paribas Open,Hard,2.1,1.72,1
Pella G.,199,260,118,142,Bautista Agut R.,25,379,234,145,2021-10-09,Indian Wells,BNP Paribas Open,Hard,4.0,1.25,0
Dimitrov G.,20,651,389,262,Altmaier D.,51,79,28,51,2021-10-09,Indian Wells,BNP Paribas Open,Hard,1.33,3.4,1
Cressy M.,96,96,42,54,Schwartzman D.,95,428,233,195,2021-10-09,Indian Wells,BNP Paribas Open,Hard,3.5,1.3,0
Murray A.,44,932,687,245,Mannarino A.,27,567,264,303,2021-10-09,Indian Wells,BNP Paribas Open,Hard,1.2,4.5,1
Daniel T.,111,178,67,111,Opelka R.,17,168,88,80,2021-10-09,Indian Wells,BNP Paribas Open,Hard,3.75,1.28,0
Gerasimov E.,150,93,43,50,Eubanks C.,29,64,28,36,2021-10-09,Indian Wells,BNP Paribas Open,Hard,2.0,1.8,0
Fucsovics M.,67,249,121,128,Mager G.,67,59,24,35,2021-10-09,Indian Wells,BNP Paribas Open,Hard,1.36,3.2,0
Millman J.,140,256,113,143,Sock J.,166,324,177,147,2021-10-09,Indian Wells,BNP Paribas Open,Hard,1.8,2.0,1
Marcora R.,208,7,3,4,Martinez P.,135,118,50,68,2021-10-09,Indian Wells,BNP Paribas Open,Hard,3.75,1.28,0
Nakashima B.,70,106,57,49,Coria F.,108,99,43,56,2021-10-09,Indian Wells,BNP Paribas Open,Hard,1.14,5.5,1
Andujar P.,323,404,164,240,Vukic A.,62,36,15,21,2021-10-09,Indian Wells,BNP Paribas Open,Hard,2.3,1.61,0
Popyrin A.,90,140,59,81,Hurkacz H.,17,238,137,101,2021-10-09,Indian Wells,BNP Paribas Open,Hard,3.2,1.36,0
Nakashima B.,70,106,57,49,Fritz T.,9,356,205,151,2021-10-10,Indian Wells,BNP Paribas Open,Hard,1.61,2.3,0
Murray A.,44,932,687,245,Alcaraz C.,1,164,130,34,2021-10-10,Indian Wells,BNP Paribas Open,Hard,2.0,1.8,1
Escobedo E.,377,57,20,37,Garin C.,101,190,103,87,2021-10-10,Indian Wells,BNP Paribas Open,Hard,2.0,1.8,0
Zverev A.,19,500,346,154,Brooksby J.,39,79,46,33,2021-10-10,Indian Wells,BNP Paribas Open,Hard,1.2,4.5,1
Carreno Busta P.,16,352,214,138,Gomez E.,155,26,7,19,2021-10-10,Indian Wells,BNP Paribas Open,Hard,1.12,6.0,1
Fognini F.,128,742,383,359,Struff J.L.,21,369,170,199,2021-10-10,Indian Wells,BNP Paribas Open,Hard,1.8,2.0,1
Vukic A.,62,36,15,21,De Minaur A.,19,272,161,111,2021-10-10,Indian Wells,BNP Paribas Open,Hard,2.75,1.44,0
Auger-Aliassime F.,12,268,163,105,Ramos-Vinolas A.,82,437,204,233,2021-10-10,Indian Wells,BNP Paribas Open,Hard,1.2,4.5,0
Anderson K.,652,598,347,251,Sonego L.,43,221,107,114,2021-10-10,Indian Wells,BNP Paribas Open,Hard,2.0,1.8,1
Tabilo A.,122,44,21,23,Berrettini M.,38,217,142,75,2021-10-10,Indian Wells,BNP Paribas Open,Hard,7.0,1.1,0
Monfils G.,323,816,510,306,Mager G.,67,59,24,35,2021-10-10,Indian Wells,BNP Paribas Open,Hard,1.22,4.33,1
Rublev A.,7,392,255,137,Taberner C.,181,37,13,24,2021-10-10,Indian Wells,BNP Paribas Open,Hard,1.07,9.0,1
Giron M.,69,150,68,82,Krajinovic F.,93,240,115,125,2021-10-10,Indian Wells,BNP Paribas Open,Hard,1.9,1.9,0
Davidovich Fokina A.,39,168,84,84,Harris L.,186,129,59,70,2021-10-10,Indian Wells,BNP Paribas Open,Hard,2.75,1.44,0
Caruso S.,146,63,19,44,Karatsev A.,75,136,66,70,2021-10-10,Indian Wells,BNP Paribas Open,Hard,3.75,1.28,0
Paul T.,14,204,111,93,Lajovic D.,66,378,163,215,2021-10-10,Indian Wells,BNP Paribas Open,Hard,1.57,2.37,1
Mcdonald M.,60,190,87,103,Medvedev D.,3,406,289,117,2021-10-10,Indian Wells,BNP Paribas Open,Hard,10.0,1.06,0
Sinner J.,8,224,153,71,Millman J.,140,256,113,143,2021-10-10,Indian Wells,BNP Paribas Open,Hard,1.2,4.5,1
Ruud C.,4,275,176,99,Harris L.,186,129,59,70,2021-10-11,Indian Wells,BNP Paribas Open,Hard,1.36,3.2,1
Shapovalov D.,29,298,166,132,Karatsev A.,75,136,66,70,2021-10-11,Indian Wells,BNP Paribas Open,Hard,1.66,2.2,0
Opelka R.,17,168,88,80,Dimitrov G.,20,651,389,262,2021-10-11,Indian Wells,BNP Paribas Open,Hard,1.8,2.0,0
Evans D.,30,251,124,127,Schwartzman D.,95,428,233,195,2021-10-11,Indian Wells,BNP Paribas Open,Hard,2.37,1.57,0
Tsitsipas S.,5,390,264,126,Martinez P.,135,118,50,68,2021-10-11,Indian Wells,BNP Paribas Open,Hard,1.08,8.0,1
Basilashvili N.,118,301,138,163,Eubanks C.,29,64,28,36,2021-10-11,Indian Wells,BNP Paribas Open,Hard,1.57,2.37,1
Isner J.,114,755,465,290,Nishioka Y.,31,215,99,116,2021-10-11,Indian Wells,BNP Paribas Open,Hard,1.3,3.5,1
Khachanov K.,11,378,217,161,Ruusuvuori E.,55,158,79,79,2021-10-11,Indian Wells,BNP Paribas Open,Hard,1.61,2.3,1
Hurkacz H.,17,238,137,101,Tiafoe F.,10,303,158,145,2021-10-12,Indian Wells,BNP Paribas Open,Hard,1.53,2.5,1
Paul T.,14,204,111,93,Rublev A.,7,392,255,137,2021-10-12,Indian Wells,BNP Paribas Open,Hard,4.5,1.2,1
Norrie C.,13,287,172,115,Bautista Agut R.,25,379,234,145,2021-10-12,Indian Wells,BNP Paribas Open,Hard,1.8,2.0,1
Krajinovic F.,93,240,115,125,Medvedev D.,3,406,289,117,2021-10-12,Indian Wells,BNP Paribas Open,Hard,8.0,1.08,0
Sinner J.,8,224,153,71,Isner J.,114,755,465,290,2021-10-12,Indian Wells,BNP Paribas Open,Hard,1.5,2.62,1
Berrettini M.,38,217,142,75,Fritz T.,9,356,205,151,2021-10-12,Indian Wells,BNP Paribas Open,Hard,1.4,3.0,0
Khachanov K.,11,378,217,161,Carreno Busta P.,16,352,214,138,2021-10-12,Indian Wells,BNP Paribas Open,Hard,2.1,1.72,1
Ramos-Vinolas A.,82,437,204,233,Basilashvili N.,118,301,138,163,2021-10-12,Indian Wells,BNP Paribas Open,Hard,2.2,1.66,0
Zverev A.,19,500,346,154,Murray A.,44,932,687,245,2021-10-12,Indian Wells,BNP Paribas Open,Hard,1.16,5.0,1
Khachanov K.,11,378,217,161,Basilashvili N.,118,301,138,163,2021-10-13,Indian Wells,BNP Paribas Open,Hard,1.33,3.4,0
Dimitrov G.,20,651,389,262,Medvedev D.,3,406,289,117,2021-10-13,Indian Wells,BNP Paribas Open,Hard,6.0,1.12,1
Norrie C.,13,287,172,115,Paul T.,14,204,111,93,2021-10-13,Indian Wells,BNP Paribas Open,Hard,1.5,2.62,1
Karatsev A.,75,136,66,70,Hurkacz H.,17,238,137,101,2021-10-13,Indian Wells,BNP Paribas Open,Hard,2.37,1.57,0
Sinner J.,8,224,153,71,Fritz T.,9,356,205,151,2021-10-13,Indian Wells,BNP Paribas Open,Hard,1.44,2.75,0
De Minaur A.,19,272,161,111,Garin C.,101,190,103,87,2021-10-13,Indian Wells,BNP Paribas Open,Hard,1.66,2.2,1
Tsitsipas S.,5,390,264,126,Fognini F.,128,742,383,359,2021-10-13,Indian Wells,BNP Paribas Open,Hard,1.14,5.5,1
Monfils G.,323,816,510,306,Anderson K.,652,598,347,251,2021-10-13,Indian Wells,BNP Paribas Open,Hard,1.4,3.0,1
Ruud C.,4,275,176,99,Schwartzman D.,95,428,233,195,2021-10-13,Indian Wells,BNP Paribas Open,Hard,1.4,3.0,0
Tsitsipas S.,5,390,264,126,De Minaur A.,19,272,161,111,2021-10-14,Indian Wells,BNP Paribas Open,Hard,1.2,4.5,1
Monfils G.,323,816,510,306,Zverev A.,19,500,346,154,2021-10-14,Indian Wells,BNP Paribas Open,Hard,4.5,1.2,0
Schwartzman D.,95,428,233,195,Norrie C.,13,287,172,115,2021-10-14,Indian Wells,BNP Paribas Open,Hard,1.72,2.1,0
Hurkacz H.,17,238,137,101,Dimitrov G.,20,651,389,262,2021-10-14,Indian Wells,BNP Paribas Open,Hard,1.57,2.37,0
Tsitsipas S.,5,390,264,126,Basilashvili N.,118,301,138,163,2021-10-15,Indian Wells,BNP Paribas Open,Hard,1.28,3.75,0
Fritz T.,9,356,205,151,Zverev A.,19,500,346,154,2021-10-15,Indian Wells,BNP Paribas Open,Hard,5.0,1.16,1
Dimitrov G.,20,651,389,262,Norrie C.,13,287,172,115,2021-10-16,Indian Wells,BNP Paribas Open,Hard,1.9,1.9,0
Basilashvili N.,118,301,138,163,Fritz T.,9,356,205,151,2021-10-16,Indian Wells,BNP Paribas Open,Hard,2.3,1.61,1
Duckworth J.,123,143,55,88,Gojo B.,115,14,3,11,2021-10-18,Moscow,Kremlin Cup,Hard,1.36,3.2,1
Popyrin A.,90,140,59,81,Van De Zandschulp B.,44,117,63,54,2021-10-18,Antwerp,European Open,Hard,2.1,1.72,0
Norrie C.,13,287,172,115,Basilashvili N.,118,301,138,163,2021-10-18,Indian Wells,BNP Paribas Open,Hard,1.57,2.37,1
Rinderknech A.,67,96,46,50,Delbonis F.,131,340,152,188,2021-10-18,Antwerp,European Open,Hard,1.33,3.4,1
Cilic M.,100,853,543,310,Dzumhur D.,202,234,107,127,2021-10-18,Moscow,Kremlin Cup,Hard,1.44,2.75,1
Gasquet R.,48,948,581,367,Lajovic D.,66,378,163,215,2021-10-18,Antwerp,European Open,Hard,1.53,2.5,0
Bonzi B.,107,83,37,46,Millman J.,140,256,113,143,2021-10-18,Moscow,Kremlin Cup,Hard,1.8,2.0,0
Djere L.,38,243,120,123,Simon G.,188,869,491,378,2021-10-19,Moscow,Kremlin Cup,Hard,1.5,2.62,0
Gerasimov E.,150,93,43,50,Kecmanovic M.,40,210,107,103,2021-10-19,Moscow,Kremlin Cup,Hard,2.0,1.8,1
Bublik A.,25,219,110,109,Marchenko I.,164,131,50,81,2021-10-19,Moscow,Kremlin Cup,Hard,1.44,2.75,0
Martinez P.,135,118,50,68,Pella G.,199,260,118,142,2021-10-19,Moscow,Kremlin Cup,Hard,1.66,2.2,1
Berankis R.,212,249,104,145,Donskoy E.,149,162,50,112,2021-10-19,Moscow,Kremlin Cup,Hard,,,1
Mannarino A.,27,567,264,303,Safiullin R.,92,42,20,22,2021-10-19,Moscow,Kremlin Cup,Hard,1.9,1.9,1
Ymer M.,59,130,58,72,Paul T.,14,204,111,93,2021-10-19,Moscow,Kremlin Cup,Hard,2.37,1.57,0
Tiafoe F.,10,303,158,145,Murray A.,44,932,687,245,2021-10-19,Antwerp,European Open,Hard,2.1,1.72,0
Davidovich Fokina A.,39,168,84,84,Thompson J.,71,221,96,125,2021-10-19,Antwerp,European Open,Hard,1.66,2.2,1
Laaksonen H.,125,101,37,64,Paire B.,149,527,237,290,2021-10-19,Antwerp,European Open,Hard,1.61,2.3,1
Nakashima B.,70,106,57,49,De Minaur A.,19,272,161,111,2021-10-19,Antwerp,European Open,Hard,2.1,1.72,1
Brooksby J.,39,79,46,33,Opelka R.,17,168,88,80,2021-10-19,Antwerp,European Open,Hard,1.72,2.1,1
Mager G.,67,59,24,35,Musetti L.,18,143,79,64,2021-10-19,Antwerp,European Open,Hard,1.8,2.0,0
Struff J.L.,21,369,170,199,Ramos-Vinolas A.,82,437,204,233,2021-10-19,Antwerp,European Open,Hard,1.57,2.37,1
Fucsovics M.,67,249,121,128,Novak D.,166,58,15,43,2021-10-19,Antwerp,European Open,Hard,1.57,2.37,1
Bergs Z.,175,15,4,11,Harris L.,186,129,59,70,2021-10-19,Antwerp,European Open,Hard,4.33,1.22,0
Khachanov K.,11,378,217,161,Duckworth J.,123,143,55,88,2021-10-20,Moscow,Kremlin Cup,Hard,1.25,4.0,1
Paul T.,14,204,111,93,Cilic M.,100,853,543,310,2021-10-20,Moscow,Kremlin Cup,Hard,1.9,1.9,0
Millman J.,140,256,113,143,Marchenko I.,164,131,50,81,2021-10-20,Moscow,Kremlin Cup,Hard,1.66,2.2,1
Mcdonald M.,60,190,87,103,Nishioka Y.,31,215,99,116,2021-10-20,Moscow,Kremlin Cup,Hard,1.5,2.62,1
Coria F.,108,99,43,56,Kachmazov A.,638,2,0,2,2021-10-20,Moscow,Kremlin Cup,Hard,1.53,2.5,1
Brooksby J.,39,79,46,33,Van De Zandschulp B.,44,117,63,54,2021-10-20,Antwerp,European Open,Hard,1.44,2.75,1
Rinderknech A.,67,96,46,50,Lajovic D.,66,378,163,215,2021-10-20,Antwerp,European Open,Hard,1.57,2.37,1
Sinner J.,8,224,153,71,Musetti L.,18,143,79,64,2021-10-20,Antwerp,European Open,Hard,1.16,5.0,1
Garin C.,101,190,103,87,Davidovich Fokina A.,39,168,84,84,2021-10-20,Antwerp,European Open,Hard,2.62,1.5,0
Fucsovics M.,67,249,121,128,Bautista Agut R.,25,379,234,145,2021-10-21,Antwerp,European Open,Hard,2.37,1.57,1
Mcdonald M.,60,190,87,103,Simon G.,188,869,491,378,2021-10-21,Moscow,Kremlin Cup,Hard,1.25,4.0,0
Gerasimov E.,150,93,43,50,Karatsev A.,75,136,66,70,2021-10-21,Moscow,Kremlin Cup,Hard,3.0,1.4,0
Mannarino A.,27,567,264,303,Rublev A.,7,392,255,137,2021-10-21,Moscow,Kremlin Cup,Hard,8.0,1.08,1
Coria F.,108,99,43,56,Berankis R.,212,249,104,145,2021-10-21,Moscow,Kremlin Cup,Hard,4.33,1.22,0
Martinez P.,135,118,50,68,Krajinovic F.,93,240,115,125,2021-10-21,Moscow,Kremlin Cup,Hard,3.0,1.4,1
Laaksonen H.,125,101,37,64,Nakashima B.,70,106,57,49,2021-10-21,Antwerp,European Open,Hard,2.5,1.53,0
Schwartzman D.,95,428,233,195,Murray A.,44,932,687,245,2021-10-21,Antwerp,European Open,Hard,2.1,1.72,1
Struff J.L.,21,369,170,199,Harris L.,186,129,59,70,2021-10-21,Antwerp,European Open,Hard,3.0,1.4,0
Martinez P.,135,118,50,68,Cilic M.,100,853,543,310,2021-10-22,Moscow,Kremlin Cup,Hard,2.62,1.5,0
Khachanov K.,11,378,217,161,Millman J.,140,256,113,143,2021-10-22,Moscow,Kremlin Cup,Hard,1.3,3.5,1
Harris L.,186,129,59,70,Fucsovics M.,67,249,121,128,2021-10-22,Antwerp,European Open,Hard,1.57,2.37,1
Rinderknech A.,67,96,46,50,Sinner J.,8,224,153,71,2021-10-22,Antwerp,European Open,Hard,4.33,1.22,0
Nakashima B.,70,106,57,49,Schwartzman D.,95,428,233,195,2021-10-22,Antwerp,European Open,Hard,2.2,1.66,0
Brooksby J.,39,79,46,33,Davidovich Fokina A.,39,168,84,84,2021-10-22,Antwerp,European Open,Hard,1.33,3.4,1
Mannarino A.,27,567,264,303,Berankis R.,212,249,104,145,2021-10-22,Moscow,Kremlin Cup,Hard,1.66,2.2,0
Karatsev A.,75,136,66,70,Simon G.,188,869,491,378,2021-10-22,Moscow,Kremlin Cup,Hard,1.22,4.33,1
Cilic M.,100,853,543,310,Berankis R.,212,249,104,145,2021-10-23,Moscow,Kremlin Cup,Hard,1.44,2.75,1
Karatsev A.,75,136,66,70,Khachanov K.,11,378,217,161,2021-10-23,Moscow,Kremlin Cup,Hard,2.0,1.8,1
Brooksby J.,39,79,46,33,Schwartzman D.,95,428,233,195,2021-10-23,Antwerp,European Open,Hard,1.66,2.2,0
Sinner J.,8,224,153,71,Harris L.,186,129,59,70,2021-10-23,Antwerp,European Open,Hard,1.5,2.62,1
Schwartzman D.,95,428,233,195,Sinner J.,8,224,153,71,2021-10-24,Antwerp,European Open,Hard,2.75,1.44,0
Karatsev A.,75,136,66,70,Cilic M.,100,853,543,310,2021-10-24,Moscow,Kremlin Cup,Hard,1.66,2.2,1
Duckworth J.,123,143,55,88,Struff J.L.,21,369,170,199,2021-10-25,St. Petersburg,St. Petersburg Open,Hard,1.8,2.0,0
Serdarusic N.,702,9,1,8,Korda S.,26,126,75,51,2021-10-25,St. Petersburg,St. Petersburg Open,Hard,5.5,1.14,0
Tiurnev E.,304,1,0,1,Bublik A.,25,219,110,109,2021-10-25,St. Petersburg,St. Petersburg Open,Hard,5.0,1.16,0
Evans D.,30,251,124,127,Alcaraz C.,1,164,130,34,2021-10-25,Vienna,Vienna Open,Hard,2.2,1.66,0
Basilashvili N.,118,301,138,163,Carreno Busta P.,16,352,214,138,2021-10-25,Vienna,Vienna Open,Hard,2.5,1.53,1
De Minaur A.,19,272,161,111,Anderson K.,652,598,347,251,2021-10-25,Vienna,Vienna Open,Hard,2.0,1.8,1
Murray A.,44,932,687,245,Hurkacz H.,17,238,137,101,2021-10-25,Vienna,Vienna Open,Hard,2.5,1.53,1
Popyrin A.,90,140,59,81,Berrettini M.,38,217,142,75,2021-10-25,Vienna,Vienna Open,Hard,3.75,1.28,0
Tsitsipas S.,5,390,264,126,Dimitrov G.,20,651,389,262,2021-10-26,Vienna,Vienna Open,Hard,1.4,3.0,1
Harris L.,186,129,59,70,Ruud C.,4,275,176,99,2021-10-26,Vienna,Vienna Open,Hard,2.1,1.72,0
Norrie C.,13,287,172,115,Fucsovics M.,67,249,121,128,2021-10-26,Vienna,Vienna Open,Hard,1.5,2.62,1
Tiafoe F.,10,303,158,145,Lajovic D.,66,378,163,215,2021-10-26,Vienna,Vienna Open,Hard,1.4,3.0,1
Berankis R.,212,249,104,145,Auger-Aliassime F.,12,268,163,105,2021-10-26,Vienna,Vienna Open,Hard,3.5,1.3,0
Zverev A.,19,500,346,154,Krajinovic F.,93,240,115,125,2021-10-26,Vienna,Vienna Open,Hard,1.14,5.5,1
Mager G.,67,59,24,35,Novak D.,166,58,15,43,2021-10-26,Vienna,Vienna Open,Hard,2.3,1.61,0
Oliel Y.,383,2,0,2,Millman J.,140,256,113,143,2021-10-26,St. Petersburg,St. Petersburg Open,Hard,6.0,1.12,0
Martinez P.,135,118,50,68,Paul T.,14,204,111,93,2021-10-26,St. Petersburg,St. Petersburg Open,Hard,2.62,1.5,0
Fritz T.,9,356,205,151,Ruusuvuori E.,55,158,79,79,2021-10-26,St. Petersburg,St. Petersburg Open,Hard,1.8,2.0,1
Djere L.,38,243,120,123,Ivashka I.,113,159,78,81,2021-10-26,St. Petersburg,St. Petersburg Open,Hard,4.0,1.25,0
Andujar P.,323,404,164,240,Delbonis F.,131,340,152,188,2021-10-26,St. Petersburg,St. Petersburg Open,Hard,2.1,1.72,1
Van De Zandschulp B.,44,117,63,54,Nishioka Y.,31,215,99,116,2021-10-26,St. Petersburg,St. Petersburg Open,Hard,1.57,2.37,1
Gerasimov E.,150,93,43,50,Mcdonald M.,60,190,87,103,2021-10-26,St. Petersburg,St. Petersburg Open,Hard,2.37,1.57,0
Cilic M.,100,853,543,310,Ramos-Vinolas A.,82,437,204,233,2021-10-27,St. Petersburg,St. Petersburg Open,Hard,1.3,3.5,1
Mannarino A.,27,567,264,303,Khachanov K.,11,378,217,161,2021-10-27,St. Petersburg,St. Petersburg Open,Hard,3.75,1.28,0
Shapovalov D.,29,298,166,132,Andujar P.,323,404,164,240,2021-10-27,St. Petersburg,St. Petersburg Open,Hard,1.08,8.0,1
Struff J.L.,21,369,170,199,Bublik A.,25,219,110,109,2021-10-27,St. Petersburg,St. Petersburg Open,Hard,1.8,2.0,1
Koepfer D.,84,86,38,48,Sonego L.,43,221,107,114,2021-10-27,Vienna,Vienna Open,Hard,2.75,1.44,0
Fognini F.,128,742,383,359,Schwartzman D.,95,428,233,195,2021-10-27,Vienna,Vienna Open,Hard,3.4,1.33,0
Murray A.,44,932,687,245,Alcaraz C.,1,164,130,34,2021-10-27,Vienna,Vienna Open,Hard,1.61,2.3,0
Berrettini M.,38,217,142,75,Basilashvili N.,118,301,138,163,2021-10-27,Vienna,Vienna Open,Hard,1.44,2.75,1
Ivashka I.,113,159,78,81,Rublev A.,7,392,255,137,2021-10-27,St. Petersburg,St. Petersburg Open,Hard,3.4,1.33,0
Sinner J.,8,224,153,71,Opelka R.,17,168,88,80,2021-10-27,Vienna,Vienna Open,Hard,1.28,3.75,1
Monfils G.,323,816,510,306,Musetti L.,18,143,79,64,2021-10-27,Vienna,Vienna Open,Hard,1.25,4.0,1
De Minaur A.,19,272,161,111,Zverev A.,19,500,346,154,2021-10-28,Vienna,Vienna Open,Hard,5.0,1.16,0
Tsitsipas S.,5,390,264,126,Tiafoe F.,10,303,158,145,2021-10-28,Vienna,Vienna Open,Hard,1.25,4.0,0
Monfils G.,323,816,510,306,Schwartzman D.,95,428,233,195,2021-10-28,Vienna,Vienna Open,Hard,2.0,1.8,0
Sinner J.,8,224,153,71,Novak D.,166,58,15,43,2021-10-28,Vienna,Vienna Open,Hard,1.08,8.0,1
Auger-Aliassime F.,12,268,163,105,Norrie C.,13,287,172,115,2021-10-28,Vienna,Vienna Open,Hard,2.2,1.66,1
Ruud C.,4,275,176,99,Sonego L.,43,221,107,114,2021-10-28,Vienna,Vienna Open,Hard,1.36,3.2,1
Bautista Agut R.,25,379,234,145,Mcdonald M.,60,190,87,103,2021-10-28,St. Petersburg,St. Petersburg Open,Hard,1.57,2.37,1
Millman J.,140,256,113,143,Karatsev A.,75,136,66,70,2021-10-28,St. Petersburg,St. Petersburg Open,Hard,4.0,1.25,1
Cilic M.,100,853,543,310,Khachanov K.,11,378,217,161,2021-10-28,St. Petersburg,St. Petersburg Open,Hard,2.37,1.57,1
Paul T.,14,204,111,93,Fritz T.,9,356,205,151,2021-10-28,St. Petersburg,St. Petersburg Open,Hard,2.5,1.53,0
Korda S.,26,126,75,51,Van De Zandschulp B.,44,117,63,54,2021-10-28,St. Petersburg,St. Petersburg Open,Hard,1.8,2.0,0
Ruud C.,4,275,176,99,Sinner J.,8,224,153,71,2021-10-29,Vienna,Vienna Open,Hard,3.0,1.4,0
Van De Zandschulp B.,44,117,63,54,Rublev A.,7,392,255,137,2021-10-29,St. Petersburg,St. Petersburg Open,Hard,4.0,1.25,1
Cilic M.,100,853,543,310,Bautista Agut R.,25,379,234,145,2021-10-29,St. Petersburg,St. Petersburg Open,Hard,2.0,1.8,1
Shapovalov D.,29,298,166,132,Struff J.L.,21,369,170,199,2021-10-29,St. Petersburg,St. Petersburg Open,Hard,1.5,2.62,0
Fritz T.,9,356,205,151,Millman J.,140,256,113,143,2021-10-29,St. Petersburg,St. Petersburg Open,Hard,1.36,3.2,1
Tiafoe F.,10,303,158,145,Schwartzman D.,95,428,233,195,2021-10-29,Vienna,Vienna Open,Hard,2.2,1.66,1
Auger-Aliassime F.,12,268,163,105,Zverev A.,19,500,346,154,2021-10-29,Vienna,Vienna Open,Hard,4.0,1.25,0
Alcaraz C.,1,164,130,34,Berrettini M.,38,217,142,75,2021-10-29,Vienna,Vienna Open,Hard,2.75,1.44,1
Van De Zandschulp B.,44,117,63,54,Cilic M.,100,853,543,310,2021-10-30,St. Petersburg,St. Petersburg Open,Hard,1.9,1.9,0
Alcaraz C.,1,164,130,34,Zverev A.,19,500,346,154,2021-10-30,Vienna,Vienna Open,Hard,3.75,1.28,0
Fritz T.,9,356,205,151,Struff J.L.,21,369,170,199,2021-10-30,St. Petersburg,St. Petersburg Open,Hard,1.44,2.75,1
Sinner J.,8,224,153,71,Tiafoe F.,10,303,158,145,2021-10-30,Vienna,Vienna Open,Hard,1.25,4.0,0
Zverev A.,19,500,346,154,Tiafoe F.,10,303,158,145,2021-10-31,Vienna,Vienna Open,Hard,1.2,4.5,1
Cilic M.,100,853,543,310,Fritz T.,9,356,205,151,2021-10-31,St. Petersburg,St. Petersburg Open,Hard,2.0,1.8,1
Ivashka I.,113,159,78,81,Ramos-Vinolas A.,82,437,204,233,2021-11-01,Paris,BNP Paribas Masters,Hard,1.25,4.0,1
Paire B.,149,527,237,290,Carreno Busta P.,16,352,214,138,2021-11-01,Paris,BNP Paribas Masters,Hard,4.0,1.25,0
Djere L.,38,243,120,123,Musetti L.,18,143,79,64,2021-11-01,Paris,BNP Paribas Masters,Hard,2.3,1.61,0
Rinderknech A.,67,96,46,50,Gaston H.,109,58,24,34,2021-11-01,Paris,BNP Paribas Masters,Hard,1.61,2.3,0
Mannarino A.,27,567,264,303,Basilashvili N.,118,301,138,163,2021-11-01,Paris,BNP Paribas Masters,Hard,2.75,1.44,1
Koepfer D.,84,86,38,48,Murray A.,44,932,687,245,2021-11-01,Paris,BNP Paribas Masters,Hard,4.0,1.25,1
Norrie C.,13,287,172,115,Delbonis F.,131,340,152,188,2021-11-01,Paris,BNP Paribas Masters,Hard,1.08,8.0,1
Karatsev A.,75,136,66,70,Korda S.,26,126,75,51,2021-11-01,Paris,BNP Paribas Masters,Hard,1.57,2.37,0
Fucsovics M.,67,249,121,128,Fognini F.,128,742,383,359,2021-11-01,Paris,BNP Paribas Masters,Hard,1.57,2.37,1
Mcdonald M.,60,190,87,103,Lajovic D.,66,378,163,215,2021-11-01,Paris,BNP Paribas Masters,Hard,1.44,2.75,0
Bublik A.,25,219,110,109,Evans D.,30,251,124,127,2021-11-01,Paris,BNP Paribas Masters,Hard,2.2,1.66,1
Gasquet R.,48,948,581,367,Dimitrov G.,20,651,389,262,2021-11-02,Paris,BNP Paribas Masters,Hard,3.75,1.28,0
Bublik A.,25,219,110,109,Ruud C.,4,275,176,99,2021-11-02,Paris,BNP Paribas Masters,Hard,3.5,1.3,0
Fucsovics M.,67,249,121,128,Djokovic N.,2,1207,1012,195,2021-11-02,Paris,BNP Paribas Masters,Hard,8.0,1.08,0
Tiafoe F.,10,303,158,145,Giron M.,69,150,68,82,2021-11-02,Paris,BNP Paribas Masters,Hard,1.5,2.62,0
Cilic M.,100,853,543,310,Davidovich Fokina A.,39,168,84,84,2021-11-02,Paris,BNP Paribas Masters,Hard,1.53,2.5,1
Kecmanovic M.,40,210,107,103,Monfils G.,323,816,510,306,2021-11-02,Paris,BNP Paribas Masters,Hard,3.4,1.33,0
De Minaur A.,19,272,161,111,Popyrin A.,90,140,59,81,2021-11-02,Paris,BNP Paribas Masters,Hard,,,0
Alcaraz C.,1,164,130,34,Herbert P.H.,157,202,89,113,2021-11-02,Paris,BNP Paribas Masters,Hard,1.25,4.0,1
Sonego L.,43,221,107,114,Fritz T.,9,356,205,151,2021-11-02,Paris,BNP Paribas Masters,Hard,2.3,1.61,0
Khachanov K.,11,378,217,161,Ymer M.,59,130,58,72,2021-11-02,Paris,BNP Paribas Masters,Hard,1.28,3.75,1
Opelka R.,17,168,88,80,Krajinovic F.,93,240,115,125,2021-11-02,Paris,BNP Paribas Masters,Hard,1.9,1.9,1
Duckworth J.,123,143,55,88,Bautista Agut R.,25,379,234,145,2021-11-02,Paris,BNP Paribas Masters,Hard,3.5,1.3,1
Paul T.,14,204,111,93,Struff J.L.,21,369,170,199,2021-11-02,Paris,BNP Paribas Masters,Hard,1.72,2.1,1
Auger-Aliassime F.,12,268,163,105,Mager G.,67,59,24,35,2021-11-02,Paris,BNP Paribas Masters,Hard,1.14,5.5,1
Schwartzman D.,95,428,233,195,Millman J.,140,256,113,143,2021-11-02,Paris,BNP Paribas Masters,Hard,1.28,3.75,1
Popyrin A.,90,140,59,81,Tsitsipas S.,5,390,264,126,2021-11-03,Paris,BNP Paribas Masters,Hard,,,1
Ivashka I.,113,159,78,81,Medvedev D.,3,406,289,117,2021-11-03,Paris,BNP Paribas Masters,Hard,6.0,1.12,0
Korda S.,26,126,75,51,Cilic M.,100,853,543,310,2021-11-03,Paris,BNP Paribas Masters,Hard,,,1
Lajovic D.,66,378,163,215,Zverev A.,19,500,346,154,2021-11-03,Paris,BNP Paribas Masters,Hard,8.0,1.08,0
Giron M.,69,150,68,82,Schwartzman D.,95,428,233,195,2021-11-03,Paris,BNP Paribas Masters,Hard,,,1
Alcaraz C.,1,164,130,34,Sinner J.,8,224,153,71,2021-11-03,Paris,BNP Paribas Masters,Hard,,,1
Monfils G.,323,816,510,306,Mannarino A.,27,567,264,303,2021-11-03,Paris,BNP Paribas Masters,Hard,,,1
Dimitrov G.,20,651,389,262,Khachanov K.,11,378,217,161,2021-11-03,Paris,BNP Paribas Masters,Hard,,,1
Paul T.,14,204,111,93,Hurkacz H.,17,238,137,101,2021-11-03,Paris,BNP Paribas Masters,Hard,,,0
Norrie C.,13,287,172,115,Opelka R.,17,168,88,80,2021-11-03,Paris,BNP Paribas Masters,Hard,,,1
Fritz T.,9,356,205,151,Rublev A.,7,392,255,137,2021-11-03,Paris,BNP Paribas Masters,Hard,,,1
Gaston H.,109,58,24,34,Carreno Busta P.,16,352,214,138,2021-11-03,Paris,BNP Paribas Masters,Hard,4.0,1.25,1
Koepfer D.,84,86,38,48,Auger-Aliassime F.,12,268,163,105,2021-11-03,Paris,BNP Paribas Masters,Hard,,,1
Duckworth J.,123,143,55,88,Musetti L.,18,143,79,64,2021-11-03,Paris,BNP Paribas Masters,Hard,,,1
Alcaraz C.,1,164,130,34,Gaston H.,109,58,24,34,2021-11-04,Paris,BNP Paribas Masters,Hard,1.16,5.0,0
Medvedev D.,3,406,289,117,Korda S.,26,126,75,51,2021-11-04,Paris,BNP Paribas Masters,Hard,1.16,5.0,1
Ruud C.,4,275,176,99,Giron M.,69,150,68,82,2021-11-04,Paris,BNP Paribas Masters,Hard,1.33,3.4,1
Zverev A.,19,500,346,154,Dimitrov G.,20,651,389,262,2021-11-04,Paris,BNP Paribas Masters,Hard,1.33,3.4,1
Fritz T.,9,356,205,151,Norrie C.,13,287,172,115,2021-11-04,Paris,BNP Paribas Masters,Hard,2.5,1.53,1
Popyrin A.,90,140,59,81,Duckworth J.,123,143,55,88,2021-11-04,Paris,BNP Paribas Masters,Hard,1.57,2.37,0
Koepfer D.,84,86,38,48,Hurkacz H.,17,238,137,101,2021-11-04,Paris,BNP Paribas Masters,Hard,4.33,1.22,0
Monfils G.,323,816,510,306,Djokovic N.,2,1207,1012,195,2021-11-04,Paris,BNP Paribas Masters,Hard,5.5,1.14,0
Duckworth J.,123,143,55,88,Hurkacz H.,17,238,137,101,2021-11-05,Paris,BNP Paribas Masters,Hard,3.2,1.36,0
Djokovic N.,2,1207,1012,195,Fritz T.,9,356,205,151,2021-11-05,Paris,BNP Paribas Masters,Hard,1.22,4.33,1
Medvedev D.,3,406,289,117,Gaston H.,109,58,24,34,2021-11-05,Paris,BNP Paribas Masters,Hard,1.1,7.0,1
Zverev A.,19,500,346,154,Ruud C.,4,275,176,99,2021-11-05,Paris,BNP Paribas Masters,Hard,1.4,3.0,1
Medvedev D.,3,406,289,117,Zverev A.,19,500,346,154,2021-11-06,Paris,BNP Paribas Masters,Hard,1.72,2.1,1
Djokovic N.,2,1207,1012,195,Hurkacz H.,17,238,137,101,2021-11-06,Paris,BNP Paribas Masters,Hard,1.16,5.0,1
Djokovic N.,2,1207,1012,195,Medvedev D.,3,406,289,117,2021-11-07,Paris,BNP Paribas Masters,Hard,2.0,1.8,1
Borg L.,437,4,1,3,Paul T.,14,204,111,93,2021-11-07,Stockholm,Stockholm Open,Hard,29.0,1.0,0
Mannarino A.,27,567,264,303,Fucsovics M.,67,249,121,128,2021-11-07,Stockholm,Stockholm Open,Hard,2.62,1.5,0
Davidovich Fokina A.,39,168,84,84,Mcdonald M.,60,190,87,103,2021-11-07,Stockholm,Stockholm Open,Hard,1.9,1.9,1
Krajinovic F.,93,240,115,125,Istomin D.,267,440,194,246,2021-11-08,Stockholm,Stockholm Open,Hard,1.16,5.0,1
Tiafoe F.,10,303,158,145,Ymer E.,186,81,24,57,2021-11-08,Stockholm,Stockholm Open,Hard,1.22,4.33,1
Kovalik J.,172,68,24,44,Gojowczyk P.,108,172,75,97,2021-11-08,Stockholm,Stockholm Open,Hard,,,1
Vavassori A.,128,12,5,7,Kotov P.,89,25,10,15,2021-11-08,Stockholm,Stockholm Open,Hard,2.3,1.61,1
Murray A.,44,932,687,245,Durasovic V.,345,2,0,2,2021-11-09,Stockholm,Stockholm Open,Hard,1.08,8.0,1
Ruusuvuori E.,55,158,79,79,Martinez P.,135,118,50,68,2021-11-09,Stockholm,Stockholm Open,Hard,1.4,3.0,0
Gerasimov E.,150,93,43,50,Fritz T.,9,356,205,151,2021-11-09,Stockholm,Stockholm Open,Hard,5.0,1.16,0
Serdarusic N.,702,9,1,8,Van De Zandschulp B.,44,117,63,54,2021-11-09,Stockholm,Stockholm Open,Hard,5.0,1.16,0
Bublik A.,25,219,110,109,Rinderknech A.,67,96,46,50,2021-11-09,Stockholm,Stockholm Open,Hard,2.2,1.66,0
Evans D.,30,251,124,127,Davidovich Fokina A.,39,168,84,84,2021-11-10,Stockholm,Stockholm Open,Hard,1.9,1.9,1
Tiafoe F.,10,303,158,145,Martinez P.,135,118,50,68,2021-11-10,Stockholm,Stockholm Open,Hard,1.3,3.5,1
Shapovalov D.,29,298,166,132,Vavassori A.,128,12,5,7,2021-11-10,Stockholm,Stockholm Open,Hard,1.11,6.5,1
Kovalik J.,172,68,24,44,Rinderknech A.,67,96,46,50,2021-11-10,Stockholm,Stockholm Open,Hard,5.0,1.16,0
Van De Zandschulp B.,44,117,63,54,Fucsovics M.,67,249,121,128,2021-11-10,Stockholm,Stockholm Open,Hard,2.5,1.53,1
Fritz T.,9,356,205,151,Paul T.,14,204,111,93,2021-11-10,Stockholm,Stockholm Open,Hard,1.4,3.0,0
Sinner J.,8,224,153,71,Murray A.,44,932,687,245,2021-11-10,Stockholm,Stockholm Open,Hard,1.36,3.2,0
Krajinovic F.,93,240,115,125,Auger-Aliassime F.,12,268,163,105,2021-11-10,Stockholm,Stockholm Open,Hard,2.62,1.5,0
Shapovalov D.,29,298,166,132,Rinderknech A.,67,96,46,50,2021-11-11,Stockholm,Stockholm Open,Hard,1.4,3.0,1
Murray A.,44,932,687,245,Paul T.,14,204,111,93,2021-11-11,Stockholm,Stockholm Open,Hard,1.53,2.5,0
Auger-Aliassime F.,12,268,163,105,Van De Zandschulp B.,44,117,63,54,2021-11-11,Stockholm,Stockholm Open,Hard,1.44,2.75,1
Evans D.,30,251,124,127,Tiafoe F.,10,303,158,145,2021-11-11,Stockholm,Stockholm Open,Hard,2.2,1.66,0
Paul T.,14,204,111,93,Tiafoe F.,10,303,158,145,2021-11-12,Stockholm,Stockholm Open,Hard,2.2,1.66,1
Shapovalov D.,29,298,166,132,Auger-Aliassime F.,12,268,163,105,2021-11-12,Stockholm,Stockholm Open,Hard,2.3,1.61,1
Paul T.,14,204,111,93,Shapovalov D.,29,298,166,132,2021-11-13,Stockholm,Stockholm Open,Hard,2.3,1.61,1
Medvedev D.,3,406,289,117,Hurkacz H.,17,238,137,101,2021-11-14,Turin,Masters Cup,Hard,1.2,4.5,1
Zverev A.,19,500,346,154,Berrettini M.,38,217,142,75,2021-11-14,Turin,Masters Cup,Hard,1.36,3.2,0
Ruud C.,4,275,176,99,Djokovic N.,2,1207,1012,195,2021-11-15,Turin,Masters Cup,Hard,6.5,1.11,0
Tsitsipas S.,5,390,264,126,Rublev A.,7,392,255,137,2021-11-15,Turin,Masters Cup,Hard,1.72,2.1,0
Hurkacz H.,17,238,137,101,Sinner J.,8,224,153,71,2021-11-16,Turin,Masters Cup,Hard,2.0,1.8,0
Zverev A.,19,500,346,154,Medvedev D.,3,406,289,117,2021-11-16,Turin,Masters Cup,Hard,2.5,1.53,0
Norrie C.,13,287,172,115,Ruud C.,4,275,176,99,2021-11-17,Turin,Masters Cup,Hard,2.37,1.57,0
Rublev A.,7,392,255,137,Djokovic N.,2,1207,1012,195,2021-11-17,Turin,Masters Cup,Hard,4.33,1.22,0
Hurkacz H.,17,238,137,101,Zverev A.,19,500,346,154,2021-11-18,Turin,Masters Cup,Hard,4.0,1.22,0
Medvedev D.,3,406,289,117,Sinner J.,8,224,153,71,2021-11-18,Turin,Masters Cup,Hard,1.4,2.75,1
Ruud C.,4,275,176,99,Rublev A.,7,392,255,137,2021-11-19,Turin,Masters Cup,Hard,2.5,1.5,1
Djokovic N.,2,1207,1012,195,Norrie C.,13,287,172,115,2021-11-19,Turin,Masters Cup,Hard,1.14,5.5,1
Medvedev D.,3,406,289,117,Ruud C.,4,275,176,99,2021-11-20,Turin,Masters Cup,Hard,1.14,5.5,1
Djokovic N.,2,1207,1012,195,Zverev A.,19,500,346,154,2021-11-20,Turin,Masters Cup,Hard,1.4,3.0,0
Zverev A.,19,500,346,154,Medvedev D.,3,406,289,117,2021-11-21,Turin,Masters Cup,Hard,2.5,1.53,1
Johnson S.,197,395,196,199,Vukic A.,62,36,15,21,2022-01-03,Adelaide,Adelaide International 1,Hard,2.0,1.8,1
Carballes Baena R.,64,207,91,116,Djere L.,38,243,120,123,2022-01-03,Adelaide,Adelaide International 1,Hard,2.2,1.66,0
Monteiro T.,121,171,69,102,Altmaier D.,51,79,28,51,2022-01-03,Adelaide,Adelaide International 1,Hard,2.3,1.61,1
Kwon S.W.,68,108,53,55,Nishioka Y.,31,215,99,116,2022-01-03,Adelaide,Adelaide International 1,Hard,1.61,2.3,1
Bagnis F.,135,121,39,82,Murray A.,44,932,687,245,2022-01-04,Melbourne,Melbourne Summer Set,Hard,7.0,1.1,1
Mannarino A.,27,567,264,303,Van De Zandschulp B.,44,117,63,54,2022-01-04,Melbourne,Melbourne Summer Set,Hard,2.75,1.44,0
Gojowczyk P.,108,172,75,97,Mcdonald M.,60,190,87,103,2022-01-04,Melbourne,Melbourne Summer Set,Hard,3.2,1.36,0
Koepfer D.,84,86,38,48,Griekspoor T.,37,97,47,50,2022-01-04,Melbourne,Melbourne Summer Set,Hard,2.3,1.61,0
Millman J.,140,256,113,143,Kokkinakis T.,86,124,55,69,2022-01-04,Adelaide,Adelaide International 1,Hard,2.1,1.72,0
Mager G.,67,59,24,35,Cerundolo F.,21,104,58,46,2022-01-04,Adelaide,Adelaide International 1,Hard,2.0,1.8,1
Ymer M.,59,130,58,72,Bonzi B.,107,83,37,46,2022-01-04,Adelaide,Adelaide International 1,Hard,2.0,1.8,1
Cerundolo J.M.,106,29,12,17,Bolt A.,345,40,13,27,2022-01-04,Adelaide,Adelaide International 1,Hard,2.75,1.44,1
Fucsovics M.,67,249,121,128,Gerasimov E.,150,93,43,50,2022-01-04,Adelaide,Adelaide International 1,Hard,1.57,2.37,0
Daniel T.,111,178,67,111,Musetti L.,18,143,79,64,2022-01-04,Adelaide,Adelaide International 1,Hard,2.0,1.8,1
Rune H.,6,131,83,48,Moutet C.,80,118,50,68,2022-01-04,Adelaide,Adelaide International 1,Hard,1.44,2.75,0
Paul T.,14,204,111,93,Vesely J.,528,288,130,158,2022-01-04,Adelaide,Adelaide International 1,Hard,1.33,3.4,1
Thompson J.,71,221,96,125,O Connell C.,74,65,26,39,2022-01-05,Melbourne,Melbourne Summer Set,Hard,1.9,1.9,1
Giron M.,69,150,68,82,Berankis R.,212,249,104,145,2022-01-05,Melbourne,Melbourne Summer Set,Hard,1.66,2.2,0
Cressy M.,96,96,42,54,Hijikata R.,110,16,7,9,2022-01-05,Melbourne,Melbourne Summer Set,Hard,1.36,3.2,1
Seppi A.,141,758,363,395,Molcan A.,120,86,45,41,2022-01-05,Melbourne,Melbourne Summer Set,Hard,2.2,1.66,0
Popyrin A.,90,140,59,81,Travaglia S.,1024,81,27,54,2022-01-05,Melbourne,Melbourne Summer Set,Hard,1.5,2.62,1
Munar J.,104,178,75,103,Anderson K.,652,598,347,251,2022-01-05,Melbourne,Melbourne Summer Set,Hard,2.75,1.44,1
Cilic M.,100,853,543,310,Monteiro T.,121,171,69,102,2022-01-05,Adelaide,Adelaide International 1,Hard,1.3,3.5,1
Tiafoe F.,10,303,158,145,Kokkinakis T.,86,124,55,69,2022-01-05,Adelaide,Adelaide International 1,Hard,1.61,2.3,0
Kwon S.W.,68,108,53,55,Ymer M.,59,130,58,72,2022-01-05,Adelaide,Adelaide International 1,Hard,1.57,2.37,0
Ruusuvuori E.,55,158,79,79,Baez S.,72,95,47,48,2022-01-05,Melbourne,Melbourne Summer Set,Hard,1.44,2.75,1
Djere L.,38,243,120,123,Moutet C.,80,118,50,68,2022-01-05,Adelaide,Adelaide International 1,Hard,2.3,1.61,1
Paire B.,149,527,237,290,Laaksonen H.,125,101,37,64,2022-01-05,Melbourne,Melbourne Summer Set,Hard,3.4,1.33,0
Molcan A.,120,86,45,41,Goffin D.,123,522,296,226,2022-01-06,Melbourne,Melbourne Summer Set,Hard,1.53,2.5,1
Bagnis F.,135,121,39,82,Dimitrov G.,20,651,389,262,2022-01-06,Melbourne,Melbourne Summer Set,Hard,5.0,1.16,0
Berankis R.,212,249,104,145,Nadal R.,2,1223,1017,206,2022-01-06,Melbourne,Melbourne Summer Set,Hard,5.5,1.14,0
Laaksonen H.,125,101,37,64,Munar J.,104,178,75,103,2022-01-06,Melbourne,Melbourne Summer Set,Hard,1.72,2.1,0
Popyrin A.,90,140,59,81,Griekspoor T.,37,97,47,50,2022-01-06,Melbourne,Melbourne Summer Set,Hard,2.0,1.8,0
Mcdonald M.,60,190,87,103,Van De Zandschulp B.,44,117,63,54,2022-01-06,Melbourne,Melbourne Summer Set,Hard,1.9,1.9,0
Thompson J.,71,221,96,125,Ruusuvuori E.,55,158,79,79,2022-01-06,Melbourne,Melbourne Summer Set,Hard,2.75,1.44,0
Cressy M.,96,96,42,54,Opelka R.,17,168,88,80,2022-01-06,Melbourne,Melbourne Summer Set,Hard,2.2,1.66,1
Cerundolo J.M.,106,29,12,17,Monfils G.,323,816,510,306,2022-01-06,Adelaide,Adelaide International 1,Hard,4.5,1.2,0
Khachanov K.,11,378,217,161,Johnson S.,197,395,196,199,2022-01-06,Adelaide,Adelaide International 1,Hard,1.25,4.0,1
Gerasimov E.,150,93,43,50,Mager G.,67,59,24,35,2022-01-06,Adelaide,Adelaide International 1,Hard,1.66,2.2,1
Paul T.,14,204,111,93,Daniel T.,111,178,67,111,2022-01-06,Adelaide,Adelaide International 1,Hard,1.33,3.4,1
Kokkinakis T.,86,124,55,69,Ymer M.,59,130,58,72,2022-01-07,Adelaide,Adelaide International 1,Hard,1.61,2.3,1
Khachanov K.,11,378,217,161,Gerasimov E.,150,93,43,50,2022-01-07,Adelaide,Adelaide International 1,Hard,1.25,4.0,1
Monfils G.,323,816,510,306,Paul T.,14,204,111,93,2022-01-07,Adelaide,Adelaide International 1,Hard,1.53,2.5,1
Djere L.,38,243,120,123,Cilic M.,100,853,543,310,2022-01-07,Adelaide,Adelaide International 1,Hard,3.75,1.28,0
Van De Zandschulp B.,44,117,63,54,Dimitrov G.,20,651,389,262,2022-01-07,Melbourne,Melbourne Summer Set,Hard,2.2,1.66,0
Ruusuvuori E.,55,158,79,79,Molcan A.,120,86,45,41,2022-01-07,Melbourne,Melbourne Summer Set,Hard,1.72,2.1,1
Nadal R.,2,1223,1017,206,Griekspoor T.,37,97,47,50,2022-01-07,Melbourne,Melbourne Summer Set,Hard,1.16,5.0,1
Munar J.,104,178,75,103,Cressy M.,96,96,42,54,2022-01-07,Melbourne,Melbourne Summer Set,Hard,2.1,1.72,0
Monfils G.,323,816,510,306,Kokkinakis T.,86,124,55,69,2022-01-08,Adelaide,Adelaide International 1,Hard,1.4,3.0,1
Cressy M.,96,96,42,54,Dimitrov G.,20,651,389,262,2022-01-08,Melbourne,Melbourne Summer Set,Hard,3.0,1.4,1
Ruusuvuori E.,55,158,79,79,Nadal R.,2,1223,1017,206,2022-01-08,Melbourne,Melbourne Summer Set,Hard,5.0,1.16,0
Khachanov K.,11,378,217,161,Cilic M.,100,853,543,310,2022-01-08,Adelaide,Adelaide International 1,Hard,2.1,1.72,1
Cressy M.,96,96,42,54,Nadal R.,2,1223,1017,206,2022-01-09,Melbourne,Melbourne Summer Set,Hard,6.0,1.12,0
Khachanov K.,11,378,217,161,Monfils G.,323,816,510,306,2022-01-09,Adelaide,Adelaide International 1,Hard,2.3,1.61,0
Thompson J.,71,221,96,125,Giron M.,69,150,68,82,2022-01-10,Sydney,Sydney Tennis Classic,Hard,2.2,1.66,1
Altmaier D.,51,79,28,51,Fognini F.,128,742,383,359,2022-01-10,Sydney,Sydney Tennis Classic,Hard,2.75,1.44,0
Munar J.,104,178,75,103,Millman J.,140,256,113,143,2022-01-10,Adelaide,Adelaide International 2,Hard,2.1,1.72,1
Bagnis F.,135,121,39,82,Goffin D.,123,522,296,226,2022-01-10,Sydney,Sydney Tennis Classic,Hard,2.2,1.66,0
Paul T.,14,204,111,93,Tiafoe F.,10,303,158,145,2022-01-10,Adelaide,Adelaide International 2,Hard,2.1,1.72,1
Vukic A.,62,36,15,21,Bublik A.,25,219,110,109,2022-01-10,Adelaide,Adelaide International 2,Hard,2.0,1.8,1
Gaston H.,109,58,24,34,Sonego L.,43,221,107,114,2022-01-10,Sydney,Sydney Tennis Classic,Hard,2.75,1.44,0
Rinderknech A.,67,96,46,50,Mcdonald M.,60,190,87,103,2022-01-10,Adelaide,Adelaide International 2,Hard,2.5,1.53,1
Cressy M.,96,96,42,54,Mannarino A.,27,567,264,303,2022-01-11,Sydney,Sydney Tennis Classic,Hard,1.44,2.75,1
Davidovich Fokina A.,39,168,84,84,Lajovic D.,66,378,163,215,2022-01-11,Sydney,Sydney Tennis Classic,Hard,1.53,2.5,0
Murray A.,44,932,687,245,Durasovic V.,345,2,0,2,2022-01-11,Sydney,Sydney Tennis Classic,Hard,1.08,8.0,1
Kecmanovic M.,40,210,107,103,Travaglia S.,1024,81,27,54,2022-01-11,Sydney,Sydney Tennis Classic,Hard,1.72,2.1,1
Delbonis F.,131,340,152,188,Kudla D.,137,198,70,128,2022-01-11,Sydney,Sydney Tennis Classic,Hard,1.8,2.0,0
Vesely J.,528,288,130,158,Nakashima B.,70,106,57,49,2022-01-11,Sydney,Sydney Tennis Classic,Hard,2.75,1.44,0
O Connell C.,74,65,26,39,Baez S.,72,95,47,48,2022-01-11,Sydney,Sydney Tennis Classic,Hard,1.8,2.0,0
Martinez P.,135,118,50,68,Popyrin A.,90,140,59,81,2022-01-11,Sydney,Sydney Tennis Classic,Hard,2.62,1.5,1
Rinderknech A.,67,96,46,50,Kwon S.W.,68,108,53,55,2022-01-11,Adelaide,Adelaide International 2,Hard,1.9,1.9,1
Monteiro T.,121,171,69,102,Nishioka Y.,31,215,99,116,2022-01-11,Adelaide,Adelaide International 2,Hard,1.9,1.9,1
Struff J.L.,21,369,170,199,Moutet C.,80,118,50,68,2022-01-11,Adelaide,Adelaide International 2,Hard,1.8,2.0,0
Harris L.,186,129,59,70,Kwon S.W.,68,108,53,55,2022-01-11,Adelaide,Adelaide International 2,Hard,1.61,2.3,0
Johnson S.,197,395,196,199,Bolt A.,345,40,13,27,2022-01-11,Adelaide,Adelaide International 2,Hard,1.36,3.2,1
Carballes Baena R.,64,207,91,116,Bonzi B.,107,83,37,46,2022-01-11,Adelaide,Adelaide International 2,Hard,2.5,1.53,0
Van De Zandschulp B.,44,117,63,54,Fucsovics M.,67,249,121,128,2022-01-11,Adelaide,Adelaide International 2,Hard,1.66,2.2,0
Gerasimov E.,150,93,43,50,Mager G.,67,59,24,35,2022-01-11,Adelaide,Adelaide International 2,Hard,1.66,2.2,0
Paire B.,149,527,237,290,Kokkinakis T.,86,124,55,69,2022-01-11,Adelaide,Adelaide International 2,Hard,3.75,1.28,0
Martinez P.,135,118,50,68,Evans D.,30,251,124,127,2022-01-12,Sydney,Sydney Tennis Classic,Hard,3.4,1.33,0
Nakashima B.,70,106,57,49,Fognini F.,128,742,383,359,2022-01-12,Sydney,Sydney Tennis Classic,Hard,1.5,2.62,1
Baez S.,72,95,47,48,Sonego L.,43,221,107,114,2022-01-12,Sydney,Sydney Tennis Classic,Hard,2.37,1.57,0
Kecmanovic M.,40,210,107,103,Karatsev A.,75,136,66,70,2022-01-12,Sydney,Sydney Tennis Classic,Hard,2.5,1.53,0
Vukic A.,62,36,15,21,Johnson S.,197,395,196,199,2022-01-12,Adelaide,Adelaide International 2,Hard,1.8,2.0,1
Isner J.,114,755,465,290,Kokkinakis T.,86,124,55,69,2022-01-12,Adelaide,Adelaide International 2,Hard,2.1,1.72,0
Bonzi B.,107,83,37,46,Paul T.,14,204,111,93,2022-01-12,Adelaide,Adelaide International 2,Hard,3.0,1.4,0
Mager G.,67,59,24,35,Khachanov K.,11,378,217,161,2022-01-12,Adelaide,Adelaide International 2,Hard,4.33,1.22,0
Goffin D.,123,522,296,226,Kudla D.,137,198,70,128,2022-01-12,Sydney,Sydney Tennis Classic,Hard,1.53,2.5,1
Murray A.,44,932,687,245,Basilashvili N.,118,301,138,163,2022-01-12,Sydney,Sydney Tennis Classic,Hard,1.25,4.0,1
Moutet C.,80,118,50,68,Fucsovics M.,67,249,121,128,2022-01-12,Adelaide,Adelaide International 2,Hard,2.2,1.66,1
Monfils G.,323,816,510,306,Monteiro T.,121,171,69,102,2022-01-12,Adelaide,Adelaide International 2,Hard,1.2,4.5,0
Cilic M.,100,853,543,310,Munar J.,104,178,75,103,2022-01-12,Adelaide,Adelaide International 2,Hard,1.36,3.2,1
Opelka R.,17,168,88,80,Thompson J.,71,221,96,125,2022-01-12,Sydney,Sydney Tennis Classic,Hard,1.53,2.5,1
Cressy M.,96,96,42,54,Lajovic D.,66,378,163,215,2022-01-13,Sydney,Sydney Tennis Classic,Hard,1.5,2.62,1
Sonego L.,43,221,107,114,Karatsev A.,75,136,66,70,2022-01-13,Sydney,Sydney Tennis Classic,Hard,2.0,1.8,0
Opelka R.,17,168,88,80,Nakashima B.,70,106,57,49,2022-01-13,Sydney,Sydney Tennis Classic,Hard,2.1,1.72,1
Goffin D.,123,522,296,226,Murray A.,44,932,687,245,2022-01-13,Sydney,Sydney Tennis Classic,Hard,2.2,1.66,0
Evans D.,30,251,124,127,Cressy M.,96,96,42,54,2022-01-13,Sydney,Sydney Tennis Classic,Hard,1.5,2.62,1
Khachanov K.,11,378,217,161,Rinderknech A.,67,96,46,50,2022-01-13,Adelaide,Adelaide International 2,Hard,1.4,3.0,0
Kokkinakis T.,86,124,55,69,Vukic A.,62,36,15,21,2022-01-13,Adelaide,Adelaide International 2,Hard,1.53,2.5,1
Monteiro T.,121,171,69,102,Moutet C.,80,118,50,68,2022-01-13,Adelaide,Adelaide International 2,Hard,2.75,1.44,0
Paul T.,14,204,111,93,Cilic M.,100,853,543,310,2022-01-13,Adelaide,Adelaide International 2,Hard,2.1,1.72,0
Cilic M.,100,853,543,310,Kokkinakis T.,86,124,55,69,2022-01-14,Adelaide,Adelaide International 2,Hard,1.57,2.37,0
Rinderknech A.,67,96,46,50,Moutet C.,80,118,50,68,2022-01-14,Adelaide,Adelaide International 2,Hard,2.0,1.8,1
Opelka R.,17,168,88,80,Murray A.,44,932,687,245,2022-01-14,Sydney,Sydney Tennis Classic,Hard,2.0,1.8,0
Karatsev A.,75,136,66,70,Evans D.,30,251,124,127,2022-01-14,Sydney,Sydney Tennis Classic,Hard,2.2,1.66,1
Rinderknech A.,67,96,46,50,Kokkinakis T.,86,124,55,69,2022-01-15,Adelaide,Adelaide International 2,Hard,2.0,1.8,0
Karatsev A.,75,136,66,70,Murray A.,44,932,687,245,2022-01-15,Sydney,Sydney Tennis Classic,Hard,1.8,2.0,1
Gerasimov E.,150,93,43,50,Hurkacz H.,17,238,137,101,2022-01-17,Melbourne,Australian Open,Hard,6.5,1.11,0
Koepfer D.,84,86,38,48,Taberner C.,181,37,13,24,2022-01-17,Melbourne,Australian Open,Hard,1.3,3.5,1
Moutet C.,80,118,50,68,Pouille L.,675,259,134,125,2022-01-17,Melbourne,Australian Open,Hard,1.25,4.0,1
Fognini F.,128,742,383,359,Griekspoor T.,37,97,47,50,2022-01-17,Melbourne,Australian Open,Hard,1.66,2.2,0
Mcdonald M.,60,190,87,103,Milojevic N.,136,14,6,8,2022-01-17,Melbourne,Australian Open,Hard,1.16,5.0,1
Caruso S.,146,63,19,44,Kecmanovic M.,40,210,107,103,2022-01-17,Melbourne,Australian Open,Hard,3.4,1.33,0
Tseng C.H.,145,9,1,8,Otte O.,233,78,33,45,2022-01-17,Melbourne,Australian Open,Hard,3.75,1.28,0
Hanfmann Y.,50,99,50,49,Kokkinakis T.,86,124,55,69,2022-01-17,Melbourne,Australian Open,Hard,3.75,1.28,1
Opelka R.,17,168,88,80,Anderson K.,652,598,347,251,2022-01-17,Melbourne,Australian Open,Hard,1.4,3.0,1
Lopez F.,634,863,441,422,Millman J.,140,256,113,143,2022-01-17,Melbourne,Australian Open,Hard,2.75,1.44,0
Korda S.,26,126,75,51,Norrie C.,13,287,172,115,2022-01-17,Melbourne,Australian Open,Hard,2.37,1.57,1
Karatsev A.,75,136,66,70,Munar J.,104,178,75,103,2022-01-17,Melbourne,Australian Open,Hard,1.16,5.0,1
Paul T.,14,204,111,93,Kukushkin M.,221,352,141,211,2022-01-17,Melbourne,Australian Open,Hard,1.22,4.33,1
Sonego L.,43,221,107,114,Querrey S.,287,678,369,309,2022-01-17,Melbourne,Australian Open,Hard,1.2,4.5,1
Giron M.,69,150,68,82,Nadal R.,2,1223,1017,206,2022-01-17,Melbourne,Australian Open,Hard,11.0,1.05,0
Zverev A.,19,500,346,154,Altmaier D.,51,79,28,51,2022-01-17,Melbourne,Australian Open,Hard,1.03,15.0,1
Etcheverry T.,34,60,26,34,Carreno Busta P.,16,352,214,138,2022-01-17,Melbourne,Australian Open,Hard,10.0,1.06,0
Escobedo E.,377,57,20,37,Bublik A.,25,219,110,109,2022-01-17,Melbourne,Australian Open,Hard,2.1,1.72,0
Djere L.,38,243,120,123,Shapovalov D.,29,298,166,132,2022-01-17,Melbourne,Australian Open,Hard,7.0,1.1,0
Kwon S.W.,68,108,53,55,Rune H.,6,131,83,48,2022-01-17,Melbourne,Australian Open,Hard,1.66,2.2,1
Lajovic D.,66,378,163,215,Fucsovics M.,67,249,121,128,2022-01-17,Melbourne,Australian Open,Hard,3.2,1.36,1
Harris L.,186,129,59,70,Vukic A.,62,36,15,21,2022-01-17,Melbourne,Australian Open,Hard,1.3,3.5,0
Martinez P.,135,118,50,68,Delbonis F.,131,340,152,188,2022-01-17,Melbourne,Australian Open,Hard,1.3,3.5,1
Gojowczyk P.,108,172,75,97,Bonzi B.,107,83,37,46,2022-01-17,Melbourne,Australian Open,Hard,3.2,1.36,0
Bagnis F.,135,121,39,82,Garin C.,101,190,103,87,2022-01-17,Melbourne,Australian Open,Hard,2.62,1.5,0
Tabilo A.,122,44,21,23,Alcaraz C.,1,164,130,34,2022-01-17,Melbourne,Australian Open,Hard,5.0,1.16,0
Kozlov S.,108,35,9,26,Vesely J.,528,288,130,158,2022-01-17,Melbourne,Australian Open,Hard,2.62,1.5,1
Coria F.,108,99,43,56,Monfils G.,323,816,510,306,2022-01-17,Melbourne,Australian Open,Hard,13.0,1.04,0
Berrettini M.,38,217,142,75,Nakashima B.,70,106,57,49,2022-01-17,Melbourne,Australian Open,Hard,1.3,3.5,1
Kudla D.,137,198,70,128,Khachanov K.,11,378,217,161,2022-01-17,Melbourne,Australian Open,Hard,6.0,1.12,0
Mannarino A.,27,567,264,303,Duckworth J.,123,143,55,88,2022-01-17,Melbourne,Australian Open,Hard,2.37,1.57,1
Albot R.,97,215,86,129,Nishioka Y.,31,215,99,116,2022-01-17,Melbourne,Australian Open,Hard,2.0,1.8,1
Evans D.,30,251,124,127,Goffin D.,123,522,296,226,2022-01-18,Melbourne,Australian Open,Hard,1.2,4.5,1
Machac T.,108,18,6,12,Cerundolo J.M.,106,29,12,17,2022-01-18,Melbourne,Australian Open,Hard,1.16,5.0,1
Barrios M.,121,10,3,7,Daniel T.,111,178,67,111,2022-01-18,Melbourne,Australian Open,Hard,3.2,1.36,0
Molcan A.,120,86,45,41,Safiullin R.,92,42,20,22,2022-01-18,Melbourne,Australian Open,Hard,1.61,2.3,1
Dzumhur D.,202,234,107,127,Andujar P.,323,404,164,240,2022-01-18,Melbourne,Australian Open,Hard,1.66,2.2,0
Fritz T.,9,356,205,151,Marterer M.,144,91,31,60,2022-01-18,Melbourne,Australian Open,Hard,1.12,6.0,1
Ymer M.,59,130,58,72,Tsitsipas S.,5,390,264,126,2022-01-18,Melbourne,Australian Open,Hard,4.5,1.2,0
Baez S.,72,95,47,48,Ramos-Vinolas A.,82,437,204,233,2022-01-18,Melbourne,Australian Open,Hard,1.5,2.62,1
Trungelliti M.,240,33,13,20,Tiafoe F.,10,303,158,145,2022-01-18,Melbourne,Australian Open,Hard,6.5,1.11,0
Popyrin A.,90,140,59,81,Rinderknech A.,67,96,46,50,2022-01-18,Melbourne,Australian Open,Hard,2.1,1.72,0
Seppi A.,141,758,363,395,Majchrzak K.,121,50,19,31,2022-01-18,Melbourne,Australian Open,Hard,2.3,1.61,0
De Minaur A.,19,272,161,111,Musetti L.,18,143,79,64,2022-01-18,Melbourne,Australian Open,Hard,1.14,5.5,1
Broady L.,125,47,18,29,Kyrgios N.,25,303,195,108,2022-01-18,Melbourne,Australian Open,Hard,2.62,1.5,0
Ruusuvuori E.,55,158,79,79,Auger-Aliassime F.,12,268,163,105,2022-01-18,Melbourne,Australian Open,Hard,3.4,1.33,0
Bolt A.,345,40,13,27,Davidovich Fokina A.,39,168,84,84,2022-01-18,Melbourne,Australian Open,Hard,3.75,1.28,0
Basilashvili N.,118,301,138,163,Murray A.,44,932,687,245,2022-01-18,Melbourne,Australian Open,Hard,2.5,1.53,0
Thompson J.,71,221,96,125,Johnson S.,197,395,196,199,2022-01-18,Melbourne,Australian Open,Hard,1.8,2.0,0
Isner J.,114,755,465,290,Cressy M.,96,96,42,54,2022-01-18,Melbourne,Australian Open,Hard,2.0,1.8,0
Krajinovic F.,93,240,115,125,Schwartzman D.,95,428,233,195,2022-01-18,Melbourne,Australian Open,Hard,4.0,1.25,0
Struff J.L.,21,369,170,199,Van De Zandschulp B.,44,117,63,54,2022-01-18,Melbourne,Australian Open,Hard,2.62,1.5,0
Laaksonen H.,125,101,37,64,Medvedev D.,3,406,289,117,2022-01-18,Melbourne,Australian Open,Hard,21.0,1.01,0
O Connell C.,74,65,26,39,Gaston H.,109,58,24,34,2022-01-18,Melbourne,Australian Open,Hard,1.8,2.0,1
Gombos N.,114,66,21,45,Skatov T.,147,5,1,4,2022-01-18,Melbourne,Australian Open,Hard,1.72,2.1,1
Cilic M.,100,853,543,310,Gomez E.,155,26,7,19,2022-01-18,Melbourne,Australian Open,Hard,1.08,8.0,1
Gasquet R.,48,948,581,367,Humbert U.,36,170,80,90,2022-01-18,Melbourne,Australian Open,Hard,4.5,1.2,1
Bautista Agut R.,25,379,234,145,Travaglia S.,1024,81,27,54,2022-01-18,Melbourne,Australian Open,Hard,1.07,9.0,1
Carballes Baena R.,64,207,91,116,Berankis R.,212,249,104,145,2022-01-18,Melbourne,Australian Open,Hard,2.75,1.44,0
Rublev A.,7,392,255,137,Mager G.,67,59,24,35,2022-01-18,Melbourne,Australian Open,Hard,1.04,13.0,1
Dimitrov G.,20,651,389,262,Lehecka J.,33,61,30,31,2022-01-18,Melbourne,Australian Open,Hard,1.16,5.0,1
Sousa J.,147,436,189,247,Sinner J.,8,224,153,71,2022-01-18,Melbourne,Australian Open,Hard,13.0,1.04,0
Paire B.,149,527,237,290,Monteiro T.,121,171,69,102,2022-01-18,Melbourne,Australian Open,Hard,3.2,1.36,1
Cecchinato M.,108,204,79,125,Kohlschreiber P.,132,812,446,366,2022-01-18,Melbourne,Australian Open,Hard,2.62,1.5,0
Martinez P.,135,118,50,68,Garin C.,101,190,103,87,2022-01-19,Melbourne,Australian Open,Hard,1.9,1.9,0
Monfils G.,323,816,510,306,Bublik A.,25,219,110,109,2022-01-19,Melbourne,Australian Open,Hard,1.2,4.5,1
Millman J.,140,256,113,143,Zverev A.,19,500,346,154,2022-01-19,Melbourne,Australian Open,Hard,11.0,1.05,0
Mcdonald M.,60,190,87,103,Karatsev A.,75,136,66,70,2022-01-19,Melbourne,Australian Open,Hard,2.75,1.44,0
Bonzi B.,107,83,37,46,Khachanov K.,11,378,217,161,2022-01-19,Melbourne,Australian Open,Hard,3.75,1.28,0
Hurkacz H.,17,238,137,101,Mannarino A.,27,567,264,303,2022-01-19,Melbourne,Australian Open,Hard,1.14,5.5,0
Albot R.,97,215,86,129,Vukic A.,62,36,15,21,2022-01-19,Melbourne,Australian Open,Hard,2.5,1.53,1
Kozlov S.,108,35,9,26,Berrettini M.,38,217,142,75,2022-01-19,Melbourne,Australian Open,Hard,10.0,1.06,0
Hanfmann Y.,50,99,50,49,Nadal R.,2,1223,1017,206,2022-01-19,Melbourne,Australian Open,Hard,15.0,1.03,0
Kwon S.W.,68,108,53,55,Shapovalov D.,29,298,166,132,2022-01-19,Melbourne,Australian Open,Hard,4.0,1.25,0
Korda S.,26,126,75,51,Moutet C.,80,118,50,68,2022-01-19,Melbourne,Australian Open,Hard,1.33,3.4,1
Koepfer D.,84,86,38,48,Opelka R.,17,168,88,80,2022-01-19,Melbourne,Australian Open,Hard,3.5,1.3,0
Carreno Busta P.,16,352,214,138,Griekspoor T.,37,97,47,50,2022-01-19,Melbourne,Australian Open,Hard,1.4,3.0,1
Paul T.,14,204,111,93,Kecmanovic M.,40,210,107,103,2022-01-19,Melbourne,Australian Open,Hard,1.4,3.0,0
Sonego L.,43,221,107,114,Otte O.,233,78,33,45,2022-01-19,Melbourne,Australian Open,Hard,1.44,2.75,1
Lajovic D.,66,378,163,215,Alcaraz C.,1,164,130,34,2022-01-19,Melbourne,Australian Open,Hard,6.0,1.12,0
De Minaur A.,19,272,161,111,Majchrzak K.,121,50,19,31,2022-01-20,Melbourne,Australian Open,Hard,1.22,4.33,1
Johnson S.,197,395,196,199,Sinner J.,8,224,153,71,2022-01-20,Melbourne,Australian Open,Hard,9.0,1.07,0
Medvedev D.,3,406,289,117,Kyrgios N.,25,303,195,108,2022-01-20,Melbourne,Australian Open,Hard,1.16,5.0,1
Van De Zandschulp B.,44,117,63,54,Gasquet R.,48,948,581,367,2022-01-20,Melbourne,Australian Open,Hard,1.25,4.0,1
Murray A.,44,932,687,245,Daniel T.,111,178,67,111,2022-01-20,Melbourne,Australian Open,Hard,1.28,3.75,0
Paire B.,149,527,237,290,Dimitrov G.,20,651,389,262,2022-01-20,Melbourne,Australian Open,Hard,5.0,1.16,1
Tsitsipas S.,5,390,264,126,Baez S.,72,95,47,48,2022-01-20,Melbourne,Australian Open,Hard,1.06,10.0,1
Auger-Aliassime F.,12,268,163,105,Davidovich Fokina A.,39,168,84,84,2022-01-20,Melbourne,Australian Open,Hard,1.22,4.33,1
Andujar P.,323,404,164,240,Molcan A.,120,86,45,41,2022-01-20,Melbourne,Australian Open,Hard,2.5,1.53,1
Fritz T.,9,356,205,151,Tiafoe F.,10,303,158,145,2022-01-20,Melbourne,Australian Open,Hard,1.4,3.0,1
Evans D.,30,251,124,127,Rinderknech A.,67,96,46,50,2022-01-20,Melbourne,Australian Open,Hard,1.36,3.2,1
Berankis R.,212,249,104,145,Rublev A.,7,392,255,137,2022-01-20,Melbourne,Australian Open,Hard,10.0,1.06,0
Machac T.,108,18,6,12,Cressy M.,96,96,42,54,2022-01-20,Melbourne,Australian Open,Hard,2.3,1.61,0
Schwartzman D.,95,428,233,195,O Connell C.,74,65,26,39,2022-01-20,Melbourne,Australian Open,Hard,1.16,5.0,0
Cilic M.,100,853,543,310,Gombos N.,114,66,21,45,2022-01-20,Melbourne,Australian Open,Hard,1.12,6.0,1
Bautista Agut R.,25,379,234,145,Kohlschreiber P.,132,812,446,366,2022-01-20,Melbourne,Australian Open,Hard,1.14,5.5,1
Karatsev A.,75,136,66,70,Mannarino A.,27,567,264,303,2022-01-21,Melbourne,Australian Open,Hard,1.25,4.0,0
Khachanov K.,11,378,217,161,Nadal R.,2,1223,1017,206,2022-01-21,Melbourne,Australian Open,Hard,4.5,1.2,0
Korda S.,26,126,75,51,Carreno Busta P.,16,352,214,138,2022-01-21,Melbourne,Australian Open,Hard,2.2,1.66,0
Albot R.,97,215,86,129,Zverev A.,19,500,346,154,2022-01-21,Melbourne,Australian Open,Hard,17.0,1.02,0
Alcaraz C.,1,164,130,34,Berrettini M.,38,217,142,75,2022-01-21,Melbourne,Australian Open,Hard,1.66,2.2,0
Monfils G.,323,816,510,306,Garin C.,101,190,103,87,2022-01-21,Melbourne,Australian Open,Hard,1.08,8.0,1
Kecmanovic M.,40,210,107,103,Sonego L.,43,221,107,114,2022-01-21,Melbourne,Australian Open,Hard,2.62,1.5,1
Opelka R.,17,168,88,80,Shapovalov D.,29,298,166,132,2022-01-21,Melbourne,Australian Open,Hard,2.0,1.8,0
Sinner J.,8,224,153,71,Daniel T.,111,178,67,111,2022-01-22,Melbourne,Australian Open,Hard,1.08,8.0,1
De Minaur A.,19,272,161,111,Andujar P.,323,404,164,240,2022-01-22,Melbourne,Australian Open,Hard,1.06,10.0,1
Auger-Aliassime F.,12,268,163,105,Evans D.,30,251,124,127,2022-01-22,Melbourne,Australian Open,Hard,1.8,2.0,1
Cilic M.,100,853,543,310,Rublev A.,7,392,255,137,2022-01-22,Melbourne,Australian Open,Hard,3.5,1.3,1
O Connell C.,74,65,26,39,Cressy M.,96,96,42,54,2022-01-22,Melbourne,Australian Open,Hard,2.5,1.53,0
Paire B.,149,527,237,290,Tsitsipas S.,5,390,264,126,2022-01-22,Melbourne,Australian Open,Hard,6.5,1.11,0
Fritz T.,9,356,205,151,Bautista Agut R.,25,379,234,145,2022-01-22,Melbourne,Australian Open,Hard,2.1,1.72,1
Medvedev D.,3,406,289,117,Van De Zandschulp B.,44,117,63,54,2022-01-22,Melbourne,Australian Open,Hard,1.03,15.0,1
Nadal R.,2,1223,1017,206,Mannarino A.,27,567,264,303,2022-01-23,Melbourne,Australian Open,Hard,1.04,13.0,1
Zverev A.,19,500,346,154,Shapovalov D.,29,298,166,132,2022-01-23,Melbourne,Australian Open,Hard,1.22,4.33,0
Monfils G.,323,816,510,306,Kecmanovic M.,40,210,107,103,2022-01-23,Melbourne,Australian Open,Hard,1.25,4.0,1
Berrettini M.,38,217,142,75,Carreno Busta P.,16,352,214,138,2022-01-23,Melbourne,Australian Open,Hard,1.44,2.75,1
De Minaur A.,19,272,161,111,Sinner J.,8,224,153,71,2022-01-24,Melbourne,Australian Open,Hard,3.0,1.4,0
Tsitsipas S.,5,390,264,126,Fritz T.,9,356,205,151,2022-01-24,Melbourne,Australian Open,Hard,1.57,2.37,1
Auger-Aliassime F.,12,268,163,105,Cilic M.,100,853,543,310,2022-01-24,Melbourne,Australian Open,Hard,1.61,2.3,1
Medvedev D.,3,406,289,117,Cressy M.,96,96,42,54,2022-01-24,Melbourne,Australian Open,Hard,1.03,15.0,1
Nadal R.,2,1223,1017,206,Shapovalov D.,29,298,166,132,2022-01-25,Melbourne,Australian Open,Hard,1.33,2.62,1
Berrettini M.,38,217,142,75,Monfils G.,323,816,510,306,2022-01-25,Melbourne,Australian Open,Hard,1.57,2.37,1
Tsitsipas S.,5,390,264,126,Sinner J.,8,224,153,71,2022-01-26,Melbourne,Australian Open,Hard,2.2,1.66,1
Auger-Aliassime F.,12,268,163,105,Medvedev D.,3,406,289,117,2022-01-26,Melbourne,Australian Open,Hard,6.0,1.12,0
Nadal R.,2,1223,1017,206,Berrettini M.,38,217,142,75,2022-01-28,Melbourne,Australian Open,Hard,1.4,3.0,1
Medvedev D.,3,406,289,117,Tsitsipas S.,5,390,264,126,2022-01-28,Melbourne,Australian Open,Hard,1.36,3.2,1
Nadal R.,2,1223,1017,206,Medvedev D.,3,406,289,117,2022-01-30,Melbourne,Australian Open,Hard,2.62,1.53,1
Kovalik J.,172,68,24,44,Bhambri Y.,862,40,14,26,2022-01-31,Pune,Maharashtra Open,Hard,2.62,1.5,0
Albot R.,97,215,86,129,Gaio F.,174,18,3,15,2022-01-31,Pune,Maharashtra Open,Hard,1.22,4.33,1
Berankis R.,212,249,104,145,Halys Q.,79,72,23,49,2022-01-31,Pune,Maharashtra Open,Hard,1.61,2.3,0
Altmaier D.,51,79,28,51,Gunneswaran P.,228,28,7,21,2022-01-31,Pune,Maharashtra Open,Hard,1.36,3.2,1
Griekspoor T.,37,97,47,50,Bublik A.,25,219,110,109,2022-01-31,Montpellier,Open Sud de France,Hard,1.66,2.2,0
Monteiro T.,121,171,69,102,Martinez P.,135,118,50,68,2022-01-31,Cordoba,Cordoba Open,Clay,2.37,1.57,0
Varillas J.P.,77,22,10,12,Bagnis F.,135,121,39,82,2022-01-31,Cordoba,Cordoba Open,Clay,1.8,2.0,1
Bonzi B.,107,83,37,46,Goffin D.,123,522,296,226,2022-01-31,Montpellier,Open Sud de France,Hard,2.0,1.8,0
Moroni G.M.,181,2,0,2,Ymer E.,186,81,24,57,2022-02-01,Pune,Maharashtra Open,Hard,2.62,1.5,0
Ruusuvuori E.,55,158,79,79,Gerasimov E.,150,93,43,50,2022-02-01,Pune,Maharashtra Open,Hard,1.44,2.75,1
Ilkel C.,382,17,1,16,Kopriva V.,159,9,5,4,2022-02-01,Pune,Maharashtra Open,Hard,2.2,1.66,0
Travaglia S.,1024,81,27,54,Ramanathan R.,435,40,14,26,2022-02-01,Pune,Maharashtra Open,Hard,1.61,2.3,1
Grenier H.,122,16,5,11,Vukic A.,62,36,15,21,2022-02-01,Pune,Maharashtra Open,Hard,3.0,1.4,0
Zapata Miralles B.,54,80,32,48,Novak D.,166,58,15,43,2022-02-01,Pune,Maharashtra Open,Hard,2.5,1.53,1
Moutet C.,80,118,50,68,Ymer M.,59,130,58,72,2022-02-01,Montpellier,Open Sud de France,Hard,1.61,2.3,0
Kwon S.W.,68,108,53,55,Gaston H.,109,58,24,34,2022-02-01,Montpellier,Open Sud de France,Hard,1.57,2.37,1
Pouille L.,675,259,134,125,Simon G.,188,869,491,378,2022-02-01,Montpellier,Open Sud de France,Hard,2.1,1.72,0
Dzumhur D.,202,234,107,127,Molcan A.,120,86,45,41,2022-02-01,Montpellier,Open Sud de France,Hard,3.0,1.4,1
Tsonga J.W.,297,672,444,228,Zuk K.,172,3,0,3,2022-02-01,Montpellier,Open Sud de France,Hard,2.1,1.72,1
Gojowczyk P.,108,172,75,97,Herbert P.H.,157,202,89,113,2022-02-01,Montpellier,Open Sud de France,Hard,2.5,1.53,0
Krajinovic F.,93,240,115,125,Popyrin A.,90,140,59,81,2022-02-01,Montpellier,Open Sud de France,Hard,1.8,2.0,1
Majchrzak K.,121,50,19,31,Clarke J.,156,13,2,11,2022-02-01,Pune,Maharashtra Open,Hard,1.5,2.62,1
Kadhe A.,778,4,0,4,Sousa J.,147,436,189,247,2022-02-01,Pune,Maharashtra Open,Hard,11.0,1.05,0
Taberner C.,181,37,13,24,Delbonis F.,131,340,152,188,2022-02-01,Cordoba,Cordoba Open,Clay,2.62,1.5,1
Hanfmann Y.,50,99,50,49,Londero J.I.,142,83,34,49,2022-02-01,Cordoba,Cordoba Open,Clay,1.66,2.2,0
Baez S.,72,95,47,48,Verdasco F.,244,962,537,425,2022-02-01,Cordoba,Cordoba Open,Clay,1.22,4.33,1
Tabilo A.,122,44,21,23,Cerundolo F.,21,104,58,46,2022-02-01,Cordoba,Cordoba Open,Clay,2.0,1.8,1
Dellien H.,164,70,22,48,Galan D.E.,76,78,33,45,2022-02-01,Cordoba,Cordoba Open,Clay,2.0,1.8,0
Coria F.,108,99,43,56,Ficovich J.P.,230,3,1,2,2022-02-01,Cordoba,Cordoba Open,Clay,1.53,2.5,0
Martin A.,723,258,107,151,Ramos-Vinolas A.,82,437,204,233,2022-02-01,Cordoba,Cordoba Open,Clay,3.75,1.28,0
Munar J.,104,178,75,103,Paire B.,149,527,237,290,2022-02-01,Cordoba,Cordoba Open,Clay,1.5,2.62,1
Rune H.,6,131,83,48,Carballes Baena R.,64,207,91,116,2022-02-01,Cordoba,Cordoba Open,Clay,1.61,2.3,0
Etcheverry T.,34,60,26,34,Jarry N.,28,141,73,68,2022-02-01,Cordoba,Cordoba Open,Clay,2.1,1.72,1
Simon G.,188,869,491,378,Bautista Agut R.,25,379,234,145,2022-02-02,Montpellier,Open Sud de France,Hard,5.5,1.14,0
Tsonga J.W.,297,672,444,228,Krajinovic F.,93,240,115,125,2022-02-02,Montpellier,Open Sud de France,Hard,3.0,1.4,0
Bublik A.,25,219,110,109,Herbert P.H.,157,202,89,113,2022-02-02,Montpellier,Open Sud de France,Hard,1.5,2.62,1
Mannarino A.,27,567,264,303,Davidovich Fokina A.,39,168,84,84,2022-02-02,Montpellier,Open Sud de France,Hard,2.0,1.8,1
Ivashka I.,113,159,78,81,Mcdonald M.,60,190,87,103,2022-02-02,Montpellier,Open Sud de France,Hard,2.2,1.66,0
Galan D.E.,76,78,33,45,Munar J.,104,178,75,103,2022-02-02,Cordoba,Cordoba Open,Clay,2.3,1.61,1
Schwartzman D.,95,428,233,195,Ficovich J.P.,230,3,1,2,2022-02-02,Cordoba,Cordoba Open,Clay,1.14,5.5,1
Milojevic N.,136,14,6,8,Etcheverry T.,34,60,26,34,2022-02-02,Cordoba,Cordoba Open,Clay,2.62,1.5,1
Halys Q.,79,72,23,49,Majchrzak K.,121,50,19,31,2022-02-02,Pune,Maharashtra Open,Hard,2.3,1.61,0
Altmaier D.,51,79,28,51,Albot R.,97,215,86,129,2022-02-02,Pune,Maharashtra Open,Hard,2.0,1.8,1
Sousa J.,147,436,189,247,Mager G.,67,59,24,35,2022-02-02,Pune,Maharashtra Open,Hard,2.3,1.61,1
Musetti L.,18,143,79,64,Vukic A.,62,36,15,21,2022-02-02,Pune,Maharashtra Open,Hard,2.37,1.57,1
Humbert U.,36,170,80,90,Gasquet R.,48,948,581,367,2022-02-02,Montpellier,Open Sud de France,Hard,1.44,2.75,0
Londero J.I.,142,83,34,49,Martinez P.,135,118,50,68,2022-02-02,Cordoba,Cordoba Open,Clay,2.62,1.5,1
Zapata Miralles B.,54,80,32,48,Vesely J.,528,288,130,158,2022-02-03,Pune,Maharashtra Open,Hard,2.62,1.5,0
Ruusuvuori E.,55,158,79,79,Kopriva V.,159,9,5,4,2022-02-03,Pune,Maharashtra Open,Hard,1.2,4.5,1
Travaglia S.,1024,81,27,54,Bhambri Y.,862,40,14,26,2022-02-03,Pune,Maharashtra Open,Hard,1.4,3.0,1
Basilashvili N.,118,301,138,163,Dzumhur D.,202,234,107,127,2022-02-03,Montpellier,Open Sud de France,Hard,1.57,2.37,0
Ymer E.,186,81,24,57,Karatsev A.,75,136,66,70,2022-02-03,Pune,Maharashtra Open,Hard,3.75,1.28,1
Monfils G.,323,816,510,306,Ymer M.,59,130,58,72,2022-02-03,Montpellier,Open Sud de France,Hard,1.25,4.0,0
Zverev A.,19,500,346,154,Mcdonald M.,60,190,87,103,2022-02-03,Montpellier,Open Sud de France,Hard,1.16,5.0,1
Baez S.,72,95,47,48,Garin C.,101,190,103,87,2022-02-03,Cordoba,Cordoba Open,Clay,2.0,1.8,1
Gasquet R.,48,948,581,367,Kwon S.W.,68,108,53,55,2022-02-03,Montpellier,Open Sud de France,Hard,2.75,1.44,1
Mannarino A.,27,567,264,303,Goffin D.,123,522,296,226,2022-02-03,Montpellier,Open Sud de France,Hard,1.61,2.3,1
Varillas J.P.,77,22,10,12,Ramos-Vinolas A.,82,437,204,233,2022-02-03,Cordoba,Cordoba Open,Clay,2.3,1.61,0
Sonego L.,43,221,107,114,Carballes Baena R.,64,207,91,116,2022-02-03,Cordoba,Cordoba Open,Clay,1.57,2.37,1
Galan D.E.,76,78,33,45,Schwartzman D.,95,428,233,195,2022-02-04,Cordoba,Cordoba Open,Clay,4.5,1.2,0
Londero J.I.,142,83,34,49,Milojevic N.,136,14,6,8,2022-02-04,Cordoba,Cordoba Open,Clay,1.36,3.2,1
Ramos-Vinolas A.,82,437,204,233,Sonego L.,43,221,107,114,2022-02-04,Cordoba,Cordoba Open,Clay,2.3,1.61,1
Tabilo A.,122,44,21,23,Taberner C.,181,37,13,24,2022-02-04,Cordoba,Cordoba Open,Clay,1.72,2.1,1
Majchrzak K.,121,50,19,31,Musetti L.,18,143,79,64,2022-02-04,Pune,Maharashtra Open,Hard,1.61,2.3,1
Zverev A.,19,500,346,154,Mannarino A.,27,567,264,303,2022-02-04,Montpellier,Open Sud de France,Hard,1.2,4.5,1
Ruusuvuori E.,55,158,79,79,Vesely J.,528,288,130,158,2022-02-04,Pune,Maharashtra Open,Hard,1.4,3.0,1
Dzumhur D.,202,234,107,127,Krajinovic F.,93,240,115,125,2022-02-04,Montpellier,Open Sud de France,Hard,3.0,1.4,0
Sousa J.,147,436,189,247,Altmaier D.,51,79,28,51,2022-02-04,Pune,Maharashtra Open,Hard,2.62,1.5,1
Travaglia S.,1024,81,27,54,Ymer E.,186,81,24,57,2022-02-04,Pune,Maharashtra Open,Hard,2.0,1.8,0
Gasquet R.,48,948,581,367,Ymer M.,59,130,58,72,2022-02-04,Montpellier,Open Sud de France,Hard,2.2,1.66,0
Bautista Agut R.,25,379,234,145,Bublik A.,25,219,110,109,2022-02-04,Montpellier,Open Sud de France,Hard,1.44,2.75,0
Ruusuvuori E.,55,158,79,79,Majchrzak K.,121,50,19,31,2022-02-05,Pune,Maharashtra Open,Hard,1.36,3.2,1
Sousa J.,147,436,189,247,Ymer E.,186,81,24,57,2022-02-05,Pune,Maharashtra Open,Hard,2.0,1.8,1
Baez S.,72,95,47,48,Tabilo A.,122,44,21,23,2022-02-05,Cordoba,Cordoba Open,Clay,1.44,2.75,0
Tabilo A.,122,44,21,23,Schwartzman D.,95,428,233,195,2022-02-05,Cordoba,Cordoba Open,Clay,3.2,1.36,1
Londero J.I.,142,83,34,49,Ramos-Vinolas A.,82,437,204,233,2022-02-05,Cordoba,Cordoba Open,Clay,2.37,1.57,0
Zverev A.,19,500,346,154,Ymer M.,59,130,58,72,2022-02-05,Montpellier,Open Sud de France,Hard,1.12,6.0,1
Bublik A.,25,219,110,109,Krajinovic F.,93,240,115,125,2022-02-05,Montpellier,Open Sud de France,Hard,1.8,2.0,1
Bublik A.,25,219,110,109,Zverev A.,19,500,346,154,2022-02-06,Montpellier,Open Sud de France,Hard,5.5,1.14,1
Ramos-Vinolas A.,82,437,204,233,Tabilo A.,122,44,21,23,2022-02-06,Cordoba,Cordoba Open,Clay,1.72,2.0,1
Ruusuvuori E.,55,158,79,79,Sousa J.,147,436,189,247,2022-02-06,Pune,Maharashtra Open,Hard,1.16,5.0,0
Basilashvili N.,118,301,138,163,Mcdonald M.,60,190,87,103,2022-02-07,Rotterdam,ABN AMRO World Tennis Tournament,Hard,2.3,1.61,0
De Minaur A.,19,272,161,111,Goffin D.,123,522,296,226,2022-02-07,Rotterdam,ABN AMRO World Tennis Tournament,Hard,1.33,3.4,1
Tsonga J.W.,297,672,444,228,Hurkacz H.,17,238,137,101,2022-02-07,Rotterdam,ABN AMRO World Tennis Tournament,Hard,4.5,1.2,0
Humbert U.,36,170,80,90,Norrie C.,13,287,172,115,2022-02-07,Rotterdam,ABN AMRO World Tennis Tournament,Hard,2.1,1.72,0
Anderson K.,652,598,347,251,Querrey S.,287,678,369,309,2022-02-07,Dallas,Dallas Open,Hard,1.44,2.75,1
Djere L.,38,243,120,123,Kecmanovic M.,40,210,107,103,2022-02-07,Buenos Aires,Argentina Open,Clay,1.9,1.9,0
Cerundolo F.,21,104,58,46,Bagnis F.,135,121,39,82,2022-02-07,Buenos Aires,Argentina Open,Clay,1.66,2.2,1
Dellien H.,164,70,22,48,Verdasco F.,244,962,537,425,2022-02-07,Buenos Aires,Argentina Open,Clay,1.4,3.0,0
Cuevas P.,149,421,210,211,Coria F.,108,99,43,56,2022-02-07,Buenos Aires,Argentina Open,Clay,3.0,1.4,0
Paire B.,149,527,237,290,Lajovic D.,66,378,163,215,2022-02-07,Buenos Aires,Argentina Open,Clay,2.3,1.61,0
Thompson J.,71,221,96,125,Lopez F.,634,863,441,422,2022-02-08,Dallas,Dallas Open,Hard,1.33,3.4,1
Giron M.,69,150,68,82,Sandgren T.,153,121,47,74,2022-02-08,Dallas,Dallas Open,Hard,1.53,2.5,1
Gojowczyk P.,108,172,75,97,Broady L.,125,47,18,29,2022-02-08,Dallas,Dallas Open,Hard,2.62,1.5,0
Rodionov J.,118,26,9,17,Cressy M.,96,96,42,54,2022-02-08,Dallas,Dallas Open,Hard,4.0,1.25,1
Stebe C.M.,231,76,28,48,Kudla D.,137,198,70,128,2022-02-08,Dallas,Dallas Open,Hard,1.8,2.0,1
Sock J.,166,324,177,147,Otte O.,233,78,33,45,2022-02-08,Dallas,Dallas Open,Hard,2.3,1.61,1
Davidovich Fokina A.,39,168,84,84,Tsitsipas S.,5,390,264,126,2022-02-08,Rotterdam,ABN AMRO World Tennis Tournament,Hard,4.5,1.2,0
Khachanov K.,11,378,217,161,Popyrin A.,90,140,59,81,2022-02-08,Rotterdam,ABN AMRO World Tennis Tournament,Hard,1.33,3.4,1
Rublev A.,7,392,255,137,Laaksonen H.,125,101,37,64,2022-02-08,Rotterdam,ABN AMRO World Tennis Tournament,Hard,1.12,6.0,1
Nakashima B.,70,106,57,49,Millman J.,140,256,113,143,2022-02-08,Dallas,Dallas Open,Hard,1.4,3.0,1
Shapovalov D.,29,298,166,132,Lehecka J.,33,61,30,31,2022-02-08,Rotterdam,ABN AMRO World Tennis Tournament,Hard,1.16,5.0,0
Ymer M.,59,130,58,72,Musetti L.,18,143,79,64,2022-02-08,Rotterdam,ABN AMRO World Tennis Tournament,Hard,1.5,2.62,0
Griekspoor T.,37,97,47,50,Karatsev A.,75,136,66,70,2022-02-08,Rotterdam,ABN AMRO World Tennis Tournament,Hard,2.3,1.61,1
Zapata Miralles B.,54,80,32,48,Van De Zandschulp B.,44,117,63,54,2022-02-08,Rotterdam,ABN AMRO World Tennis Tournament,Hard,4.33,1.22,0
Rune H.,6,131,83,48,Baez S.,72,95,47,48,2022-02-08,Buenos Aires,Argentina Open,Clay,2.5,1.53,0
Tabilo A.,122,44,21,23,Martinez P.,135,118,50,68,2022-02-08,Buenos Aires,Argentina Open,Clay,2.3,1.61,0
Etcheverry T.,34,60,26,34,Munar J.,104,178,75,103,2022-02-08,Buenos Aires,Argentina Open,Clay,2.1,1.72,0
Londero J.I.,142,83,34,49,Andujar P.,323,404,164,240,2022-02-08,Buenos Aires,Argentina Open,Clay,1.9,1.9,0
Jarry N.,28,141,73,68,Carballes Baena R.,64,207,91,116,2022-02-08,Buenos Aires,Argentina Open,Clay,2.0,1.8,0
Del Potro J.M.,753,581,411,170,Delbonis F.,131,340,152,188,2022-02-08,Buenos Aires,Argentina Open,Clay,2.62,1.5,0
Ramos-Vinolas A.,82,437,204,233,Monteiro T.,121,171,69,102,2022-02-08,Buenos Aires,Argentina Open,Clay,1.8,2.0,0
Gerasimov E.,150,93,43,50,Auger-Aliassime F.,12,268,163,105,2022-02-09,Rotterdam,ABN AMRO World Tennis Tournament,Hard,4.33,1.22,0
Khachanov K.,11,378,217,161,Norrie C.,13,287,172,115,2022-02-09,Rotterdam,ABN AMRO World Tennis Tournament,Hard,1.9,1.9,0
Fucsovics M.,67,249,121,128,Krajinovic F.,93,240,115,125,2022-02-09,Rotterdam,ABN AMRO World Tennis Tournament,Hard,2.1,1.72,1
Harris L.,186,129,59,70,Ivashka I.,113,159,78,81,2022-02-09,Rotterdam,ABN AMRO World Tennis Tournament,Hard,1.72,2.1,0
Hurkacz H.,17,238,137,101,Musetti L.,18,143,79,64,2022-02-09,Rotterdam,ABN AMRO World Tennis Tournament,Hard,1.28,3.75,0
Ruud C.,4,275,176,99,Carballes Baena R.,64,207,91,116,2022-02-09,Buenos Aires,Argentina Open,Clay,1.16,5.0,1
Kwon S.W.,68,108,53,55,Gaston H.,109,58,24,34,2022-02-09,Rotterdam,ABN AMRO World Tennis Tournament,Hard,1.36,3.2,1
Broady L.,125,47,18,29,Giron M.,69,150,68,82,2022-02-09,Dallas,Dallas Open,Hard,2.2,1.66,0
Nakashima B.,70,106,57,49,Thompson J.,71,221,96,125,2022-02-09,Dallas,Dallas Open,Hard,1.33,3.4,0
Mcdonald M.,60,190,87,103,De Minaur A.,19,272,161,111,2022-02-09,Rotterdam,ABN AMRO World Tennis Tournament,Hard,3.0,1.4,0
Nishioka Y.,31,215,99,116,Krueger M.,228,24,7,17,2022-02-09,Dallas,Dallas Open,Hard,1.57,2.37,1
Pospisil V.,99,280,122,158,Chakravarthi C.,0,1,0,1,2022-02-09,Dallas,Dallas Open,Hard,1.02,17.0,1
Verdasco F.,244,962,537,425,Monteiro T.,121,171,69,102,2022-02-09,Buenos Aires,Argentina Open,Clay,3.0,1.4,1
Coria F.,108,99,43,56,Lajovic D.,66,378,163,215,2022-02-09,Buenos Aires,Argentina Open,Clay,1.8,2.0,1
Bublik A.,25,219,110,109,Murray A.,44,932,687,245,2022-02-09,Rotterdam,ABN AMRO World Tennis Tournament,Hard,2.2,1.66,0
Altmaier D.,51,79,28,51,Seppi A.,141,758,363,395,2022-02-09,Dallas,Dallas Open,Hard,1.8,2.0,0
Johnson S.,197,395,196,199,Mannarino A.,27,567,264,303,2022-02-09,Dallas,Dallas Open,Hard,2.1,1.72,0
Sonego L.,43,221,107,114,Baez S.,72,95,47,48,2022-02-10,Buenos Aires,Argentina Open,Clay,1.9,1.9,1
Ivashka I.,113,159,78,81,Tsitsipas S.,5,390,264,126,2022-02-10,Rotterdam,ABN AMRO World Tennis Tournament,Hard,4.0,1.25,0
Auger-Aliassime F.,12,268,163,105,Murray A.,44,932,687,245,2022-02-10,Rotterdam,ABN AMRO World Tennis Tournament,Hard,1.4,3.0,1
Rublev A.,7,392,255,137,Kwon S.W.,68,108,53,55,2022-02-10,Rotterdam,ABN AMRO World Tennis Tournament,Hard,1.22,4.33,1
Lehecka J.,33,61,30,31,Van De Zandschulp B.,44,117,63,54,2022-02-10,Rotterdam,ABN AMRO World Tennis Tournament,Hard,3.0,1.4,1
Seppi A.,141,758,363,395,Brooksby J.,39,79,46,33,2022-02-10,Dallas,Dallas Open,Hard,4.5,1.2,0
Pospisil V.,99,280,122,158,Rodionov J.,118,26,9,17,2022-02-10,Dallas,Dallas Open,Hard,1.4,3.0,1
Isner J.,114,755,465,290,Anderson K.,652,598,347,251,2022-02-10,Dallas,Dallas Open,Hard,1.72,2.1,1
Fognini F.,128,742,383,359,Martinez P.,135,118,50,68,2022-02-10,Buenos Aires,Argentina Open,Clay,2.62,1.5,1
Andujar P.,323,404,164,240,Delbonis F.,131,340,152,188,2022-02-10,Buenos Aires,Argentina Open,Clay,1.8,2.0,0
Cerundolo F.,21,104,58,46,Kecmanovic M.,40,210,107,103,2022-02-10,Buenos Aires,Argentina Open,Clay,2.0,1.8,1
Griekspoor T.,37,97,47,50,Fucsovics M.,67,249,121,128,2022-02-10,Rotterdam,ABN AMRO World Tennis Tournament,Hard,1.8,2.0,0
Fritz T.,9,356,205,151,Sock J.,166,324,177,147,2022-02-10,Dallas,Dallas Open,Hard,1.3,3.5,1
Rublev A.,7,392,255,137,Fucsovics M.,67,249,121,128,2022-02-11,Rotterdam,ABN AMRO World Tennis Tournament,Hard,1.25,4.0,1
Giron M.,69,150,68,82,Fritz T.,9,356,205,151,2022-02-11,Dallas,Dallas Open,Hard,4.33,1.22,1
Thompson J.,71,221,96,125,Brooksby J.,39,79,46,33,2022-02-11,Dallas,Dallas Open,Hard,3.2,1.36,0
Mannarino A.,27,567,264,303,Nishioka Y.,31,215,99,116,2022-02-11,Dallas,Dallas Open,Hard,1.53,2.5,1
Stebe C.M.,231,76,28,48,Opelka R.,17,168,88,80,2022-02-11,Dallas,Dallas Open,Hard,4.0,1.25,0
Schwartzman D.,95,428,233,195,Munar J.,104,178,75,103,2022-02-11,Buenos Aires,Argentina Open,Clay,1.3,3.5,1
Fognini F.,128,742,383,359,Delbonis F.,131,340,152,188,2022-02-11,Buenos Aires,Argentina Open,Clay,1.9,1.9,0
Coria F.,108,99,43,56,Ruud C.,4,275,176,99,2022-02-11,Buenos Aires,Argentina Open,Clay,4.5,1.2,0
Sonego L.,43,221,107,114,Verdasco F.,244,962,537,425,2022-02-11,Buenos Aires,Argentina Open,Clay,1.28,3.75,1
Norrie C.,13,287,172,115,Auger-Aliassime F.,12,268,163,105,2022-02-11,Rotterdam,ABN AMRO World Tennis Tournament,Hard,2.62,1.5,0
Lehecka J.,33,61,30,31,Musetti L.,18,143,79,64,2022-02-11,Rotterdam,ABN AMRO World Tennis Tournament,Hard,2.1,1.72,1
Tsitsipas S.,5,390,264,126,De Minaur A.,19,272,161,111,2022-02-11,Rotterdam,ABN AMRO World Tennis Tournament,Hard,1.28,3.75,1
Tsitsipas S.,5,390,264,126,Lehecka J.,33,61,30,31,2022-02-12,Rotterdam,ABN AMRO World Tennis Tournament,Hard,1.12,6.0,1
Auger-Aliassime F.,12,268,163,105,Rublev A.,7,392,255,137,2022-02-12,Rotterdam,ABN AMRO World Tennis Tournament,Hard,2.1,1.72,1
Schwartzman D.,95,428,233,195,Sonego L.,43,221,107,114,2022-02-12,Buenos Aires,Argentina Open,Clay,1.53,2.5,1
Isner J.,114,755,465,290,Opelka R.,17,168,88,80,2022-02-12,Dallas,Dallas Open,Hard,2.2,1.66,0
Opelka R.,17,168,88,80,Mannarino A.,27,567,264,303,2022-02-12,Dallas,Dallas Open,Hard,1.61,2.3,1
Pospisil V.,99,280,122,158,Isner J.,114,755,465,290,2022-02-12,Dallas,Dallas Open,Hard,2.3,1.61,0
Ruud C.,4,275,176,99,Delbonis F.,131,340,152,188,2022-02-12,Buenos Aires,Argentina Open,Clay,1.16,5.0,1
Schwartzman D.,95,428,233,195,Cerundolo F.,21,104,58,46,2022-02-12,Buenos Aires,Argentina Open,Clay,1.3,3.5,1
Giron M.,69,150,68,82,Brooksby J.,39,79,46,33,2022-02-13,Dallas,Dallas Open,Hard,2.75,1.44,0
Ruud C.,4,275,176,99,Schwartzman D.,95,428,233,195,2022-02-13,Buenos Aires,Argentina Open,Clay,1.44,2.75,1
Opelka R.,17,168,88,80,Brooksby J.,39,79,46,33,2022-02-13,Dallas,Dallas Open,Hard,1.8,2.0,1
Tsitsipas S.,5,390,264,126,Auger-Aliassime F.,12,268,163,105,2022-02-13,Rotterdam,ABN AMRO World Tennis Tournament,Hard,1.8,2.0,0
Gombos N.,114,66,21,45,Ivashka I.,113,159,78,81,2022-02-14,Marseille,Open 13,Hard,3.75,1.28,0
Ymer M.,59,130,58,72,Gasquet R.,48,948,581,367,2022-02-14,Marseille,Open 13,Hard,1.66,2.2,0
Travaglia S.,1024,81,27,54,Laaksonen H.,125,101,37,64,2022-02-14,Marseille,Open 13,Hard,2.3,1.61,1
Khachanov K.,11,378,217,161,Mcdonald M.,60,190,87,103,2022-02-14,Doha,Qatar Exxon Mobil Open,Hard,1.5,2.62,1
Kwon S.W.,68,108,53,55,Eubanks C.,29,64,28,36,2022-02-14,Doha,Qatar Exxon Mobil Open,Hard,1.4,3.0,1
Fabbiano T.,192,89,27,62,Van De Zandschulp B.,44,117,63,54,2022-02-14,Doha,Qatar Exxon Mobil Open,Hard,5.0,1.16,0
Martinez P.,135,118,50,68,Shang J.,149,12,4,8,2022-02-14,Rio de Janeiro,Rio Open,Clay,1.1,7.0,1
Gerasimov E.,150,93,43,50,Evans D.,30,251,124,127,2022-02-14,Doha,Qatar Exxon Mobil Open,Hard,2.75,1.44,0
O Connell C.,74,65,26,39,Molcan A.,120,86,45,41,2022-02-14,Doha,Qatar Exxon Mobil Open,Hard,1.66,2.2,0
Munar J.,104,178,75,103,Alcaraz C.,1,164,130,34,2022-02-14,Rio de Janeiro,Rio Open,Clay,3.75,1.28,0
Andujar P.,323,404,164,240,Cuevas P.,149,421,210,211,2022-02-14,Rio de Janeiro,Rio Open,Clay,1.44,2.75,1
Nishioka Y.,31,215,99,116,Otte O.,233,78,33,45,2022-02-14,Delray Beach,Delray Beach Open,Hard,1.8,2.0,0
Cressy M.,96,96,42,54,Millman J.,140,256,113,143,2022-02-14,Delray Beach,Delray Beach Open,Hard,1.5,2.62,0
Seppi A.,141,758,363,395,Gojowczyk P.,108,172,75,97,2022-02-14,Delray Beach,Delray Beach Open,Hard,1.53,2.5,1
Nakashima B.,70,106,57,49,Kudla D.,137,198,70,128,2022-02-14,Delray Beach,Delray Beach Open,Hard,1.25,4.0,1
Coria F.,108,99,43,56,Garin C.,101,190,103,87,2022-02-15,Rio de Janeiro,Rio Open,Clay,2.5,1.53,1
Djere L.,38,243,120,123,Sonego L.,43,221,107,114,2022-02-15,Rio de Janeiro,Rio Open,Clay,2.5,1.53,0
Fucsovics M.,67,249,121,128,Harris L.,186,129,59,70,2022-02-15,Doha,Qatar Exxon Mobil Open,Hard,1.72,2.1,1
Daniel T.,111,178,67,111,Murray A.,44,932,687,245,2022-02-15,Doha,Qatar Exxon Mobil Open,Hard,3.2,1.36,0
Goffin D.,123,522,296,226,Ruusuvuori E.,55,158,79,79,2022-02-15,Doha,Qatar Exxon Mobil Open,Hard,3.75,1.28,0
Monteiro T.,121,171,69,102,Baez S.,72,95,47,48,2022-02-15,Rio de Janeiro,Rio Open,Clay,2.2,1.66,1
Kecmanovic M.,40,210,107,103,Meligeni Rodrigues F,224,2,0,2,2022-02-15,Rio de Janeiro,Rio Open,Clay,1.2,4.5,1
Bagnis F.,135,121,39,82,Fognini F.,128,742,383,359,2022-02-15,Rio de Janeiro,Rio Open,Clay,2.5,1.53,0
Popyrin A.,90,140,59,81,Safiullin R.,92,42,20,22,2022-02-15,Marseille,Open 13,Hard,1.66,2.2,0
Bergs Z.,175,15,4,11,Rune H.,6,131,83,48,2022-02-15,Marseille,Open 13,Hard,2.62,1.5,0
Machac T.,108,18,6,12,Dzumhur D.,202,234,107,127,2022-02-15,Marseille,Open 13,Hard,1.53,2.5,1
Kukushkin M.,221,352,141,211,Herbert P.H.,157,202,89,113,2022-02-15,Marseille,Open 13,Hard,2.62,1.5,0
Tsonga J.W.,297,672,444,228,Simon G.,188,869,491,378,2022-02-15,Marseille,Open 13,Hard,1.61,2.3,1
Novak D.,166,58,15,43,Albot R.,97,215,86,129,2022-02-15,Marseille,Open 13,Hard,2.2,1.66,0
Moutet C.,80,118,50,68,Gaston H.,109,58,24,34,2022-02-15,Marseille,Open 13,Hard,1.4,3.0,0
Verdasco F.,244,962,537,425,Lajovic D.,66,378,163,215,2022-02-15,Rio de Janeiro,Rio Open,Clay,2.2,1.66,1
Jaziri M.,444,217,83,134,Davidovich Fokina A.,39,168,84,84,2022-02-15,Doha,Qatar Exxon Mobil Open,Hard,13.0,1.04,0
Londero J.I.,142,83,34,49,Ramos-Vinolas A.,82,437,204,233,2022-02-15,Rio de Janeiro,Rio Open,Clay,2.3,1.61,0
Rinderknech A.,67,96,46,50,Vesely J.,528,288,130,158,2022-02-15,Doha,Qatar Exxon Mobil Open,Hard,1.5,2.62,1
Delbonis F.,131,340,152,188,Galan D.E.,76,78,33,45,2022-02-15,Rio de Janeiro,Rio Open,Clay,1.66,2.2,1
Sousa J.,147,436,189,247,Ymer E.,186,81,24,57,2022-02-15,Doha,Qatar Exxon Mobil Open,Hard,,,0
Kovalik J.,172,68,24,44,Bublik A.,25,219,110,109,2022-02-15,Doha,Qatar Exxon Mobil Open,Hard,5.5,1.14,0
Anderson K.,652,598,347,251,Johnson S.,197,395,196,199,2022-02-15,Delray Beach,Delray Beach Open,Hard,1.61,2.3,0
Broady L.,125,47,18,29,Mannarino A.,27,567,264,303,2022-02-15,Delray Beach,Delray Beach Open,Hard,2.5,1.53,0
Thompson J.,71,221,96,125,Krueger M.,228,24,7,17,2022-02-15,Delray Beach,Delray Beach Open,Hard,1.53,2.5,0
Querrey S.,287,678,369,309,Istomin D.,267,440,194,246,2022-02-15,Delray Beach,Delray Beach Open,Hard,1.57,2.37,0
Sandgren T.,153,121,47,74,Giron M.,69,150,68,82,2022-02-15,Delray Beach,Delray Beach Open,Hard,3.0,1.4,0
Kozlov S.,108,35,9,26,Gomez E.,155,26,7,19,2022-02-15,Delray Beach,Delray Beach Open,Hard,1.66,2.2,1
Korda S.,26,126,75,51,Kokkinakis T.,86,124,55,69,2022-02-15,Delray Beach,Delray Beach Open,Hard,1.53,2.5,1
Evans D.,30,251,124,127,Davidovich Fokina A.,39,168,84,84,2022-02-16,Doha,Qatar Exxon Mobil Open,Hard,1.57,2.37,0
Karatsev A.,75,136,66,70,Rune H.,6,131,83,48,2022-02-16,Marseille,Open 13,Hard,1.44,2.75,1
Pouille L.,675,259,134,125,Griekspoor T.,37,97,47,50,2022-02-16,Marseille,Open 13,Hard,3.75,1.28,1
Bonzi B.,107,83,37,46,Majchrzak K.,121,50,19,31,2022-02-16,Marseille,Open 13,Hard,1.9,1.9,1
Paul T.,14,204,111,93,Istomin D.,267,440,194,246,2022-02-16,Delray Beach,Delray Beach Open,Hard,1.14,5.5,1
Kozlov S.,108,35,9,26,Johnson S.,197,395,196,199,2022-02-16,Delray Beach,Delray Beach Open,Hard,2.37,1.57,1
Sock J.,166,324,177,147,Altmaier D.,51,79,28,51,2022-02-16,Delray Beach,Delray Beach Open,Hard,1.72,2.1,1
Gasquet R.,48,948,581,367,Rublev A.,7,392,255,137,2022-02-16,Marseille,Open 13,Hard,6.0,1.12,0
Fucsovics M.,67,249,121,128,Kwon S.W.,68,108,53,55,2022-02-16,Doha,Qatar Exxon Mobil Open,Hard,1.61,2.3,1
Rinderknech A.,67,96,46,50,Bublik A.,25,219,110,109,2022-02-16,Doha,Qatar Exxon Mobil Open,Hard,2.3,1.61,1
Van De Zandschulp B.,44,117,63,54,Cilic M.,100,853,543,310,2022-02-16,Doha,Qatar Exxon Mobil Open,Hard,2.2,1.66,0
Basilashvili N.,118,301,138,163,Ymer E.,186,81,24,57,2022-02-16,Doha,Qatar Exxon Mobil Open,Hard,1.61,2.3,1
Paire B.,149,527,237,290,Cerundolo F.,21,104,58,46,2022-02-16,Rio de Janeiro,Rio Open,Clay,2.75,1.44,0
Coria F.,108,99,43,56,Verdasco F.,244,962,537,425,2022-02-16,Rio de Janeiro,Rio Open,Clay,1.44,2.75,1
Andujar P.,323,404,164,240,Ramos-Vinolas A.,82,437,204,233,2022-02-16,Rio de Janeiro,Rio Open,Clay,2.75,1.44,1
Carreno Busta P.,16,352,214,138,Fognini F.,128,742,383,359,2022-02-16,Rio de Janeiro,Rio Open,Clay,1.4,3.0,0
Ruusuvuori E.,55,158,79,79,Khachanov K.,11,378,217,161,2022-02-16,Doha,Qatar Exxon Mobil Open,Hard,2.5,1.53,0
Bautista Agut R.,25,379,234,145,Murray A.,44,932,687,245,2022-02-16,Doha,Qatar Exxon Mobil Open,Hard,1.66,2.2,1
Molcan A.,120,86,45,41,Shapovalov D.,29,298,166,132,2022-02-16,Doha,Qatar Exxon Mobil Open,Hard,4.33,1.22,0
Travaglia S.,1024,81,27,54,Ivashka I.,113,159,78,81,2022-02-16,Marseille,Open 13,Hard,3.4,1.33,0
Kecmanovic M.,40,210,107,103,Sonego L.,43,221,107,114,2022-02-17,Rio de Janeiro,Rio Open,Clay,2.62,1.5,1
Albot R.,97,215,86,129,Pouille L.,675,259,134,125,2022-02-17,Marseille,Open 13,Hard,1.8,2.0,0
Gaston H.,109,58,24,34,Tsitsipas S.,5,390,264,126,2022-02-17,Marseille,Open 13,Hard,5.5,1.14,0
Tsonga J.W.,297,672,444,228,Auger-Aliassime F.,12,268,163,105,2022-02-17,Marseille,Open 13,Hard,5.0,1.16,0
Schwartzman D.,95,428,233,195,Martinez P.,135,118,50,68,2022-02-17,Rio de Janeiro,Rio Open,Clay,1.44,2.75,1
Machac T.,108,18,6,12,Safiullin R.,92,42,20,22,2022-02-17,Marseille,Open 13,Hard,1.61,2.3,0
Korda S.,26,126,75,51,Seppi A.,141,758,363,395,2022-02-17,Delray Beach,Delray Beach Open,Hard,1.16,5.0,1
Shapovalov D.,29,298,166,132,Rinderknech A.,67,96,46,50,2022-02-17,Doha,Qatar Exxon Mobil Open,Hard,1.33,3.4,0
Basilashvili N.,118,301,138,163,Fucsovics M.,67,249,121,128,2022-02-17,Doha,Qatar Exxon Mobil Open,Hard,2.3,1.61,1
Bautista Agut R.,25,379,234,145,Davidovich Fokina A.,39,168,84,84,2022-02-17,Doha,Qatar Exxon Mobil Open,Hard,1.36,3.2,1
Khachanov K.,11,378,217,161,Cilic M.,100,853,543,310,2022-02-17,Doha,Qatar Exxon Mobil Open,Hard,1.66,2.2,1
Bonzi B.,107,83,37,46,Herbert P.H.,157,202,89,113,2022-02-17,Marseille,Open 13,Hard,1.8,2.0,1
Nakashima B.,70,106,57,49,Mannarino A.,27,567,264,303,2022-02-17,Delray Beach,Delray Beach Open,Hard,1.57,2.37,0
Carballes Baena R.,64,207,91,116,Cerundolo F.,21,104,58,46,2022-02-17,Rio de Janeiro,Rio Open,Clay,,,0
Otte O.,233,78,33,45,Norrie C.,13,287,172,115,2022-02-17,Delray Beach,Delray Beach Open,Hard,4.0,1.25,0
Giron M.,69,150,68,82,Millman J.,140,256,113,143,2022-02-17,Delray Beach,Delray Beach Open,Hard,1.53,2.5,0
Sock J.,166,324,177,147,Opelka R.,17,168,88,80,2022-02-17,Delray Beach,Delray Beach Open,Hard,3.4,1.33,0
Kozlov S.,108,35,9,26,Paul T.,14,204,111,93,2022-02-18,Delray Beach,Delray Beach Open,Hard,3.2,1.36,0
Tsitsipas S.,5,390,264,126,Safiullin R.,92,42,20,22,2022-02-18,Marseille,Open 13,Hard,1.12,6.0,0
Dimitrov G.,20,651,389,262,Krueger M.,228,24,7,17,2022-02-18,Delray Beach,Delray Beach Open,Hard,1.33,3.4,1
Rublev A.,7,392,255,137,Pouille L.,675,259,134,125,2022-02-18,Marseille,Open 13,Hard,1.12,6.0,1
Delbonis F.,131,340,152,188,Alcaraz C.,1,164,130,34,2022-02-18,Rio de Janeiro,Rio Open,Clay,4.33,1.22,0
Korda S.,26,126,75,51,Norrie C.,13,287,172,115,2022-02-18,Delray Beach,Delray Beach Open,Hard,1.9,1.9,0
Opelka R.,17,168,88,80,Mannarino A.,27,567,264,303,2022-02-18,Delray Beach,Delray Beach Open,Hard,1.44,2.75,1
Auger-Aliassime F.,12,268,163,105,Ivashka I.,113,159,78,81,2022-02-18,Marseille,Open 13,Hard,1.25,4.0,1
Khachanov K.,11,378,217,161,Bautista Agut R.,25,379,234,145,2022-02-18,Doha,Qatar Exxon Mobil Open,Hard,2.5,1.53,0
Berrettini M.,38,217,142,75,Monteiro T.,121,171,69,102,2022-02-18,Rio de Janeiro,Rio Open,Clay,1.33,3.4,1
Rinderknech A.,67,96,46,50,Basilashvili N.,118,301,138,163,2022-02-18,Doha,Qatar Exxon Mobil Open,Hard,1.8,2.0,0
Bonzi B.,107,83,37,46,Karatsev A.,75,136,66,70,2022-02-18,Marseille,Open 13,Hard,2.37,1.57,1
Fognini F.,128,742,383,359,Coria F.,108,99,43,56,2022-02-19,Rio de Janeiro,Rio Open,Clay,1.53,2.5,1
Cerundolo F.,21,104,58,46,Kecmanovic M.,40,210,107,103,2022-02-19,Rio de Janeiro,Rio Open,Clay,2.1,1.72,1
Andujar P.,323,404,164,240,Schwartzman D.,95,428,233,195,2022-02-19,Rio de Janeiro,Rio Open,Clay,4.5,1.2,0
Schwartzman D.,95,428,233,195,Cerundolo F.,21,104,58,46,2022-02-19,Rio de Janeiro,Rio Open,Clay,1.44,2.75,1
Berrettini M.,38,217,142,75,Alcaraz C.,1,164,130,34,2022-02-19,Rio de Janeiro,Rio Open,Clay,2.3,1.61,0
Paul T.,14,204,111,93,Norrie C.,13,287,172,115,2022-02-19,Delray Beach,Delray Beach Open,Hard,2.3,1.61,0
Safiullin R.,92,42,20,22,Auger-Aliassime F.,12,268,163,105,2022-02-19,Marseille,Open 13,Hard,5.0,1.16,0
Bonzi B.,107,83,37,46,Rublev A.,7,392,255,137,2022-02-19,Marseille,Open 13,Hard,3.5,1.3,0
Millman J.,140,256,113,143,Dimitrov G.,20,651,389,262,2022-02-19,Delray Beach,Delray Beach Open,Hard,2.5,1.53,1
Bautista Agut R.,25,379,234,145,Basilashvili N.,118,301,138,163,2022-02-19,Doha,Qatar Exxon Mobil Open,Hard,1.5,2.62,1
Millman J.,140,256,113,143,Opelka R.,17,168,88,80,2022-02-20,Delray Beach,Delray Beach Open,Hard,2.75,1.44,0
Rublev A.,7,392,255,137,Auger-Aliassime F.,12,268,163,105,2022-02-20,Marseille,Open 13,Hard,2.37,1.57,1
Fognini F.,128,742,383,359,Alcaraz C.,1,164,130,34,2022-02-20,Rio de Janeiro,Rio Open,Clay,3.75,1.28,0
Schwartzman D.,95,428,233,195,Alcaraz C.,1,164,130,34,2022-02-20,Rio de Janeiro,Rio Open,Clay,3.4,1.33,0
Norrie C.,13,287,172,115,Opelka R.,17,168,88,80,2022-02-20,Delray Beach,Delray Beach Open,Hard,1.66,2.2,1
Goffin D.,123,522,296,226,Daniel T.,111,178,67,111,2022-02-21,Dubai ,Dubai Tennis Championships,Hard,1.9,1.9,0
O Connell C.,74,65,26,39,Murray A.,44,932,687,245,2022-02-21,Dubai ,Dubai Tennis Championships,Hard,2.75,1.44,0
Djokovic N.,2,1207,1012,195,Musetti L.,18,143,79,64,2022-02-21,Dubai ,Dubai Tennis Championships,Hard,1.06,10.0,1
Londero J.I.,142,83,34,49,Etcheverry T.,34,60,26,34,2022-02-21,Santiago,Chile Open,Clay,1.57,2.37,1
Bagnis F.,135,121,39,82,Zapata Miralles B.,54,80,32,48,2022-02-21,Santiago,Chile Open,Clay,1.66,2.2,1
Seyboth Wild T.,117,28,12,16,Kicker N.,203,47,19,28,2022-02-21,Santiago,Chile Open,Clay,1.66,2.2,1
Vesely J.,528,288,130,158,Cilic M.,100,853,543,310,2022-02-21,Dubai ,Dubai Tennis Championships,Hard,3.75,1.28,1
Jaziri M.,444,217,83,134,Krajinovic F.,93,240,115,125,2022-02-21,Dubai ,Dubai Tennis Championships,Hard,11.0,1.05,0
Hanfmann Y.,50,99,50,49,Coria F.,108,99,43,56,2022-02-22,Santiago,Chile Open,Clay,2.2,1.66,1
Lama G.,410,4,0,4,Dellien H.,164,70,22,48,2022-02-22,Santiago,Chile Open,Clay,3.0,1.4,0
De Minaur A.,19,272,161,111,Khachanov K.,11,378,217,161,2022-02-22,Dubai ,Dubai Tennis Championships,Hard,2.2,1.66,0
Mcdonald M.,60,190,87,103,Karatsev A.,75,136,66,70,2022-02-22,Dubai ,Dubai Tennis Championships,Hard,2.2,1.66,1
Harris L.,186,129,59,70,Molcan A.,120,86,45,41,2022-02-22,Dubai ,Dubai Tennis Championships,Hard,1.57,2.37,0
Ivashka I.,113,159,78,81,Kwon S.W.,68,108,53,55,2022-02-22,Dubai ,Dubai Tennis Championships,Hard,1.61,2.3,0
Sinner J.,8,224,153,71,Davidovich Fokina A.,39,168,84,84,2022-02-22,Dubai ,Dubai Tennis Championships,Hard,1.3,3.5,1
Kecmanovic M.,40,210,107,103,Cecchinato M.,108,204,79,125,2022-02-22,Santiago,Chile Open,Clay,1.2,4.5,1
Varillas J.P.,77,22,10,12,Baez S.,72,95,47,48,2022-02-22,Santiago,Chile Open,Clay,2.5,1.53,0
Basilashvili N.,118,301,138,163,Popyrin A.,90,140,59,81,2022-02-22,Dubai ,Dubai Tennis Championships,Hard,1.72,2.1,0
Evans D.,30,251,124,127,Rublev A.,7,392,255,137,2022-02-22,Dubai ,Dubai Tennis Championships,Hard,2.37,1.57,0
Rinderknech A.,67,96,46,50,Bautista Agut R.,25,379,234,145,2022-02-22,Dubai ,Dubai Tennis Championships,Hard,2.75,1.44,0
Fucsovics M.,67,249,121,128,Shapovalov D.,29,298,166,132,2022-02-22,Dubai ,Dubai Tennis Championships,Hard,2.37,1.57,0
Taberner C.,181,37,13,24,Cerundolo J.M.,106,29,12,17,2022-02-22,Santiago,Chile Open,Clay,1.61,2.3,1
Galan D.E.,76,78,33,45,Munar J.,104,178,75,103,2022-02-22,Santiago,Chile Open,Clay,2.1,1.72,0
Pucinelli de Almeida M.,264,2,1,1,Rune H.,6,131,83,48,2022-02-22,Santiago,Chile Open,Clay,3.0,1.4,1
Monteiro T.,121,171,69,102,Jarry N.,28,141,73,68,2022-02-22,Santiago,Chile Open,Clay,1.8,2.0,1
Hurkacz H.,17,238,137,101,Bublik A.,25,219,110,109,2022-02-22,Dubai ,Dubai Tennis Championships,Hard,1.5,2.62,1
Berankis R.,212,249,104,145,Struff J.L.,21,369,170,199,2022-02-22,Dubai ,Dubai Tennis Championships,Hard,2.2,1.66,1
Mannarino A.,27,567,264,303,Fritz T.,9,356,205,151,2022-02-22,Acapulco,Abierto Mexicano,Hard,3.5,1.3,0
Verdasco F.,244,962,537,425,Isner J.,114,755,465,290,2022-02-22,Acapulco,Abierto Mexicano,Hard,3.5,1.3,0
Gojowczyk P.,108,172,75,97,Nakashima B.,70,106,57,49,2022-02-22,Acapulco,Abierto Mexicano,Hard,7.0,1.1,1
Lajovic D.,66,378,163,215,Korda S.,26,126,75,51,2022-02-22,Acapulco,Abierto Mexicano,Hard,4.5,1.2,1
Dimitrov G.,20,651,389,262,Kozlov S.,108,35,9,26,2022-02-22,Acapulco,Abierto Mexicano,Hard,1.28,3.75,0
Carreno Busta P.,16,352,214,138,Otte O.,233,78,33,45,2022-02-22,Acapulco,Abierto Mexicano,Hard,1.36,3.2,1
Zverev A.,19,500,346,154,Brooksby J.,39,79,46,33,2022-02-22,Acapulco,Abierto Mexicano,Hard,1.2,4.5,1
Berankis R.,212,249,104,145,Popyrin A.,90,140,59,81,2022-02-23,Dubai ,Dubai Tennis Championships,Hard,2.5,1.53,1
Rublev A.,7,392,255,137,Kwon S.W.,68,108,53,55,2022-02-23,Dubai ,Dubai Tennis Championships,Hard,1.2,4.5,1
Khachanov K.,11,378,217,161,Djokovic N.,2,1207,1012,195,2022-02-23,Dubai ,Dubai Tennis Championships,Hard,6.0,1.12,0
Bautista Agut R.,25,379,234,145,Vesely J.,528,288,130,158,2022-02-23,Dubai ,Dubai Tennis Championships,Hard,1.16,5.0,0
Shapovalov D.,29,298,166,132,Daniel T.,111,178,67,111,2022-02-23,Dubai ,Dubai Tennis Championships,Hard,1.28,3.75,1
Monteiro T.,121,171,69,102,Delbonis F.,131,340,152,188,2022-02-23,Santiago,Chile Open,Clay,2.1,1.72,1
Paul T.,14,204,111,93,Berrettini M.,38,217,142,75,2022-02-23,Acapulco,Abierto Mexicano,Hard,3.4,1.33,1
Medvedev D.,3,406,289,117,Paire B.,149,527,237,290,2022-02-23,Acapulco,Abierto Mexicano,Hard,1.06,10.0,1
Lopez F.,634,863,441,422,Nishioka Y.,31,215,99,116,2022-02-23,Acapulco,Abierto Mexicano,Hard,3.5,1.3,0
Mcdonald M.,60,190,87,103,Krajinovic F.,93,240,115,125,2022-02-23,Dubai ,Dubai Tennis Championships,Hard,1.53,2.5,1
Londero J.I.,142,83,34,49,Baez S.,72,95,47,48,2022-02-23,Santiago,Chile Open,Clay,3.0,1.4,0
Olivo R.,179,55,23,32,Tabilo A.,122,44,21,23,2022-02-23,Santiago,Chile Open,Clay,4.5,1.2,0
Millman J.,140,256,113,143,Giron M.,69,150,68,82,2022-02-23,Acapulco,Abierto Mexicano,Hard,2.0,1.8,0
Sinner J.,8,224,153,71,Murray A.,44,932,687,245,2022-02-23,Dubai ,Dubai Tennis Championships,Hard,1.3,3.5,1
Dellien H.,164,70,22,48,Bagnis F.,135,121,39,82,2022-02-23,Santiago,Chile Open,Clay,2.1,1.72,0
Norrie C.,13,287,172,115,Altmaier D.,51,79,28,51,2022-02-23,Acapulco,Abierto Mexicano,Hard,1.16,5.0,1
Nadal R.,2,1223,1017,206,Kudla D.,137,198,70,128,2022-02-23,Acapulco,Abierto Mexicano,Hard,1.03,15.0,1
Andujar P.,323,404,164,240,Hernandez A.,521,5,1,4,2022-02-23,Acapulco,Abierto Mexicano,Hard,1.12,6.0,1
Wolf J.J.,45,75,39,36,Sonego L.,43,221,107,114,2022-02-23,Acapulco,Abierto Mexicano,Hard,2.75,1.44,1
Djere L.,38,243,120,123,Tsitsipas S.,5,390,264,126,2022-02-23,Acapulco,Abierto Mexicano,Hard,8.0,1.08,0
Molcan A.,120,86,45,41,Hurkacz H.,17,238,137,101,2022-02-23,Dubai ,Dubai Tennis Championships,Hard,4.33,1.22,0
Pucinelli de Almeida M.,264,2,1,1,Kecmanovic M.,40,210,107,103,2022-02-24,Santiago,Chile Open,Clay,4.5,1.2,0
Hanfmann Y.,50,99,50,49,Seyboth Wild T.,117,28,12,16,2022-02-24,Santiago,Chile Open,Clay,1.44,2.75,1
Medvedev D.,3,406,289,117,Nishioka Y.,31,215,99,116,2022-02-24,Acapulco,Abierto Mexicano,Hard,1.06,10.0,1
Wolf J.J.,45,75,39,36,Tsitsipas S.,5,390,264,126,2022-02-24,Acapulco,Abierto Mexicano,Hard,5.5,1.14,0
Zverev A.,19,500,346,154,Gojowczyk P.,108,172,75,97,2022-02-24,Acapulco,Abierto Mexicano,Hard,1.06,10.0,0
Fritz T.,9,356,205,151,Nishioka Y.,31,215,99,116,2022-02-24,Acapulco,Abierto Mexicano,Hard,1.2,4.5,0
Kozlov S.,108,35,9,26,Nadal R.,2,1223,1017,206,2022-02-24,Acapulco,Abierto Mexicano,Hard,26.0,1.01,0
Lajovic D.,66,378,163,215,Paul T.,14,204,111,93,2022-02-24,Acapulco,Abierto Mexicano,Hard,3.5,1.3,0
Norrie C.,13,287,172,115,Isner J.,114,755,465,290,2022-02-24,Acapulco,Abierto Mexicano,Hard,1.4,3.0,1
Giron M.,69,150,68,82,Carreno Busta P.,16,352,214,138,2022-02-24,Acapulco,Abierto Mexicano,Hard,3.4,1.33,1
Taberner C.,181,37,13,24,Ramos-Vinolas A.,82,437,204,233,2022-02-24,Santiago,Chile Open,Clay,2.75,1.44,0
Munar J.,104,178,75,103,Martinez P.,135,118,50,68,2022-02-24,Santiago,Chile Open,Clay,1.61,2.3,0
Shapovalov D.,29,298,166,132,Berankis R.,212,249,104,145,2022-02-24,Dubai ,Dubai Tennis Championships,Hard,1.2,4.5,1
Djokovic N.,2,1207,1012,195,Vesely J.,528,288,130,158,2022-02-24,Dubai ,Dubai Tennis Championships,Hard,1.05,11.0,0
Sinner J.,8,224,153,71,Hurkacz H.,17,238,137,101,2022-02-24,Dubai ,Dubai Tennis Championships,Hard,1.53,2.5,0
Mcdonald M.,60,190,87,103,Rublev A.,7,392,255,137,2022-02-24,Dubai ,Dubai Tennis Championships,Hard,3.75,1.28,0
Andujar P.,323,404,164,240,Medvedev D.,3,406,289,117,2022-02-24,Acapulco,Abierto Mexicano,Hard,17.0,1.02,0
Hanfmann Y.,50,99,50,49,Martinez P.,135,118,50,68,2022-02-25,Santiago,Chile Open,Clay,2.1,1.72,0
Ramos-Vinolas A.,82,437,204,233,Bagnis F.,135,121,39,82,2022-02-25,Santiago,Chile Open,Clay,1.61,2.3,1
Monteiro T.,121,171,69,102,Baez S.,72,95,47,48,2022-02-25,Santiago,Chile Open,Clay,2.37,1.57,0
Garin C.,101,190,103,87,Tabilo A.,122,44,21,23,2022-02-25,Santiago,Chile Open,Clay,2.3,1.61,0
Tsitsipas S.,5,390,264,126,Giron M.,69,150,68,82,2022-02-25,Acapulco,Abierto Mexicano,Hard,1.22,4.33,1
Vesely J.,528,288,130,158,Shapovalov D.,29,298,166,132,2022-02-25,Dubai ,Dubai Tennis Championships,Hard,2.75,1.44,1
Rublev A.,7,392,255,137,Hurkacz H.,17,238,137,101,2022-02-25,Dubai ,Dubai Tennis Championships,Hard,2.0,1.8,1
Gojowczyk P.,108,172,75,97,Norrie C.,13,287,172,115,2022-02-25,Acapulco,Abierto Mexicano,Hard,7.0,1.1,0
Paul T.,14,204,111,93,Nadal R.,2,1223,1017,206,2022-02-25,Acapulco,Abierto Mexicano,Hard,7.0,1.1,0
Martinez P.,135,118,50,68,Tabilo A.,122,44,21,23,2022-02-26,Santiago,Chile Open,Clay,2.3,1.61,1
Ramos-Vinolas A.,82,437,204,233,Baez S.,72,95,47,48,2022-02-26,Santiago,Chile Open,Clay,1.8,2.0,0
Vesely J.,528,288,130,158,Rublev A.,7,392,255,137,2022-02-26,Dubai ,Dubai Tennis Championships,Hard,3.4,1.33,0
Tabilo A.,122,44,21,23,Kecmanovic M.,40,210,107,103,2022-02-26,Santiago,Chile Open,Clay,1.8,2.0,1
Nadal R.,2,1223,1017,206,Medvedev D.,3,406,289,117,2022-02-26,Acapulco,Abierto Mexicano,Hard,2.2,1.66,1
Norrie C.,13,287,172,115,Tsitsipas S.,5,390,264,126,2022-02-26,Acapulco,Abierto Mexicano,Hard,2.62,1.5,1
Nadal R.,2,1223,1017,206,Norrie C.,13,287,172,115,2022-02-27,Acapulco,Abierto Mexicano,Hard,1.16,5.0,1
Baez S.,72,95,47,48,Martinez P.,135,118,50,68,2022-02-27,Santiago,Chile Open,Clay,1.66,2.2,0
Giron M.,69,150,68,82,Musetti L.,18,143,79,64,2022-03-10,Indian Wells,BNP Paribas Open,Hard,1.61,2.3,0
Eubanks C.,29,64,28,36,Cressy M.,96,96,42,54,2022-03-10,Indian Wells,BNP Paribas Open,Hard,2.5,1.53,1
Cerundolo J.M.,106,29,12,17,Sock J.,166,324,177,147,2022-03-10,Indian Wells,BNP Paribas Open,Hard,3.75,1.28,0
Brooksby J.,39,79,46,33,Carballes Baena R.,64,207,91,116,2022-03-10,Indian Wells,BNP Paribas Open,Hard,1.12,6.0,1
Coric B.,15,343,185,158,Davidovich Fokina A.,39,168,84,84,2022-03-10,Indian Wells,BNP Paribas Open,Hard,4.0,1.25,0
Coria F.,108,99,43,56,Cuevas P.,149,421,210,211,2022-03-10,Indian Wells,BNP Paribas Open,Hard,1.66,2.2,1
Mcdonald M.,60,190,87,103,Fucsovics M.,67,249,121,128,2022-03-10,Indian Wells,BNP Paribas Open,Hard,1.72,2.1,1
Krajinovic F.,93,240,115,125,Lajovic D.,66,378,163,215,2022-03-10,Indian Wells,BNP Paribas Open,Hard,1.57,2.37,1
Andujar P.,323,404,164,240,Fognini F.,128,742,383,359,2022-03-10,Indian Wells,BNP Paribas Open,Hard,3.0,1.4,0
Rinderknech A.,67,96,46,50,Bonzi B.,107,83,37,46,2022-03-10,Indian Wells,BNP Paribas Open,Hard,1.72,2.1,0
Djere L.,38,243,120,123,Kwon S.W.,68,108,53,55,2022-03-10,Indian Wells,BNP Paribas Open,Hard,3.2,1.36,1
Paul T.,14,204,111,93,Kukushkin M.,221,352,141,211,2022-03-11,Indian Wells,BNP Paribas Open,Hard,1.22,4.33,1
Kecmanovic M.,40,210,107,103,Broady L.,125,47,18,29,2022-03-11,Indian Wells,BNP Paribas Open,Hard,1.44,2.75,1
Paire B.,149,527,237,290,Koepfer D.,84,86,38,48,2022-03-11,Indian Wells,BNP Paribas Open,Hard,1.9,1.9,0
Goffin D.,123,522,296,226,Thompson J.,71,221,96,125,2022-03-11,Indian Wells,BNP Paribas Open,Hard,1.57,2.37,0
Murray A.,44,932,687,245,Daniel T.,111,178,67,111,2022-03-11,Indian Wells,BNP Paribas Open,Hard,1.4,3.0,1
Kohlschreiber P.,132,812,446,366,Ruusuvuori E.,55,158,79,79,2022-03-11,Indian Wells,BNP Paribas Open,Hard,4.0,1.25,0
Munar J.,104,178,75,103,Shang J.,149,12,4,8,2022-03-11,Indian Wells,BNP Paribas Open,Hard,1.25,4.0,1
Kokkinakis T.,86,124,55,69,Korda S.,26,126,75,51,2022-03-11,Indian Wells,BNP Paribas Open,Hard,2.37,1.57,0
Martinez P.,135,118,50,68,Sousa J.,147,436,189,247,2022-03-11,Indian Wells,BNP Paribas Open,Hard,1.5,2.62,1
Kyrgios N.,25,303,195,108,Baez S.,72,95,47,48,2022-03-11,Indian Wells,BNP Paribas Open,Hard,1.44,2.75,1
Popyrin A.,90,140,59,81,Machac T.,108,18,6,12,2022-03-11,Indian Wells,BNP Paribas Open,Hard,2.2,1.66,0
Wolf J.J.,45,75,39,36,Gaston H.,109,58,24,34,2022-03-11,Indian Wells,BNP Paribas Open,Hard,1.5,2.62,1
Otte O.,233,78,33,45,Gasquet R.,48,948,581,367,2022-03-11,Indian Wells,BNP Paribas Open,Hard,2.2,1.66,1
Coria F.,108,99,43,56,Evans D.,30,251,124,127,2022-03-12,Indian Wells,BNP Paribas Open,Hard,5.5,1.14,0
Bonzi B.,107,83,37,46,Sonego L.,43,221,107,114,2022-03-12,Indian Wells,BNP Paribas Open,Hard,1.9,1.9,1
Davidovich Fokina A.,39,168,84,84,Shapovalov D.,29,298,166,132,2022-03-12,Indian Wells,BNP Paribas Open,Hard,3.0,1.4,0
Krajinovic F.,93,240,115,125,Monfils G.,323,816,510,306,2022-03-12,Indian Wells,BNP Paribas Open,Hard,2.75,1.44,0
Ruud C.,4,275,176,99,Eubanks C.,29,64,28,36,2022-03-12,Indian Wells,BNP Paribas Open,Hard,1.2,4.5,1
Martinez P.,135,118,50,68,Norrie C.,13,287,172,115,2022-03-12,Indian Wells,BNP Paribas Open,Hard,4.5,1.2,0
Musetti L.,18,143,79,64,Opelka R.,17,168,88,80,2022-03-12,Indian Wells,BNP Paribas Open,Hard,2.75,1.44,0
Korda S.,26,126,75,51,Nadal R.,2,1223,1017,206,2022-03-12,Indian Wells,BNP Paribas Open,Hard,6.0,1.12,0
Medvedev D.,3,406,289,117,Machac T.,108,18,6,12,2022-03-12,Indian Wells,BNP Paribas Open,Hard,1.05,11.0,1
Bautista Agut R.,25,379,234,145,Wolf J.J.,45,75,39,36,2022-03-12,Indian Wells,BNP Paribas Open,Hard,1.22,4.33,1
Nakashima B.,70,106,57,49,Mannarino A.,27,567,264,303,2022-03-12,Indian Wells,BNP Paribas Open,Hard,1.57,2.37,1
Querrey S.,287,678,369,309,Griekspoor T.,37,97,47,50,2022-03-12,Indian Wells,BNP Paribas Open,Hard,4.33,1.22,1
Van De Zandschulp B.,44,117,63,54,Sandgren T.,153,121,47,74,2022-03-12,Indian Wells,BNP Paribas Open,Hard,1.33,3.4,1
Majchrzak K.,121,50,19,31,Bedene A.,347,291,131,160,2022-03-12,Indian Wells,BNP Paribas Open,Hard,1.22,4.33,1
Johnson S.,197,395,196,199,Altmaier D.,51,79,28,51,2022-03-12,Indian Wells,BNP Paribas Open,Hard,1.9,1.9,1
Laaksonen H.,125,101,37,64,Bagnis F.,135,121,39,82,2022-03-12,Indian Wells,BNP Paribas Open,Hard,1.57,2.37,0
Struff J.L.,21,369,170,199,Millman J.,140,256,113,143,2022-03-12,Indian Wells,BNP Paribas Open,Hard,2.5,1.53,0
Humbert U.,36,170,80,90,Rune H.,6,131,83,48,2022-03-12,Indian Wells,BNP Paribas Open,Hard,1.8,2.0,0
Alcaraz C.,1,164,130,34,Mcdonald M.,60,190,87,103,2022-03-12,Indian Wells,BNP Paribas Open,Hard,1.25,4.0,1
Harris L.,186,129,59,70,Bagnis F.,135,121,39,82,2022-03-13,Indian Wells,BNP Paribas Open,Hard,1.61,2.3,1
Berrettini M.,38,217,142,75,Rune H.,6,131,83,48,2022-03-13,Indian Wells,BNP Paribas Open,Hard,1.3,3.5,1
Schwartzman D.,95,428,233,195,Ruusuvuori E.,55,158,79,79,2022-03-13,Indian Wells,BNP Paribas Open,Hard,1.66,2.2,1
Fritz T.,9,356,205,151,Majchrzak K.,121,50,19,31,2022-03-13,Indian Wells,BNP Paribas Open,Hard,1.22,4.33,1
Van De Zandschulp B.,44,117,63,54,Auger-Aliassime F.,12,268,163,105,2022-03-13,Indian Wells,BNP Paribas Open,Hard,3.75,1.28,1
Bublik A.,25,219,110,109,Murray A.,44,932,687,245,2022-03-13,Indian Wells,BNP Paribas Open,Hard,2.3,1.61,1
Rublev A.,7,392,255,137,Koepfer D.,84,86,38,48,2022-03-13,Indian Wells,BNP Paribas Open,Hard,1.07,9.0,1
Otte O.,233,78,33,45,Hurkacz H.,17,238,137,101,2022-03-13,Indian Wells,BNP Paribas Open,Hard,4.33,1.22,0
Querrey S.,287,678,369,309,Isner J.,114,755,465,290,2022-03-13,Indian Wells,BNP Paribas Open,Hard,3.2,1.36,0
Cilic M.,100,853,543,310,Kecmanovic M.,40,210,107,103,2022-03-13,Indian Wells,BNP Paribas Open,Hard,1.57,2.37,0
Kyrgios N.,25,303,195,108,Delbonis F.,131,340,152,188,2022-03-13,Indian Wells,BNP Paribas Open,Hard,1.16,5.0,1
Khachanov K.,11,378,217,161,Brooksby J.,39,79,46,33,2022-03-13,Indian Wells,BNP Paribas Open,Hard,1.9,1.9,0
Fognini F.,128,742,383,359,Basilashvili N.,118,301,138,163,2022-03-13,Indian Wells,BNP Paribas Open,Hard,2.0,1.8,0
Sock J.,166,324,177,147,Tsitsipas S.,5,390,264,126,2022-03-13,Indian Wells,BNP Paribas Open,Hard,5.0,1.16,0
Djere L.,38,243,120,123,Sinner J.,8,224,153,71,2022-03-13,Indian Wells,BNP Paribas Open,Hard,6.5,1.11,0
Karatsev A.,75,136,66,70,Johnson S.,197,395,196,199,2022-03-13,Indian Wells,BNP Paribas Open,Hard,1.44,2.75,0
Opelka R.,17,168,88,80,Shapovalov D.,29,298,166,132,2022-03-14,Indian Wells,BNP Paribas Open,Hard,2.0,1.8,1
Nadal R.,2,1223,1017,206,Evans D.,30,251,124,127,2022-03-14,Indian Wells,BNP Paribas Open,Hard,1.12,6.0,1
Medvedev D.,3,406,289,117,Monfils G.,323,816,510,306,2022-03-14,Indian Wells,BNP Paribas Open,Hard,1.12,6.0,0
Zverev A.,19,500,346,154,Paul T.,14,204,111,93,2022-03-14,Indian Wells,BNP Paribas Open,Hard,1.25,4.0,0
Bautista Agut R.,25,379,234,145,Alcaraz C.,1,164,130,34,2022-03-14,Indian Wells,BNP Paribas Open,Hard,2.75,1.44,0
Thompson J.,71,221,96,125,Dimitrov G.,20,651,389,262,2022-03-14,Indian Wells,BNP Paribas Open,Hard,3.5,1.3,0
Millman J.,140,256,113,143,De Minaur A.,19,272,161,111,2022-03-14,Indian Wells,BNP Paribas Open,Hard,3.4,1.33,0
Tiafoe F.,10,303,158,145,Nakashima B.,70,106,57,49,2022-03-14,Indian Wells,BNP Paribas Open,Hard,2.5,1.53,1
Carreno Busta P.,16,352,214,138,Munar J.,104,178,75,103,2022-03-14,Indian Wells,BNP Paribas Open,Hard,1.36,3.2,0
Isner J.,114,755,465,290,Schwartzman D.,95,428,233,195,2022-03-15,Indian Wells,BNP Paribas Open,Hard,2.0,1.8,1
Sinner J.,8,224,153,71,Bonzi B.,107,83,37,46,2022-03-15,Indian Wells,BNP Paribas Open,Hard,1.22,4.33,1
Tsitsipas S.,5,390,264,126,Brooksby J.,39,79,46,33,2022-03-15,Indian Wells,BNP Paribas Open,Hard,1.61,2.3,0
Norrie C.,13,287,172,115,Basilashvili N.,118,301,138,163,2022-03-15,Indian Wells,BNP Paribas Open,Hard,1.22,4.33,1
Kyrgios N.,25,303,195,108,Ruud C.,4,275,176,99,2022-03-15,Indian Wells,BNP Paribas Open,Hard,2.0,1.8,1
Kecmanovic M.,40,210,107,103,Van De Zandschulp B.,44,117,63,54,2022-03-15,Indian Wells,BNP Paribas Open,Hard,2.3,1.61,1
Berrettini M.,38,217,142,75,Harris L.,186,129,59,70,2022-03-15,Indian Wells,BNP Paribas Open,Hard,1.25,4.0,1
Fritz T.,9,356,205,151,Munar J.,104,178,75,103,2022-03-15,Indian Wells,BNP Paribas Open,Hard,1.2,4.5,1
Paul T.,14,204,111,93,De Minaur A.,19,272,161,111,2022-03-15,Indian Wells,BNP Paribas Open,Hard,1.8,2.0,0
Isner J.,114,755,465,290,Dimitrov G.,20,651,389,262,2022-03-16,Indian Wells,BNP Paribas Open,Hard,1.9,1.9,0
Opelka R.,17,168,88,80,Nadal R.,2,1223,1017,206,2022-03-16,Indian Wells,BNP Paribas Open,Hard,4.33,1.22,0
Rublev A.,7,392,255,137,Hurkacz H.,17,238,137,101,2022-03-16,Indian Wells,BNP Paribas Open,Hard,1.53,2.5,1
De Minaur A.,19,272,161,111,Fritz T.,9,356,205,151,2022-03-16,Indian Wells,BNP Paribas Open,Hard,2.1,1.72,0
Sinner J.,8,224,153,71,Kyrgios N.,25,303,195,108,2022-03-16,Indian Wells,BNP Paribas Open,Hard,1.8,2.0,0
Kecmanovic M.,40,210,107,103,Berrettini M.,38,217,142,75,2022-03-16,Indian Wells,BNP Paribas Open,Hard,3.0,1.4,1
Tiafoe F.,10,303,158,145,Rublev A.,7,392,255,137,2022-03-16,Indian Wells,BNP Paribas Open,Hard,3.2,1.36,0
Bublik A.,25,219,110,109,Dimitrov G.,20,651,389,262,2022-03-16,Indian Wells,BNP Paribas Open,Hard,2.0,1.8,0
Hurkacz H.,17,238,137,101,Johnson S.,197,395,196,199,2022-03-16,Indian Wells,BNP Paribas Open,Hard,1.28,3.75,1
Alcaraz C.,1,164,130,34,Monfils G.,323,816,510,306,2022-03-17,Indian Wells,BNP Paribas Open,Hard,1.3,3.5,1
Norrie C.,13,287,172,115,Brooksby J.,39,79,46,33,2022-03-17,Indian Wells,BNP Paribas Open,Hard,1.72,2.1,1
Kyrgios N.,25,303,195,108,Nadal R.,2,1223,1017,206,2022-03-17,Indian Wells,BNP Paribas Open,Hard,3.0,1.4,0
Kecmanovic M.,40,210,107,103,Fritz T.,9,356,205,151,2022-03-18,Indian Wells,BNP Paribas Open,Hard,2.37,1.57,0
Dimitrov G.,20,651,389,262,Rublev A.,7,392,255,137,2022-03-18,Indian Wells,BNP Paribas Open,Hard,3.4,1.33,0
Alcaraz C.,1,164,130,34,Norrie C.,13,287,172,115,2022-03-18,Indian Wells,BNP Paribas Open,Hard,1.36,3.2,1
Rublev A.,7,392,255,137,Fritz T.,9,356,205,151,2022-03-19,Indian Wells,BNP Paribas Open,Hard,1.44,2.75,0
Alcaraz C.,1,164,130,34,Nadal R.,2,1223,1017,206,2022-03-19,Indian Wells,BNP Paribas Open,Hard,2.3,1.61,0
Fritz T.,9,356,205,151,Nadal R.,2,1223,1017,206,2022-03-20,Indian Wells,BNP Paribas Open,Hard,4.5,1.2,1
Shang J.,149,12,4,8,Kudla D.,137,198,70,128,2022-03-23,Miami,Miami Open,Hard,3.4,1.33,0
Coric B.,15,343,185,158,Verdasco F.,244,962,537,425,2022-03-23,Miami,Miami Open,Hard,1.72,2.1,1
Carballes Baena R.,64,207,91,116,Goffin D.,123,522,296,226,2022-03-23,Miami,Miami Open,Hard,3.0,1.4,0
Millman J.,140,256,113,143,Galan D.E.,76,78,33,45,2022-03-23,Miami,Miami Open,Hard,1.44,2.75,0
Laaksonen H.,125,101,37,64,Paire B.,149,527,237,290,2022-03-23,Miami,Miami Open,Hard,1.9,1.9,1
Otte O.,233,78,33,45,Krueger M.,228,24,7,17,2022-03-23,Miami,Miami Open,Hard,1.66,2.2,1
Lajovic D.,66,378,163,215,Cerundolo J.M.,106,29,12,17,2022-03-23,Miami,Miami Open,Hard,1.1,7.0,0
Koepfer D.,84,86,38,48,Mcdonald M.,60,190,87,103,2022-03-23,Miami,Miami Open,Hard,3.2,1.36,0
Griekspoor T.,37,97,47,50,Cerundolo F.,21,104,58,46,2022-03-23,Miami,Miami Open,Hard,1.33,3.4,0
Munar J.,104,178,75,103,Daniel T.,111,178,67,111,2022-03-23,Miami,Miami Open,Hard,1.72,2.1,0
Nakashima B.,70,106,57,49,Kwon S.W.,68,108,53,55,2022-03-23,Miami,Miami Open,Hard,1.57,2.37,1
Simon G.,188,869,491,378,Draper J.,55,51,29,22,2022-03-23,Miami,Miami Open,Hard,2.62,1.5,0
Nava E.,242,13,2,11,Gaston H.,109,58,24,34,2022-03-23,Miami,Miami Open,Hard,2.3,1.61,0
Wolf J.J.,45,75,39,36,Altmaier D.,51,79,28,51,2022-03-24,Miami,Miami Open,Hard,1.53,2.5,1
Sock J.,166,324,177,147,Kecmanovic M.,40,210,107,103,2022-03-24,Miami,Miami Open,Hard,2.1,1.72,0
Delbonis F.,131,340,152,188,Murray A.,44,932,687,245,2022-03-24,Miami,Miami Open,Hard,5.0,1.16,0
Bonzi B.,107,83,37,46,Paul T.,14,204,111,93,2022-03-24,Miami,Miami Open,Hard,2.62,1.5,0
Rinderknech A.,67,96,46,50,Djere L.,38,243,120,123,2022-03-24,Miami,Miami Open,Hard,1.53,2.5,1
Van De Zandschulp B.,44,117,63,54,Kukushkin M.,221,352,141,211,2022-03-24,Miami,Miami Open,Hard,1.28,3.75,0
Giron M.,69,150,68,82,Fucsovics M.,67,249,121,128,2022-03-24,Miami,Miami Open,Hard,2.1,1.72,0
Majchrzak K.,121,50,19,31,Baez S.,72,95,47,48,2022-03-24,Miami,Miami Open,Hard,1.72,2.1,1
Tsonga J.W.,297,672,444,228,Thompson J.,71,221,96,125,2022-03-24,Miami,Miami Open,Hard,2.5,1.53,0
Musetti L.,18,143,79,64,Popyrin A.,90,140,59,81,2022-03-24,Miami,Miami Open,Hard,1.57,2.37,0
Davidovich Fokina A.,39,168,84,84,Korda S.,26,126,75,51,2022-03-24,Miami,Miami Open,Hard,2.75,1.44,0
Martinez P.,135,118,50,68,Struff J.L.,21,369,170,199,2022-03-24,Miami,Miami Open,Hard,1.72,2.1,1
Bagnis F.,135,121,39,82,Harris L.,186,129,59,70,2022-03-24,Miami,Miami Open,Hard,3.5,1.3,0
Nishioka Y.,31,215,99,116,Gomez E.,155,26,7,19,2022-03-24,Miami,Miami Open,Hard,1.28,3.75,1
Bedene A.,347,291,131,160,Humbert U.,36,170,80,90,2022-03-24,Miami,Miami Open,Hard,3.4,1.33,0
Gasquet R.,48,948,581,367,Kokkinakis T.,86,124,55,69,2022-03-24,Miami,Miami Open,Hard,3.0,1.4,0
Kyrgios N.,25,303,195,108,Mannarino A.,27,567,264,303,2022-03-24,Miami,Miami Open,Hard,1.2,4.5,1
Ruusuvuori E.,55,158,79,79,Cressy M.,96,96,42,54,2022-03-24,Miami,Miami Open,Hard,1.57,2.37,1
Coria F.,108,99,43,56,Brooksby J.,39,79,46,33,2022-03-24,Miami,Miami Open,Hard,13.0,1.04,0
Opelka R.,17,168,88,80,Cerundolo F.,21,104,58,46,2022-03-25,Miami,Miami Open,Hard,1.16,5.0,0
Galan D.E.,76,78,33,45,Bublik A.,25,219,110,109,2022-03-25,Miami,Miami Open,Hard,3.0,1.4,0
Norrie C.,13,287,172,115,Draper J.,55,51,29,22,2022-03-25,Miami,Miami Open,Hard,1.16,5.0,1
Dimitrov G.,20,651,389,262,Mcdonald M.,60,190,87,103,2022-03-25,Miami,Miami Open,Hard,1.57,2.37,0
Kudla D.,137,198,70,128,Sonego L.,43,221,107,114,2022-03-25,Miami,Miami Open,Hard,2.62,1.5,1
Monfils G.,323,816,510,306,Otte O.,233,78,33,45,2022-03-25,Miami,Miami Open,Hard,1.25,4.0,1
Kyrgios N.,25,303,195,108,Rublev A.,7,392,255,137,2022-03-25,Miami,Miami Open,Hard,2.2,1.66,1
Fognini F.,128,742,383,359,Daniel T.,111,178,67,111,2022-03-25,Miami,Miami Open,Hard,2.37,1.57,1
Ruusuvuori E.,55,158,79,79,Sinner J.,8,224,153,71,2022-03-25,Miami,Miami Open,Hard,3.0,1.4,0
Isner J.,114,755,465,290,Gaston H.,109,58,24,34,2022-03-25,Miami,Miami Open,Hard,1.25,4.0,0
Zverev A.,19,500,346,154,Coric B.,15,343,185,158,2022-03-25,Miami,Miami Open,Hard,1.14,5.5,1
Carreno Busta P.,16,352,214,138,Goffin D.,123,522,296,226,2022-03-25,Miami,Miami Open,Hard,1.44,2.75,1
Cerundolo J.M.,106,29,12,17,Anderson K.,652,598,347,251,2022-03-25,Miami,Miami Open,Hard,,,1
Kokkinakis T.,86,124,55,69,Schwartzman D.,95,428,233,195,2022-03-25,Miami,Miami Open,Hard,2.1,1.72,1
Tsitsipas S.,5,390,264,126,Wolf J.J.,45,75,39,36,2022-03-26,Miami,Miami Open,Hard,1.2,4.5,1
Shapovalov D.,29,298,166,132,Harris L.,186,129,59,70,2022-03-26,Miami,Miami Open,Hard,1.44,2.75,0
Korda S.,26,126,75,51,Ramos-Vinolas A.,82,437,204,233,2022-03-26,Miami,Miami Open,Hard,1.14,5.5,1
Fritz T.,9,356,205,151,Kukushkin M.,221,352,141,211,2022-03-26,Miami,Miami Open,Hard,1.25,4.0,1
Humbert U.,36,170,80,90,Karatsev A.,75,136,66,70,2022-03-26,Miami,Miami Open,Hard,2.2,1.66,0
Kecmanovic M.,40,210,107,103,Auger-Aliassime F.,12,268,163,105,2022-03-26,Miami,Miami Open,Hard,3.0,1.4,1
Nishioka Y.,31,215,99,116,Evans D.,30,251,124,127,2022-03-26,Miami,Miami Open,Hard,2.5,1.53,1
Basilashvili N.,118,301,138,163,Brooksby J.,39,79,46,33,2022-03-26,Miami,Miami Open,Hard,3.2,1.36,0
Garin C.,101,190,103,87,Martinez P.,135,118,50,68,2022-03-26,Miami,Miami Open,Hard,2.75,1.44,0
Murray A.,44,932,687,245,Medvedev D.,3,406,289,117,2022-03-26,Miami,Miami Open,Hard,6.0,1.12,0
Paul T.,14,204,111,93,Khachanov K.,11,378,217,161,2022-03-26,Miami,Miami Open,Hard,2.0,1.8,1
Thompson J.,71,221,96,125,De Minaur A.,19,272,161,111,2022-03-26,Miami,Miami Open,Hard,4.0,1.25,0
Majchrzak K.,121,50,19,31,Bautista Agut R.,25,379,234,145,2022-03-26,Miami,Miami Open,Hard,4.33,1.22,0
Tiafoe F.,10,303,158,145,Nakashima B.,70,106,57,49,2022-03-26,Miami,Miami Open,Hard,2.0,1.8,1
Laaksonen H.,125,101,37,64,Ruud C.,4,275,176,99,2022-03-26,Miami,Miami Open,Hard,5.5,1.14,0
Rinderknech A.,67,96,46,50,Hurkacz H.,17,238,137,101,2022-03-26,Miami,Miami Open,Hard,3.4,1.33,0
Sinner J.,8,224,153,71,Carreno Busta P.,16,352,214,138,2022-03-27,Miami,Miami Open,Hard,1.53,2.5,1
Tiafoe F.,10,303,158,145,Cerundolo J.M.,106,29,12,17,2022-03-27,Miami,Miami Open,Hard,1.12,6.0,1
Bublik A.,25,219,110,109,Ruud C.,4,275,176,99,2022-03-27,Miami,Miami Open,Hard,3.5,1.3,0
Kyrgios N.,25,303,195,108,Fognini F.,128,742,383,359,2022-03-27,Miami,Miami Open,Hard,1.14,5.5,1
Alcaraz C.,1,164,130,34,Fucsovics M.,67,249,121,128,2022-03-27,Miami,Miami Open,Hard,1.14,5.5,1
Cilic M.,100,853,543,310,Popyrin A.,90,140,59,81,2022-03-27,Miami,Miami Open,Hard,1.44,2.75,1
Norrie C.,13,287,172,115,Gaston H.,109,58,24,34,2022-03-27,Miami,Miami Open,Hard,1.12,6.0,1
Fritz T.,9,356,205,151,Paul T.,14,204,111,93,2022-03-28,Miami,Miami Open,Hard,1.66,2.2,1
Monfils G.,323,816,510,306,Cerundolo F.,21,104,58,46,2022-03-28,Miami,Miami Open,Hard,1.16,5.0,0
Kokkinakis T.,86,124,55,69,Kudla D.,137,198,70,128,2022-03-28,Miami,Miami Open,Hard,1.33,3.4,1
Zverev A.,19,500,346,154,Mcdonald M.,60,190,87,103,2022-03-28,Miami,Miami Open,Hard,1.16,5.0,1
Bautista Agut R.,25,379,234,145,Brooksby J.,39,79,46,33,2022-03-28,Miami,Miami Open,Hard,2.2,1.66,0
Martinez P.,135,118,50,68,Medvedev D.,3,406,289,117,2022-03-28,Miami,Miami Open,Hard,11.0,1.05,0
Karatsev A.,75,136,66,70,Hurkacz H.,17,238,137,101,2022-03-28,Miami,Miami Open,Hard,3.0,1.4,0
Harris L.,186,129,59,70,Nishioka Y.,31,215,99,116,2022-03-28,Miami,Miami Open,Hard,1.5,2.62,1
Alcaraz C.,1,164,130,34,Cilic M.,100,853,543,310,2022-03-28,Miami,Miami Open,Hard,1.22,4.33,1
Korda S.,26,126,75,51,Kecmanovic M.,40,210,107,103,2022-03-28,Miami,Miami Open,Hard,2.1,1.72,0
Brooksby J.,39,79,46,33,Medvedev D.,3,406,289,117,2022-03-29,Miami,Miami Open,Hard,5.0,1.16,0
Hurkacz H.,17,238,137,101,Harris L.,186,129,59,70,2022-03-29,Miami,Miami Open,Hard,1.3,3.5,1
Kyrgios N.,25,303,195,108,Sinner J.,8,224,153,71,2022-03-29,Miami,Miami Open,Hard,1.44,2.75,0
Cerundolo F.,21,104,58,46,Tiafoe F.,10,303,158,145,2022-03-29,Miami,Miami Open,Hard,3.2,1.36,1
Norrie C.,13,287,172,115,Ruud C.,4,275,176,99,2022-03-29,Miami,Miami Open,Hard,2.37,1.57,0
Tsitsipas S.,5,390,264,126,De Minaur A.,19,272,161,111,2022-03-29,Miami,Miami Open,Hard,1.36,3.2,1
Kokkinakis T.,86,124,55,69,Zverev A.,19,500,346,154,2022-03-29,Miami,Miami Open,Hard,4.5,1.2,0
Alcaraz C.,1,164,130,34,Tsitsipas S.,5,390,264,126,2022-03-30,Miami,Miami Open,Hard,1.5,2.62,1
Kecmanovic M.,40,210,107,103,Fritz T.,9,356,205,151,2022-03-30,Miami,Miami Open,Hard,2.62,1.5,1
Cerundolo F.,21,104,58,46,Sinner J.,8,224,153,71,2022-03-30,Miami,Miami Open,Hard,5.5,1.14,1
Zverev A.,19,500,346,154,Ruud C.,4,275,176,99,2022-03-31,Miami,Miami Open,Hard,1.3,3.5,0
Hurkacz H.,17,238,137,101,Medvedev D.,3,406,289,117,2022-03-31,Miami,Miami Open,Hard,4.0,1.25,1
Alcaraz C.,1,164,130,34,Kecmanovic M.,40,210,107,103,2022-04-01,Miami,Miami Open,Hard,1.16,5.0,1
Ruud C.,4,275,176,99,Cerundolo F.,21,104,58,46,2022-04-01,Miami,Miami Open,Hard,1.14,5.5,1
Alcaraz C.,1,164,130,34,Hurkacz H.,17,238,137,101,2022-04-02,Miami,Miami Open,Hard,1.44,2.75,1
Alcaraz C.,1,164,130,34,Ruud C.,4,275,176,99,2022-04-03,Miami,Miami Open,Hard,1.33,3.4,1
Cecchinato M.,108,204,79,125,Carballes Baena R.,64,207,91,116,2022-04-05,Marrakech,Grand Prix Hassan II,Clay,3.2,1.36,0
Andujar P.,323,404,164,240,Evans D.,30,251,124,127,2022-04-05,Marrakech,Grand Prix Hassan II,Clay,1.61,2.3,1
Davidovich Fokina A.,39,168,84,84,Coria F.,108,99,43,56,2022-04-05,Marrakech,Grand Prix Hassan II,Clay,1.44,2.75,0
Molcan A.,120,86,45,41,Travaglia S.,1024,81,27,54,2022-04-05,Marrakech,Grand Prix Hassan II,Clay,1.5,2.62,1
Benchetrit E.,445,8,1,7,Auger-Aliassime F.,12,268,163,105,2022-04-05,Marrakech,Grand Prix Hassan II,Clay,13.0,1.04,0
Gasquet R.,48,948,581,367,Laaksonen H.,125,101,37,64,2022-04-05,Marrakech,Grand Prix Hassan II,Clay,1.57,2.37,1
Sousa J.,147,436,189,247,Delbonis F.,131,340,152,188,2022-04-05,Marrakech,Grand Prix Hassan II,Clay,3.0,1.4,1
Musetti L.,18,143,79,64,Ramos-Vinolas A.,82,437,204,233,2022-04-05,Marrakech,Grand Prix Hassan II,Clay,2.2,1.66,1
Jaziri M.,444,217,83,134,Vesely J.,528,288,130,158,2022-04-05,Marrakech,Grand Prix Hassan II,Clay,7.0,1.1,1
Taberner C.,181,37,13,24,Hanfmann Y.,50,99,50,49,2022-04-05,Marrakech,Grand Prix Hassan II,Clay,1.8,2.0,1
Lehecka J.,33,61,30,31,Djere L.,38,243,120,123,2022-04-05,Marrakech,Grand Prix Hassan II,Clay,2.5,1.53,0
Van De Zandschulp B.,44,117,63,54,Dellien H.,164,70,22,48,2022-04-05,Marrakech,Grand Prix Hassan II,Clay,1.72,2.1,1
Thompson J.,71,221,96,125,Diez S.,292,10,2,8,2022-04-05,Houston,U.S. Men's Clay Court Championships,Clay,1.5,2.62,1
Galan D.E.,76,78,33,45,Querrey S.,287,678,369,309,2022-04-05,Houston,U.S. Men's Clay Court Championships,Clay,1.44,2.75,0
Brooksby J.,39,79,46,33,Wolf J.J.,45,75,39,36,2022-04-05,Houston,U.S. Men's Clay Court Championships,Clay,1.28,3.75,0
Krueger M.,228,24,7,17,Varillas J. P.,1345,20,9,11,2022-04-05,Houston,U.S. Men's Clay Court Championships,Clay,2.75,1.44,1
Kudla D.,137,198,70,128,Johnson S.,197,395,196,199,2022-04-05,Houston,U.S. Men's Clay Court Championships,Clay,2.3,1.61,0
Brouwer G.,144,21,11,10,Lopez F.,634,863,441,422,2022-04-05,Houston,U.S. Men's Clay Court Championships,Clay,1.72,2.1,1
Kyrgios N.,25,303,195,108,Mcdonald M.,60,190,87,103,2022-04-05,Houston,U.S. Men's Clay Court Championships,Clay,1.44,2.75,1
Paul T.,14,204,111,93,Gojowczyk P.,108,172,75,97,2022-04-05,Houston,U.S. Men's Clay Court Championships,Clay,1.14,5.5,1
Querrey S.,287,678,369,309,Mmoh M.,112,55,20,35,2022-04-06,Houston,U.S. Men's Clay Court Championships,Clay,1.53,2.5,0
Tiafoe F.,10,303,158,145,Giron M.,69,150,68,82,2022-04-06,Houston,U.S. Men's Clay Court Championships,Clay,1.53,2.5,1
Taberner C.,181,37,13,24,Musetti L.,18,143,79,64,2022-04-06,Marrakech,Grand Prix Hassan II,Clay,2.75,1.44,0
Dzumhur D.,202,234,107,127,Goffin D.,123,522,296,226,2022-04-06,Marrakech,Grand Prix Hassan II,Clay,2.62,1.5,0
Kopriva V.,159,9,5,4,Zapata Miralles B.,54,80,32,48,2022-04-06,Marrakech,Grand Prix Hassan II,Clay,2.1,1.72,1
Kotov P.,89,25,10,15,Griekspoor T.,37,97,47,50,2022-04-06,Marrakech,Grand Prix Hassan II,Clay,3.2,1.36,1
Basic M.,292,50,22,28,Majchrzak K.,121,50,19,31,2022-04-06,Marrakech,Grand Prix Hassan II,Clay,4.33,1.22,1
Sock J.,166,324,177,147,Garin C.,101,190,103,87,2022-04-06,Houston,U.S. Men's Clay Court Championships,Clay,1.9,1.9,0
Djere L.,38,243,120,123,Jaziri M.,444,217,83,134,2022-04-06,Marrakech,Grand Prix Hassan II,Clay,1.1,7.0,1
Tabilo A.,122,44,21,23,Harrison C.,251,15,6,9,2022-04-06,Houston,U.S. Men's Clay Court Championships,Clay,1.22,4.33,1
Purcell M.,78,28,9,19,Cuevas P.,149,421,210,211,2022-04-06,Houston,U.S. Men's Clay Court Championships,Clay,2.75,1.44,0
Kyrgios N.,25,303,195,108,Paul T.,14,204,111,93,2022-04-06,Houston,U.S. Men's Clay Court Championships,Clay,1.61,2.3,1
Auger-Aliassime F.,12,268,163,105,Molcan A.,120,86,45,41,2022-04-07,Marrakech,Grand Prix Hassan II,Clay,1.28,3.75,0
Kopriva V.,159,9,5,4,Van De Zandschulp B.,44,117,63,54,2022-04-07,Marrakech,Grand Prix Hassan II,Clay,3.0,1.4,0
Kotov P.,89,25,10,15,Gasquet R.,48,948,581,367,2022-04-07,Marrakech,Grand Prix Hassan II,Clay,2.75,1.44,0
Sousa J.,147,436,189,247,Carballes Baena R.,64,207,91,116,2022-04-07,Marrakech,Grand Prix Hassan II,Clay,2.75,1.44,0
Andujar P.,323,404,164,240,Goffin D.,123,522,296,226,2022-04-07,Marrakech,Grand Prix Hassan II,Clay,1.61,2.3,0
Coria F.,108,99,43,56,Basic M.,292,50,22,28,2022-04-07,Marrakech,Grand Prix Hassan II,Clay,1.28,3.75,1
Tiafoe F.,10,303,158,145,Cuevas P.,149,421,210,211,2022-04-07,Houston,U.S. Men's Clay Court Championships,Clay,1.4,3.0,1
Thompson J.,71,221,96,125,Garin C.,101,190,103,87,2022-04-07,Houston,U.S. Men's Clay Court Championships,Clay,3.2,1.36,0
Brouwer G.,144,21,11,10,Wolf J.J.,45,75,39,36,2022-04-07,Houston,U.S. Men's Clay Court Championships,Clay,3.4,1.33,1
Opelka R.,17,168,88,80,Krueger M.,228,24,7,17,2022-04-07,Houston,U.S. Men's Clay Court Championships,Clay,1.36,3.2,1
Van De Zandschulp B.,44,117,63,54,Molcan A.,120,86,45,41,2022-04-08,Marrakech,Grand Prix Hassan II,Clay,1.9,1.9,0
Coria F.,108,99,43,56,Gasquet R.,48,948,581,367,2022-04-08,Marrakech,Grand Prix Hassan II,Clay,1.61,2.3,1
Goffin D.,123,522,296,226,Carballes Baena R.,64,207,91,116,2022-04-08,Marrakech,Grand Prix Hassan II,Clay,1.66,2.2,1
Musetti L.,18,143,79,64,Djere L.,38,243,120,123,2022-04-08,Marrakech,Grand Prix Hassan II,Clay,1.72,2.1,0
Johnson S.,197,395,196,199,Isner J.,114,755,465,290,2022-04-08,Houston,U.S. Men's Clay Court Championships,Clay,2.2,1.66,0
Opelka R.,17,168,88,80,Brouwer G.,144,21,11,10,2022-04-08,Houston,U.S. Men's Clay Court Championships,Clay,1.25,4.0,1
Mmoh M.,112,55,20,35,Kyrgios N.,25,303,195,108,2022-04-08,Houston,U.S. Men's Clay Court Championships,Clay,7.0,1.1,0
Garin C.,101,190,103,87,Fritz T.,9,356,205,151,2022-04-08,Houston,U.S. Men's Clay Court Championships,Clay,3.5,1.3,1
Fritz T.,9,356,205,151,Tabilo A.,122,44,21,23,2022-04-08,Houston,U.S. Men's Clay Court Championships,Clay,1.66,2.2,1
Isner J.,114,755,465,290,Tiafoe F.,10,303,158,145,2022-04-09,Houston,U.S. Men's Clay Court Championships,Clay,1.9,1.9,1
Kyrgios N.,25,303,195,108,Opelka R.,17,168,88,80,2022-04-09,Houston,U.S. Men's Clay Court Championships,Clay,1.53,2.5,0
Garin C.,101,190,103,87,Isner J.,114,755,465,290,2022-04-09,Houston,U.S. Men's Clay Court Championships,Clay,2.0,1.8,0
Coria F.,108,99,43,56,Goffin D.,123,522,296,226,2022-04-09,Marrakech,Grand Prix Hassan II,Clay,2.2,1.66,0
Djere L.,38,243,120,123,Molcan A.,120,86,45,41,2022-04-09,Marrakech,Grand Prix Hassan II,Clay,1.66,2.2,0
Harris L.,186,129,59,70,Fucsovics M.,67,249,121,128,2022-04-10,Monte Carlo,Monte Carlo Masters,Clay,2.62,1.5,0
Basilashvili N.,118,301,138,163,Dimitrov G.,20,651,389,262,2022-04-10,Monte Carlo,Monte Carlo Masters,Clay,2.75,1.44,0
Lajovic D.,66,378,163,215,Krajinovic F.,93,240,115,125,2022-04-10,Monte Carlo,Monte Carlo Masters,Clay,2.2,1.66,1
Molcan A.,120,86,45,41,Goffin D.,123,522,296,226,2022-04-10,Marrakech,Grand Prix Hassan II,Clay,1.8,2.0,0
Isner J.,114,755,465,290,Opelka R.,17,168,88,80,2022-04-10,Houston,U.S. Men's Clay Court Championships,Clay,2.3,1.61,0
Giron M.,69,150,68,82,Davidovich Fokina A.,39,168,84,84,2022-04-10,Monte Carlo,Monte Carlo Masters,Clay,2.75,1.44,0
Tsonga J.W.,297,672,444,228,Cilic M.,100,853,543,310,2022-04-11,Monte Carlo,Monte Carlo Masters,Clay,4.33,1.22,0
Dellien H.,164,70,22,48,Hurkacz H.,17,238,137,101,2022-04-11,Monte Carlo,Monte Carlo Masters,Clay,3.0,1.4,0
Baez S.,72,95,47,48,Carreno Busta P.,16,352,214,138,2022-04-11,Monte Carlo,Monte Carlo Masters,Clay,2.75,1.44,0
Sinner J.,8,224,153,71,Coric B.,15,343,185,158,2022-04-11,Monte Carlo,Monte Carlo Masters,Clay,1.36,3.2,1
De Minaur A.,19,272,161,111,Zapata Miralles B.,54,80,32,48,2022-04-11,Monte Carlo,Monte Carlo Masters,Clay,1.3,3.5,1
Bublik A.,25,219,110,109,Wawrinka S.,72,854,535,319,2022-04-11,Monte Carlo,Monte Carlo Masters,Clay,1.44,2.75,1
Schwartzman D.,95,428,233,195,Khachanov K.,11,378,217,161,2022-04-11,Monte Carlo,Monte Carlo Masters,Clay,1.44,2.75,1
Fognini F.,128,742,383,359,Rinderknech A.,67,96,46,50,2022-04-11,Monte Carlo,Monte Carlo Masters,Clay,1.44,2.75,1
Ramos-Vinolas A.,82,437,204,233,Griekspoor T.,37,97,47,50,2022-04-11,Monte Carlo,Monte Carlo Masters,Clay,1.57,2.37,1
Van De Zandschulp B.,44,117,63,54,Korda S.,26,126,75,51,2022-04-11,Monte Carlo,Monte Carlo Masters,Clay,2.2,1.66,0
Munar J.,104,178,75,103,Delbonis F.,131,340,152,188,2022-04-11,Monte Carlo,Monte Carlo Masters,Clay,1.3,3.5,0
Lehecka J.,33,61,30,31,Goffin D.,123,522,296,226,2022-04-12,Monte Carlo,Monte Carlo Masters,Clay,2.2,1.66,0
Fognini F.,128,742,383,359,Tsitsipas S.,5,390,264,126,2022-04-12,Monte Carlo,Monte Carlo Masters,Clay,3.75,1.28,0
Djokovic N.,2,1207,1012,195,Davidovich Fokina A.,39,168,84,84,2022-04-12,Monte Carlo,Monte Carlo Masters,Clay,1.16,5.0,0
Rune H.,6,131,83,48,Karatsev A.,75,136,66,70,2022-04-12,Monte Carlo,Monte Carlo Masters,Clay,1.66,2.2,1
Paire B.,149,527,237,290,Musetti L.,18,143,79,64,2022-04-12,Monte Carlo,Monte Carlo Masters,Clay,3.0,1.4,0
Dimitrov G.,20,651,389,262,Lajovic D.,66,378,163,215,2022-04-12,Monte Carlo,Monte Carlo Masters,Clay,1.5,2.62,1
Cressy M.,96,96,42,54,Djere L.,38,243,120,123,2022-04-12,Monte Carlo,Monte Carlo Masters,Clay,3.75,1.28,0
Humbert U.,36,170,80,90,Martinez P.,135,118,50,68,2022-04-12,Monte Carlo,Monte Carlo Masters,Clay,3.0,1.4,0
Ivashka I.,113,159,78,81,Sonego L.,43,221,107,114,2022-04-12,Monte Carlo,Monte Carlo Masters,Clay,3.0,1.4,0
Bonzi B.,107,83,37,46,Evans D.,30,251,124,127,2022-04-12,Monte Carlo,Monte Carlo Masters,Clay,2.0,1.8,0
Ruusuvuori E.,55,158,79,79,Otte O.,233,78,33,45,2022-04-12,Monte Carlo,Monte Carlo Masters,Clay,1.66,2.2,1
Fritz T.,9,356,205,151,Catarina L.,430,4,0,4,2022-04-12,Monte Carlo,Monte Carlo Masters,Clay,1.02,17.0,1
Delbonis F.,131,340,152,188,Zverev A.,19,500,346,154,2022-04-13,Monte Carlo,Monte Carlo Masters,Clay,5.5,1.14,0
De Minaur A.,19,272,161,111,Rublev A.,7,392,255,137,2022-04-13,Monte Carlo,Monte Carlo Masters,Clay,3.5,1.3,0
Auger-Aliassime F.,12,268,163,105,Musetti L.,18,143,79,64,2022-04-13,Monte Carlo,Monte Carlo Masters,Clay,1.57,2.37,0
Ruusuvuori E.,55,158,79,79,Sinner J.,8,224,153,71,2022-04-13,Monte Carlo,Monte Carlo Masters,Clay,3.5,1.3,0
Bublik A.,25,219,110,109,Carreno Busta P.,16,352,214,138,2022-04-13,Monte Carlo,Monte Carlo Masters,Clay,4.33,1.22,0
Ruud C.,4,275,176,99,Rune H.,6,131,83,48,2022-04-13,Monte Carlo,Monte Carlo Masters,Clay,1.16,5.0,1
Fucsovics M.,67,249,121,128,Schwartzman D.,95,428,233,195,2022-04-13,Monte Carlo,Monte Carlo Masters,Clay,3.5,1.3,0
Goffin D.,123,522,296,226,Evans D.,30,251,124,127,2022-04-13,Monte Carlo,Monte Carlo Masters,Clay,1.66,2.2,1
Martinez P.,135,118,50,68,Hurkacz H.,17,238,137,101,2022-04-13,Monte Carlo,Monte Carlo Masters,Clay,2.62,1.5,0
Djere L.,38,243,120,123,Sonego L.,43,221,107,114,2022-04-13,Monte Carlo,Monte Carlo Masters,Clay,2.2,1.66,1
Korda S.,26,126,75,51,Alcaraz C.,1,164,130,34,2022-04-13,Monte Carlo,Monte Carlo Masters,Clay,4.33,1.22,1
Norrie C.,13,287,172,115,Ramos-Vinolas A.,82,437,204,233,2022-04-13,Monte Carlo,Monte Carlo Masters,Clay,1.66,2.2,0
Cilic M.,100,853,543,310,Fritz T.,9,356,205,151,2022-04-13,Monte Carlo,Monte Carlo Masters,Clay,1.57,2.37,0
Korda S.,26,126,75,51,Fritz T.,9,356,205,151,2022-04-14,Monte Carlo,Monte Carlo Masters,Clay,1.66,2.2,0
Ruud C.,4,275,176,99,Dimitrov G.,20,651,389,262,2022-04-14,Monte Carlo,Monte Carlo Masters,Clay,1.2,4.5,0
Davidovich Fokina A.,39,168,84,84,Goffin D.,123,522,296,226,2022-04-14,Monte Carlo,Monte Carlo Masters,Clay,2.1,1.72,1
Schwartzman D.,95,428,233,195,Musetti L.,18,143,79,64,2022-04-14,Monte Carlo,Monte Carlo Masters,Clay,1.57,2.37,1
Djere L.,38,243,120,123,Tsitsipas S.,5,390,264,126,2022-04-14,Monte Carlo,Monte Carlo Masters,Clay,6.0,1.12,0
Carreno Busta P.,16,352,214,138,Zverev A.,19,500,346,154,2022-04-14,Monte Carlo,Monte Carlo Masters,Clay,3.5,1.3,0
Ramos-Vinolas A.,82,437,204,233,Hurkacz H.,17,238,137,101,2022-04-14,Monte Carlo,Monte Carlo Masters,Clay,2.3,1.61,0
Rublev A.,7,392,255,137,Sinner J.,8,224,153,71,2022-04-14,Monte Carlo,Monte Carlo Masters,Clay,1.9,1.9,0
Schwartzman D.,95,428,233,195,Tsitsipas S.,5,390,264,126,2022-04-15,Monte Carlo,Monte Carlo Masters,Clay,3.4,1.33,0
Zverev A.,19,500,346,154,Sinner J.,8,224,153,71,2022-04-15,Monte Carlo,Monte Carlo Masters,Clay,1.44,2.75,1
Fritz T.,9,356,205,151,Davidovich Fokina A.,39,168,84,84,2022-04-15,Monte Carlo,Monte Carlo Masters,Clay,2.0,1.8,0
Dimitrov G.,20,651,389,262,Hurkacz H.,17,238,137,101,2022-04-15,Monte Carlo,Monte Carlo Masters,Clay,2.0,1.8,1
Davidovich Fokina A.,39,168,84,84,Dimitrov G.,20,651,389,262,2022-04-16,Monte Carlo,Monte Carlo Masters,Clay,1.72,2.1,1
Zverev A.,19,500,346,154,Tsitsipas S.,5,390,264,126,2022-04-16,Monte Carlo,Monte Carlo Masters,Clay,1.9,1.9,0
Tsitsipas S.,5,390,264,126,Davidovich Fokina A.,39,168,84,84,2022-04-17,Monte Carlo,Monte Carlo Masters,Clay,1.22,4.33,1
Rune H.,6,131,83,48,Garin C.,101,190,103,87,2022-04-18,Belgrade,Serbia Open,Clay,1.72,2.1,1
Kecmanovic M.,40,210,107,103,Gasquet R.,48,948,581,367,2022-04-18,Belgrade,Serbia Open,Clay,1.28,3.75,1
Cecchinato M.,108,204,79,125,Fognini F.,128,742,383,359,2022-04-18,Belgrade,Serbia Open,Clay,3.0,1.4,0
Munar J.,104,178,75,103,Moroni G.M.,181,2,0,2,2022-04-18,Barcelona,Barcelona Open,Clay,1.12,6.0,1
Ymer E.,186,81,24,57,Cressy M.,96,96,42,54,2022-04-18,Barcelona,Barcelona Open,Clay,1.44,2.75,1
Zapata Miralles B.,54,80,32,48,Robredo T.,362,684,411,273,2022-04-18,Barcelona,Barcelona Open,Clay,1.1,7.0,1
Alvarez Varona N.,231,3,1,2,Nakashima B.,70,106,57,49,2022-04-18,Barcelona,Barcelona Open,Clay,3.4,1.33,0
Mannarino A.,27,567,264,303,Gerasimov E.,150,93,43,50,2022-04-18,Barcelona,Barcelona Open,Clay,2.5,1.53,0
Musetti L.,18,143,79,64,Baez S.,72,95,47,48,2022-04-18,Barcelona,Barcelona Open,Clay,1.9,1.9,1
Giron M.,69,150,68,82,Coria F.,108,99,43,56,2022-04-18,Barcelona,Barcelona Open,Clay,3.0,1.4,0
Kwon S.W.,68,108,53,55,Paire B.,149,527,237,290,2022-04-18,Barcelona,Barcelona Open,Clay,2.1,1.72,1
Mcdonald M.,60,190,87,103,Grenier H.,122,16,5,11,2022-04-18,Barcelona,Barcelona Open,Clay,1.28,3.75,1
Bedene A.,347,291,131,160,Kukushkin M.,221,352,141,211,2022-04-18,Belgrade,Serbia Open,Clay,1.66,2.2,1
Otte O.,233,78,33,45,Tabilo A.,122,44,21,23,2022-04-19,Belgrade,Serbia Open,Clay,2.3,1.61,1
Krajinovic F.,93,240,115,125,Goffin D.,123,522,296,226,2022-04-19,Belgrade,Serbia Open,Clay,2.3,1.61,1
Sousa J.,147,436,189,247,Monteiro T.,121,171,69,102,2022-04-19,Belgrade,Serbia Open,Clay,2.37,1.57,0
Thiem D.,116,517,327,190,Millman J.,140,256,113,143,2022-04-19,Belgrade,Serbia Open,Clay,1.5,2.62,0
Ymer M.,59,130,58,72,Safiullin R.,92,42,20,22,2022-04-19,Belgrade,Serbia Open,Clay,1.72,2.1,0
Medjedovic H.,147,11,3,8,Djere L.,38,243,120,123,2022-04-19,Belgrade,Serbia Open,Clay,5.5,1.14,0
Lehecka J.,33,61,30,31,Laaksonen H.,125,101,37,64,2022-04-19,Belgrade,Serbia Open,Clay,1.5,2.62,1
Daniel T.,111,178,67,111,Lajovic D.,66,378,163,215,2022-04-19,Belgrade,Serbia Open,Clay,2.0,1.8,1
Ymer E.,186,81,24,57,Sonego L.,43,221,107,114,2022-04-19,Barcelona,Barcelona Open,Clay,2.62,1.5,0
Nakashima B.,70,106,57,49,Ruud C.,4,275,176,99,2022-04-19,Barcelona,Barcelona Open,Clay,7.0,1.1,0
Norrie C.,13,287,172,115,Gerasimov E.,150,93,43,50,2022-04-19,Barcelona,Barcelona Open,Clay,1.12,6.0,1
Musetti L.,18,143,79,64,Evans D.,30,251,124,127,2022-04-19,Barcelona,Barcelona Open,Clay,1.36,3.2,1
Martinez P.,135,118,50,68,Ivashka I.,113,159,78,81,2022-04-19,Barcelona,Barcelona Open,Clay,1.36,3.2,0
Humbert U.,36,170,80,90,Andujar P.,323,404,164,240,2022-04-19,Barcelona,Barcelona Open,Clay,2.75,1.44,1
Guinard M.,148,9,4,5,Dellien H.,164,70,22,48,2022-04-19,Barcelona,Barcelona Open,Clay,3.0,1.4,0
Lopez F.,634,863,441,422,Ruusuvuori E.,55,158,79,79,2022-04-19,Barcelona,Barcelona Open,Clay,5.0,1.16,0
Thompson J.,71,221,96,125,Fucsovics M.,67,249,121,128,2022-04-19,Barcelona,Barcelona Open,Clay,4.0,1.25,0
Taberner C.,181,37,13,24,Korda S.,26,126,75,51,2022-04-19,Barcelona,Barcelona Open,Clay,3.5,1.3,1
Carballes Baena R.,64,207,91,116,Harris L.,186,129,59,70,2022-04-19,Barcelona,Barcelona Open,Clay,1.57,2.37,0
Schwartzman D.,95,428,233,195,Mcdonald M.,60,190,87,103,2022-04-19,Barcelona,Barcelona Open,Clay,1.12,6.0,1
Delbonis F.,131,340,152,188,Fucsovics M.,67,249,121,128,2022-04-20,Barcelona,Barcelona Open,Clay,2.2,1.66,0
Millman J.,140,256,113,143,Kecmanovic M.,40,210,107,103,2022-04-20,Belgrade,Serbia Open,Clay,5.0,1.16,0
Carreno Busta P.,16,352,214,138,Zapata Miralles B.,54,80,32,48,2022-04-20,Barcelona,Barcelona Open,Clay,1.25,4.0,1
Krajinovic F.,93,240,115,125,Monteiro T.,121,171,69,102,2022-04-20,Belgrade,Serbia Open,Clay,1.57,2.37,0
Alcaraz C.,1,164,130,34,Kwon S.W.,68,108,53,55,2022-04-20,Barcelona,Barcelona Open,Clay,1.06,10.0,1
Munar J.,104,178,75,103,Basilashvili N.,118,301,138,163,2022-04-20,Barcelona,Barcelona Open,Clay,1.25,4.0,1
Humbert U.,36,170,80,90,De Minaur A.,19,272,161,111,2022-04-20,Barcelona,Barcelona Open,Clay,3.0,1.4,0
Taberner C.,181,37,13,24,Auger-Aliassime F.,12,268,163,105,2022-04-20,Barcelona,Barcelona Open,Clay,2.75,1.44,0
Ramos-Vinolas A.,82,437,204,233,Harris L.,186,129,59,70,2022-04-20,Barcelona,Barcelona Open,Clay,1.44,2.75,0
Bublik A.,25,219,110,109,Ruusuvuori E.,55,158,79,79,2022-04-20,Barcelona,Barcelona Open,Clay,2.75,1.44,0
Tiafoe F.,10,303,158,145,Dellien H.,164,70,22,48,2022-04-20,Barcelona,Barcelona Open,Clay,1.72,2.1,1
Djere L.,38,243,120,123,Djokovic N.,2,1207,1012,195,2022-04-20,Belgrade,Serbia Open,Clay,5.5,1.14,0
Khachanov K.,11,378,217,161,Safiullin R.,92,42,20,22,2022-04-20,Belgrade,Serbia Open,Clay,1.4,3.0,1
Fognini F.,128,742,383,359,Bedene A.,347,291,131,160,2022-04-21,Belgrade,Serbia Open,Clay,1.33,3.4,1
Kecmanovic M.,40,210,107,103,Djokovic N.,2,1207,1012,195,2022-04-21,Belgrade,Serbia Open,Clay,2.5,1.53,0
Karatsev A.,75,136,66,70,Otte O.,233,78,33,45,2022-04-21,Belgrade,Serbia Open,Clay,1.5,2.62,0
Lehecka J.,33,61,30,31,Rublev A.,7,392,255,137,2022-04-21,Belgrade,Serbia Open,Clay,4.5,1.2,0
Rune H.,6,131,83,48,Daniel T.,111,178,67,111,2022-04-21,Belgrade,Serbia Open,Clay,1.36,3.2,0
Khachanov K.,11,378,217,161,Monteiro T.,121,171,69,102,2022-04-21,Belgrade,Serbia Open,Clay,1.66,2.2,1
Coria F.,108,99,43,56,Dimitrov G.,20,651,389,262,2022-04-21,Barcelona,Barcelona Open,Clay,2.75,1.44,0
Ivashka I.,113,159,78,81,Tsitsipas S.,5,390,264,126,2022-04-21,Barcelona,Barcelona Open,Clay,6.0,1.12,0
Fucsovics M.,67,249,121,128,Norrie C.,13,287,172,115,2022-04-22,Barcelona,Barcelona Open,Clay,2.2,1.66,0
Ruusuvuori E.,55,158,79,79,Ruud C.,4,275,176,99,2022-04-22,Barcelona,Barcelona Open,Clay,5.0,1.16,0
Sonego L.,43,221,107,114,Carreno Busta P.,16,352,214,138,2022-04-22,Barcelona,Barcelona Open,Clay,2.5,1.53,0
Musetti L.,18,143,79,64,Schwartzman D.,95,428,233,195,2022-04-22,Barcelona,Barcelona Open,Clay,2.75,1.44,0
Auger-Aliassime F.,12,268,163,105,Tiafoe F.,10,303,158,145,2022-04-22,Barcelona,Barcelona Open,Clay,1.44,2.75,1
Fognini F.,128,742,383,359,Otte O.,233,78,33,45,2022-04-22,Belgrade,Serbia Open,Clay,1.44,2.75,1
Daniel T.,111,178,67,111,Rublev A.,7,392,255,137,2022-04-22,Belgrade,Serbia Open,Clay,3.5,1.3,0
Harris L.,186,129,59,70,De Minaur A.,19,272,161,111,2022-04-22,Barcelona,Barcelona Open,Clay,2.5,1.53,0
Tsitsipas S.,5,390,264,126,Dimitrov G.,20,651,389,262,2022-04-22,Barcelona,Barcelona Open,Clay,1.22,4.33,1
Auger-Aliassime F.,12,268,163,105,Schwartzman D.,95,428,233,195,2022-04-22,Barcelona,Barcelona Open,Clay,2.37,1.57,0
Carreno Busta P.,16,352,214,138,Ruud C.,4,275,176,99,2022-04-22,Barcelona,Barcelona Open,Clay,3.5,1.3,1
De Minaur A.,19,272,161,111,Norrie C.,13,287,172,115,2022-04-22,Barcelona,Barcelona Open,Clay,1.53,2.5,1
Alcaraz C.,1,164,130,34,Tsitsipas S.,5,390,264,126,2022-04-22,Barcelona,Barcelona Open,Clay,1.66,2.2,1
Munar J.,104,178,75,103,Alcaraz C.,1,164,130,34,2022-04-22,Barcelona,Barcelona Open,Clay,4.5,1.2,0
Rublev A.,7,392,255,137,Fognini F.,128,742,383,359,2022-04-23,Belgrade,Serbia Open,Clay,1.33,3.4,1
Khachanov K.,11,378,217,161,Djokovic N.,2,1207,1012,195,2022-04-23,Belgrade,Serbia Open,Clay,4.0,1.25,0
De Minaur A.,19,272,161,111,Alcaraz C.,1,164,130,34,2022-04-24,Barcelona,Barcelona Open,Clay,8.0,1.08,0
Carreno Busta P.,16,352,214,138,Schwartzman D.,95,428,233,195,2022-04-24,Barcelona,Barcelona Open,Clay,2.1,1.72,1
Alcaraz C.,1,164,130,34,Carreno Busta P.,16,352,214,138,2022-04-24,Barcelona,Barcelona Open,Clay,1.57,2.37,1
Djokovic N.,2,1207,1012,195,Rublev A.,7,392,255,137,2022-04-24,Belgrade,Serbia Open,Clay,1.4,3.0,0
Altmaier D.,51,79,28,51,Kohlschreiber P.,132,812,446,366,2022-04-25,Munich,BMW Open,Clay,1.72,2.1,1
Ruusuvuori E.,55,158,79,79,Nishioka Y.,31,215,99,116,2022-04-25,Munich,BMW Open,Clay,1.5,2.62,1
Rune H.,6,131,83,48,Lehecka J.,33,61,30,31,2022-04-25,Munich,BMW Open,Clay,1.53,2.5,1
Gombos N.,114,66,21,45,Molcan A.,120,86,45,41,2022-04-25,Munich,BMW Open,Clay,3.5,1.3,0
Rehberg M.,412,3,0,3,Kecmanovic M.,40,210,107,103,2022-04-25,Munich,BMW Open,Clay,19.0,1.02,0
Kwon S.W.,68,108,53,55,Paire B.,149,527,237,290,2022-04-25,Estoril,Millennium Estoril Open,Clay,1.53,2.5,1
Borges N.,69,28,10,18,Andujar P.,323,404,164,240,2022-04-25,Estoril,Millennium Estoril Open,Clay,2.0,1.8,1
Tiafoe F.,10,303,158,145,Lajovic D.,66,378,163,215,2022-04-25,Estoril,Millennium Estoril Open,Clay,1.53,2.5,1
Coria F.,108,99,43,56,Zapata Miralles B.,54,80,32,48,2022-04-25,Estoril,Millennium Estoril Open,Clay,1.66,2.2,0
Harris L.,186,129,59,70,Taberner C.,181,37,13,24,2022-04-26,Estoril,Millennium Estoril Open,Clay,2.37,1.57,0
Evans D.,30,251,124,127,Cressy M.,96,96,42,54,2022-04-26,Munich,BMW Open,Clay,1.3,3.5,0
Ivashka I.,113,159,78,81,Mcdonald M.,60,190,87,103,2022-04-26,Munich,BMW Open,Clay,1.53,2.5,1
Giron M.,69,150,68,82,Gaston H.,109,58,24,34,2022-04-26,Munich,BMW Open,Clay,2.2,1.66,0
Topo M.,478,4,0,4,Otte O.,233,78,33,45,2022-04-26,Munich,BMW Open,Clay,4.5,1.2,0
Cuevas P.,149,421,210,211,Carballes Baena R.,64,207,91,116,2022-04-26,Estoril,Millennium Estoril Open,Clay,2.0,1.8,1
Korda S.,26,126,75,51,Herbert P.H.,157,202,89,113,2022-04-26,Estoril,Millennium Estoril Open,Clay,1.25,4.0,1
Bonzi B.,107,83,37,46,Thiem D.,116,517,327,190,2022-04-26,Estoril,Millennium Estoril Open,Clay,2.75,1.44,1
Thompson J.,71,221,96,125,Ramos-Vinolas A.,82,437,204,233,2022-04-26,Estoril,Millennium Estoril Open,Clay,4.33,1.22,0
Sousa J.,147,436,189,247,Baez S.,72,95,47,48,2022-04-26,Estoril,Millennium Estoril Open,Clay,3.4,1.33,0
Dellien H.,164,70,22,48,Vesely J.,528,288,130,158,2022-04-26,Estoril,Millennium Estoril Open,Clay,1.53,2.5,1
Paul T.,14,204,111,93,Gasquet R.,48,948,581,367,2022-04-26,Estoril,Millennium Estoril Open,Clay,1.44,2.75,0
Gerasimov E.,150,93,43,50,Millman J.,140,256,113,143,2022-04-27,Munich,BMW Open,Clay,1.66,2.2,1
Van De Zandschulp B.,44,117,63,54,Nakashima B.,70,106,57,49,2022-04-27,Munich,BMW Open,Clay,1.57,2.37,1
Zverev A.,19,500,346,154,Rune H.,6,131,83,48,2022-04-27,Munich,BMW Open,Clay,1.14,5.5,0
Cressy M.,96,96,42,54,Ruusuvuori E.,55,158,79,79,2022-04-27,Munich,BMW Open,Clay,3.75,1.28,0
Altmaier D.,51,79,28,51,Kecmanovic M.,40,210,107,103,2022-04-27,Munich,BMW Open,Clay,5.0,1.16,0
Garin C.,101,190,103,87,Tabilo A.,122,44,21,23,2022-04-27,Munich,BMW Open,Clay,1.66,2.2,0
Basilashvili N.,118,301,138,163,Ivashka I.,113,159,78,81,2022-04-27,Munich,BMW Open,Clay,2.62,1.5,1
Ramos-Vinolas A.,82,437,204,233,Kwon S.W.,68,108,53,55,2022-04-27,Estoril,Millennium Estoril Open,Clay,1.44,2.75,1
Davidovich Fokina A.,39,168,84,84,Zapata Miralles B.,54,80,32,48,2022-04-27,Estoril,Millennium Estoril Open,Clay,1.36,3.2,1
Tiafoe F.,10,303,158,145,Borges N.,69,28,10,18,2022-04-27,Estoril,Millennium Estoril Open,Clay,1.61,2.3,1
Verdasco F.,244,962,537,425,Cuevas P.,149,421,210,211,2022-04-27,Estoril,Millennium Estoril Open,Clay,2.1,1.72,1
Gaston H.,109,58,24,34,Tabilo A.,122,44,21,23,2022-04-28,Munich,BMW Open,Clay,2.3,1.61,0
Ruud C.,4,275,176,99,Molcan A.,120,86,45,41,2022-04-28,Munich,BMW Open,Clay,1.2,4.5,1
Gerasimov E.,150,93,43,50,Van De Zandschulp B.,44,117,63,54,2022-04-28,Munich,BMW Open,Clay,2.75,1.44,0
Dellien H.,164,70,22,48,Gasquet R.,48,948,581,367,2022-04-28,Estoril,Millennium Estoril Open,Clay,1.66,2.2,0
Otte O.,233,78,33,45,Opelka R.,17,168,88,80,2022-04-28,Munich,BMW Open,Clay,2.5,1.53,1
Auger-Aliassime F.,12,268,163,105,Taberner C.,181,37,13,24,2022-04-28,Estoril,Millennium Estoril Open,Clay,1.33,3.4,1
Bonzi B.,107,83,37,46,Korda S.,26,126,75,51,2022-04-28,Estoril,Millennium Estoril Open,Clay,3.2,1.36,0
Baez S.,72,95,47,48,Cilic M.,100,853,543,310,2022-04-28,Estoril,Millennium Estoril Open,Clay,1.72,2.1,1
Ruud C.,4,275,176,99,Van De Zandschulp B.,44,117,63,54,2022-04-29,Munich,BMW Open,Clay,1.28,3.75,0
Verdasco F.,244,962,537,425,Ramos-Vinolas A.,82,437,204,233,2022-04-29,Estoril,Millennium Estoril Open,Clay,3.2,1.36,0
Gasquet R.,48,948,581,367,Baez S.,72,95,47,48,2022-04-29,Estoril,Millennium Estoril Open,Clay,3.0,1.4,0
Davidovich Fokina A.,39,168,84,84,Tiafoe F.,10,303,158,145,2022-04-29,Estoril,Millennium Estoril Open,Clay,1.44,2.75,0
Auger-Aliassime F.,12,268,163,105,Korda S.,26,126,75,51,2022-04-29,Estoril,Millennium Estoril Open,Clay,1.8,2.0,0
Rune H.,6,131,83,48,Ruusuvuori E.,55,158,79,79,2022-04-29,Munich,BMW Open,Clay,1.53,2.5,1
Basilashvili N.,118,301,138,163,Kecmanovic M.,40,210,107,103,2022-04-29,Munich,BMW Open,Clay,3.2,1.36,0
Otte O.,233,78,33,45,Tabilo A.,122,44,21,23,2022-04-29,Munich,BMW Open,Clay,1.72,2.1,1
Van De Zandschulp B.,44,117,63,54,Kecmanovic M.,40,210,107,103,2022-04-30,Munich,BMW Open,Clay,2.5,1.53,1
Rune H.,6,131,83,48,Otte O.,233,78,33,45,2022-04-30,Munich,BMW Open,Clay,1.3,3.5,1
Korda S.,26,126,75,51,Tiafoe F.,10,303,158,145,2022-04-30,Estoril,Millennium Estoril Open,Clay,1.36,3.2,0
Baez S.,72,95,47,48,Ramos-Vinolas A.,82,437,204,233,2022-04-30,Estoril,Millennium Estoril Open,Clay,1.61,2.3,1
Van De Zandschulp B.,44,117,63,54,Rune H.,6,131,83,48,2022-05-01,Munich,BMW Open,Clay,2.62,1.5,0
Sonego L.,43,221,107,114,Draper J.,55,51,29,22,2022-05-01,Madrid,Mutua Madrid Open,Clay,1.3,3.5,0
Krajinovic F.,93,240,115,125,Isner J.,114,755,465,290,2022-05-01,Madrid,Mutua Madrid Open,Clay,2.37,1.57,0
Delbonis F.,131,340,152,188,Evans D.,30,251,124,127,2022-05-01,Madrid,Mutua Madrid Open,Clay,1.72,2.1,0
Tiafoe F.,10,303,158,145,Baez S.,72,95,47,48,2022-05-01,Estoril,Millennium Estoril Open,Clay,2.37,1.57,0
Pouille L.,675,259,134,125,Khachanov K.,11,378,217,161,2022-05-02,Madrid,Mutua Madrid Open,Clay,5.0,1.16,1
Humbert U.,36,170,80,90,Shapovalov D.,29,298,166,132,2022-05-02,Madrid,Mutua Madrid Open,Clay,2.2,1.66,0
Murray A.,44,932,687,245,Thiem D.,116,517,327,190,2022-05-02,Madrid,Mutua Madrid Open,Clay,2.2,1.66,1
Dimitrov G.,20,651,389,262,Cressy M.,96,96,42,54,2022-05-02,Madrid,Mutua Madrid Open,Clay,1.33,3.4,1
Kwon S.W.,68,108,53,55,Norrie C.,13,287,172,115,2022-05-02,Madrid,Mutua Madrid Open,Clay,3.5,1.3,0
Goffin D.,123,522,296,226,Karatsev A.,75,136,66,70,2022-05-02,Madrid,Mutua Madrid Open,Clay,1.66,2.2,1
Paire B.,149,527,237,290,Schwartzman D.,95,428,233,195,2022-05-02,Madrid,Mutua Madrid Open,Clay,4.5,1.2,0
Harris L.,186,129,59,70,Davidovich Fokina A.,39,168,84,84,2022-05-02,Madrid,Mutua Madrid Open,Clay,3.4,1.33,0
Monfils G.,323,816,510,306,Gimeno Valero C.,369,1,0,1,2022-05-02,Madrid,Mutua Madrid Open,Clay,1.25,4.0,1
Ivashka I.,113,159,78,81,Musetti L.,18,143,79,64,2022-05-02,Madrid,Mutua Madrid Open,Clay,2.75,1.44,0
Lajovic D.,66,378,163,215,Coric B.,15,343,185,158,2022-05-02,Madrid,Mutua Madrid Open,Clay,1.8,2.0,1
Paul T.,14,204,111,93,Sinner J.,8,224,153,71,2022-05-02,Madrid,Mutua Madrid Open,Clay,4.0,1.25,0
De Minaur A.,19,272,161,111,Martinez P.,135,118,50,68,2022-05-02,Madrid,Mutua Madrid Open,Clay,1.5,2.62,1
Basilashvili N.,118,301,138,163,Fognini F.,128,742,383,359,2022-05-02,Madrid,Mutua Madrid Open,Clay,2.5,1.53,1
Alcaraz C.,1,164,130,34,Basilashvili N.,118,301,138,163,2022-05-03,Madrid,Mutua Madrid Open,Clay,1.08,8.0,1
Shapovalov D.,29,298,166,132,Murray A.,44,932,687,245,2022-05-03,Madrid,Mutua Madrid Open,Clay,1.5,2.62,0
Monfils G.,323,816,510,306,Djokovic N.,2,1207,1012,195,2022-05-03,Madrid,Mutua Madrid Open,Clay,4.5,1.2,0
Rublev A.,7,392,255,137,Draper J.,55,51,29,22,2022-05-03,Madrid,Mutua Madrid Open,Clay,1.14,5.5,1
Opelka R.,17,168,88,80,Korda S.,26,126,75,51,2022-05-03,Madrid,Mutua Madrid Open,Clay,2.2,1.66,0
Van De Zandschulp B.,44,117,63,54,Carreno Busta P.,16,352,214,138,2022-05-03,Madrid,Mutua Madrid Open,Clay,3.2,1.36,1
Kecmanovic M.,40,210,107,103,Bublik A.,25,219,110,109,2022-05-03,Madrid,Mutua Madrid Open,Clay,1.33,3.4,1
Brooksby J.,39,79,46,33,Bautista Agut R.,25,379,234,145,2022-05-03,Madrid,Mutua Madrid Open,Clay,2.1,1.72,0
Cilic M.,100,853,543,310,Ramos-Vinolas A.,82,437,204,233,2022-05-03,Madrid,Mutua Madrid Open,Clay,1.72,2.1,1
Dellien H.,164,70,22,48,Hurkacz H.,17,238,137,101,2022-05-03,Madrid,Mutua Madrid Open,Clay,3.5,1.3,0
Garin C.,101,190,103,87,Tiafoe F.,10,303,158,145,2022-05-03,Madrid,Mutua Madrid Open,Clay,2.1,1.72,1
Dimitrov G.,20,651,389,262,Schwartzman D.,95,428,233,195,2022-05-04,Madrid,Mutua Madrid Open,Clay,2.5,1.53,1
Pouille L.,675,259,134,125,Tsitsipas S.,5,390,264,126,2022-05-04,Madrid,Mutua Madrid Open,Clay,10.0,1.06,0
Auger-Aliassime F.,12,268,163,105,Garin C.,101,190,103,87,2022-05-04,Madrid,Mutua Madrid Open,Clay,1.5,2.62,1
De Minaur A.,19,272,161,111,Sinner J.,8,224,153,71,2022-05-04,Madrid,Mutua Madrid Open,Clay,2.75,1.44,0
Musetti L.,18,143,79,64,Korda S.,26,126,75,51,2022-05-04,Madrid,Mutua Madrid Open,Clay,2.62,1.5,1
Goffin D.,123,522,296,226,Van De Zandschulp B.,44,117,63,54,2022-05-04,Madrid,Mutua Madrid Open,Clay,2.1,1.72,1
Norrie C.,13,287,172,115,Isner J.,114,755,465,290,2022-05-04,Madrid,Mutua Madrid Open,Clay,1.66,2.2,1
Kecmanovic M.,40,210,107,103,Nadal R.,2,1223,1017,206,2022-05-04,Madrid,Mutua Madrid Open,Clay,3.4,1.33,0
Bautista Agut R.,25,379,234,145,Evans D.,30,251,124,127,2022-05-04,Madrid,Mutua Madrid Open,Clay,1.3,3.5,0
Ruud C.,4,275,176,99,Lajovic D.,66,378,163,215,2022-05-04,Madrid,Mutua Madrid Open,Clay,1.12,6.0,0
Davidovich Fokina A.,39,168,84,84,Hurkacz H.,17,238,137,101,2022-05-04,Madrid,Mutua Madrid Open,Clay,1.72,2.1,0
Cilic M.,100,853,543,310,Zverev A.,19,500,346,154,2022-05-04,Madrid,Mutua Madrid Open,Clay,5.0,1.16,0
Norrie C.,13,287,172,115,Alcaraz C.,1,164,130,34,2022-05-05,Madrid,Mutua Madrid Open,Clay,5.0,1.16,0
Djokovic N.,2,1207,1012,195,Murray A.,44,932,687,245,2022-05-05,Madrid,Mutua Madrid Open,Clay,1.12,6.0,1
Evans D.,30,251,124,127,Rublev A.,7,392,255,137,2022-05-05,Madrid,Mutua Madrid Open,Clay,4.33,1.22,0
Hurkacz H.,17,238,137,101,Lajovic D.,66,378,163,215,2022-05-05,Madrid,Mutua Madrid Open,Clay,1.28,3.75,1
Zverev A.,19,500,346,154,Musetti L.,18,143,79,64,2022-05-05,Madrid,Mutua Madrid Open,Clay,1.28,3.75,1
Goffin D.,123,522,296,226,Nadal R.,2,1223,1017,206,2022-05-05,Madrid,Mutua Madrid Open,Clay,6.0,1.12,0
Auger-Aliassime F.,12,268,163,105,Sinner J.,8,224,153,71,2022-05-05,Madrid,Mutua Madrid Open,Clay,2.37,1.57,1
Dimitrov G.,20,651,389,262,Tsitsipas S.,5,390,264,126,2022-05-05,Madrid,Mutua Madrid Open,Clay,3.5,1.3,0
Djokovic N.,2,1207,1012,195,Hurkacz H.,17,238,137,101,2022-05-06,Madrid,Mutua Madrid Open,Clay,1.3,3.5,1
Alcaraz C.,1,164,130,34,Nadal R.,2,1223,1017,206,2022-05-06,Madrid,Mutua Madrid Open,Clay,1.8,2.0,1
Tsitsipas S.,5,390,264,126,Rublev A.,7,392,255,137,2022-05-06,Madrid,Mutua Madrid Open,Clay,1.4,3.0,1
Zverev A.,19,500,346,154,Auger-Aliassime F.,12,268,163,105,2022-05-06,Madrid,Mutua Madrid Open,Clay,1.5,2.62,1
Djokovic N.,2,1207,1012,195,Alcaraz C.,1,164,130,34,2022-05-07,Madrid,Mutua Madrid Open,Clay,1.72,2.1,0
Zverev A.,19,500,346,154,Tsitsipas S.,5,390,264,126,2022-05-07,Madrid,Mutua Madrid Open,Clay,2.3,1.61,1
Cilic M.,100,853,543,310,Arnaldi M.,76,18,9,9,2022-05-08,Rome,Internazionali BNL d'Italia,Clay,1.16,5.0,1
Harris L.,186,129,59,70,Karatsev A.,75,136,66,70,2022-05-08,Rome,Internazionali BNL d'Italia,Clay,2.2,1.66,0
Garin C.,101,190,103,87,Passaro F.,126,10,3,7,2022-05-08,Rome,Internazionali BNL d'Italia,Clay,1.3,3.5,1
Krajinovic F.,93,240,115,125,Tiafoe F.,10,303,158,145,2022-05-08,Rome,Internazionali BNL d'Italia,Clay,2.3,1.61,1
Alcaraz C.,1,164,130,34,Zverev A.,19,500,346,154,2022-05-08,Madrid,Mutua Madrid Open,Clay,1.53,2.5,1
Delbonis F.,131,340,152,188,Carreno Busta P.,16,352,214,138,2022-05-09,Rome,Internazionali BNL d'Italia,Clay,4.33,1.22,0
Lajovic D.,66,378,163,215,De Minaur A.,19,272,161,111,2022-05-09,Rome,Internazionali BNL d'Italia,Clay,2.2,1.66,0
Thiem D.,116,517,327,190,Fognini F.,128,742,383,359,2022-05-09,Rome,Internazionali BNL d'Italia,Clay,2.37,1.57,0
Ramos-Vinolas A.,82,437,204,233,Paul T.,14,204,111,93,2022-05-09,Rome,Internazionali BNL d'Italia,Clay,1.66,2.2,0
Korda S.,26,126,75,51,Van De Zandschulp B.,44,117,63,54,2022-05-09,Rome,Internazionali BNL d'Italia,Clay,1.61,2.3,0
Zeppieri G.,129,13,4,9,Khachanov K.,11,378,217,161,2022-05-09,Rome,Internazionali BNL d'Italia,Clay,3.75,1.28,0
Giron M.,69,150,68,82,Bublik A.,25,219,110,109,2022-05-09,Rome,Internazionali BNL d'Italia,Clay,2.1,1.72,1
Shapovalov D.,29,298,166,132,Sonego L.,43,221,107,114,2022-05-09,Rome,Internazionali BNL d'Italia,Clay,1.9,1.9,1
Djere L.,38,243,120,123,Coric B.,15,343,185,158,2022-05-09,Rome,Internazionali BNL d'Italia,Clay,1.5,2.62,1
Brooksby J.,39,79,46,33,Cobolli F.,148,14,5,9,2022-05-09,Rome,Internazionali BNL d'Italia,Clay,1.53,2.5,1
Davidovich Fokina A.,39,168,84,84,Ivashka I.,113,159,78,81,2022-05-09,Rome,Internazionali BNL d'Italia,Clay,1.33,3.4,1
Opelka R.,17,168,88,80,Wawrinka S.,72,854,535,319,2022-05-09,Rome,Internazionali BNL d'Italia,Clay,1.33,3.4,0
Basilashvili N.,118,301,138,163,Evans D.,30,251,124,127,2022-05-09,Rome,Internazionali BNL d'Italia,Clay,2.1,1.72,1
Garin C.,101,190,103,87,Ruusuvuori E.,55,158,79,79,2022-05-10,Rome,Internazionali BNL d'Italia,Clay,2.0,1.8,1
Krajinovic F.,93,240,115,125,Rublev A.,7,392,255,137,2022-05-10,Rome,Internazionali BNL d'Italia,Clay,5.0,1.16,1
Auger-Aliassime F.,12,268,163,105,Davidovich Fokina A.,39,168,84,84,2022-05-10,Rome,Internazionali BNL d'Italia,Clay,1.72,2.1,1
Basilashvili N.,118,301,138,163,Shapovalov D.,29,298,166,132,2022-05-10,Rome,Internazionali BNL d'Italia,Clay,2.37,1.57,0
Djokovic N.,2,1207,1012,195,Karatsev A.,75,136,66,70,2022-05-10,Rome,Internazionali BNL d'Italia,Clay,1.08,8.0,1
Van De Zandschulp B.,44,117,63,54,Ruud C.,4,275,176,99,2022-05-10,Rome,Internazionali BNL d'Italia,Clay,2.75,1.44,0
Goffin D.,123,522,296,226,Hurkacz H.,17,238,137,101,2022-05-10,Rome,Internazionali BNL d'Italia,Clay,2.2,1.66,1
Cerundolo F.,21,104,58,46,Isner J.,114,755,465,290,2022-05-10,Rome,Internazionali BNL d'Italia,Clay,2.0,1.8,0
Dimitrov G.,20,651,389,262,Nakashima B.,70,106,57,49,2022-05-10,Rome,Internazionali BNL d'Italia,Clay,1.28,3.75,1
Baez S.,72,95,47,48,Griekspoor T.,37,97,47,50,2022-05-10,Rome,Internazionali BNL d'Italia,Clay,1.36,3.2,1
Sinner J.,8,224,153,71,Martinez P.,135,118,50,68,2022-05-10,Rome,Internazionali BNL d'Italia,Clay,1.16,5.0,1
Nardi L.,151,11,2,9,Norrie C.,13,287,172,115,2022-05-10,Rome,Internazionali BNL d'Italia,Clay,5.5,1.14,0
Schwartzman D.,95,428,233,195,Kecmanovic M.,40,210,107,103,2022-05-10,Rome,Internazionali BNL d'Italia,Clay,1.61,2.3,1
Zverev A.,19,500,346,154,Baez S.,72,95,47,48,2022-05-11,Rome,Internazionali BNL d'Italia,Clay,1.2,4.5,1
Carreno Busta P.,16,352,214,138,Khachanov K.,11,378,217,161,2022-05-11,Rome,Internazionali BNL d'Italia,Clay,1.5,2.62,0
Nadal R.,2,1223,1017,206,Isner J.,114,755,465,290,2022-05-11,Rome,Internazionali BNL d'Italia,Clay,1.1,7.0,1
Dimitrov G.,20,651,389,262,Tsitsipas S.,5,390,264,126,2022-05-11,Rome,Internazionali BNL d'Italia,Clay,4.33,1.22,0
Schwartzman D.,95,428,233,195,Giron M.,69,150,68,82,2022-05-11,Rome,Internazionali BNL d'Italia,Clay,1.12,6.0,0
Brooksby J.,39,79,46,33,Goffin D.,123,522,296,226,2022-05-11,Rome,Internazionali BNL d'Italia,Clay,3.2,1.36,1
Wawrinka S.,72,854,535,319,Djere L.,38,243,120,123,2022-05-11,Rome,Internazionali BNL d'Italia,Clay,3.2,1.36,1
Fognini F.,128,742,383,359,Sinner J.,8,224,153,71,2022-05-11,Rome,Internazionali BNL d'Italia,Clay,3.5,1.3,0
Norrie C.,13,287,172,115,Cilic M.,100,853,543,310,2022-05-11,Rome,Internazionali BNL d'Italia,Clay,1.61,2.3,0
Paul T.,14,204,111,93,De Minaur A.,19,272,161,111,2022-05-11,Rome,Internazionali BNL d'Italia,Clay,2.2,1.66,0
Shapovalov D.,29,298,166,132,Nadal R.,2,1223,1017,206,2022-05-12,Rome,Internazionali BNL d'Italia,Clay,5.0,1.16,1
Wawrinka S.,72,854,535,319,Djokovic N.,2,1207,1012,195,2022-05-12,Rome,Internazionali BNL d'Italia,Clay,9.0,1.07,0
Brooksby J.,39,79,46,33,Ruud C.,4,275,176,99,2022-05-12,Rome,Internazionali BNL d'Italia,Clay,4.33,1.22,0
Garin C.,101,190,103,87,Cilic M.,100,853,543,310,2022-05-12,Rome,Internazionali BNL d'Italia,Clay,2.37,1.57,1
Auger-Aliassime F.,12,268,163,105,Giron M.,69,150,68,82,2022-05-12,Rome,Internazionali BNL d'Italia,Clay,1.16,5.0,1
Tsitsipas S.,5,390,264,126,Khachanov K.,11,378,217,161,2022-05-12,Rome,Internazionali BNL d'Italia,Clay,1.2,4.5,1
Zverev A.,19,500,346,154,De Minaur A.,19,272,161,111,2022-05-12,Rome,Internazionali BNL d'Italia,Clay,1.22,4.33,1
Krajinovic F.,93,240,115,125,Sinner J.,8,224,153,71,2022-05-12,Rome,Internazionali BNL d'Italia,Clay,4.0,1.25,0
Garin C.,101,190,103,87,Zverev A.,19,500,346,154,2022-05-13,Rome,Internazionali BNL d'Italia,Clay,5.5,1.14,0
Sinner J.,8,224,153,71,Tsitsipas S.,5,390,264,126,2022-05-13,Rome,Internazionali BNL d'Italia,Clay,2.75,1.44,0
Shapovalov D.,29,298,166,132,Ruud C.,4,275,176,99,2022-05-13,Rome,Internazionali BNL d'Italia,Clay,3.0,1.4,0
Auger-Aliassime F.,12,268,163,105,Djokovic N.,2,1207,1012,195,2022-05-13,Rome,Internazionali BNL d'Italia,Clay,5.0,1.16,0
Zverev A.,19,500,346,154,Tsitsipas S.,5,390,264,126,2022-05-14,Rome,Internazionali BNL d'Italia,Clay,2.3,1.61,0
Djokovic N.,2,1207,1012,195,Ruud C.,4,275,176,99,2022-05-14,Rome,Internazionali BNL d'Italia,Clay,1.2,4.5,1
Rinderknech A.,67,96,46,50,Rune H.,6,131,83,48,2022-05-15,Lyon,Lyon Open,Clay,4.0,1.25,0
Bublik A.,25,219,110,109,Majchrzak K.,121,50,19,31,2022-05-15,Geneva,Geneva Open,Clay,2.3,1.61,0
Djokovic N.,2,1207,1012,195,Tsitsipas S.,5,390,264,126,2022-05-15,Rome,Internazionali BNL d'Italia,Clay,1.44,2.75,1
Mannarino A.,27,567,264,303,Karatsev A.,75,136,66,70,2022-05-15,Lyon,Lyon Open,Clay,3.75,1.28,1
Griekspoor T.,37,97,47,50,Paul T.,14,204,111,93,2022-05-15,Geneva,Geneva Open,Clay,2.2,1.66,1
Cerundolo F.,21,104,58,46,Duckworth J.,123,143,55,88,2022-05-15,Lyon,Lyon Open,Clay,1.12,6.0,1
Khachanov K.,11,378,217,161,Simon G.,188,869,491,378,2022-05-16,Lyon,Lyon Open,Clay,1.12,6.0,1
Molcan A.,120,86,45,41,Tsonga J.W.,297,672,444,228,2022-05-16,Lyon,Lyon Open,Clay,1.2,4.5,1
Martinez P.,135,118,50,68,Watanuki Y.,99,25,11,14,2022-05-16,Lyon,Lyon Open,Clay,1.12,6.0,0
Pouille L.,675,259,134,125,Otte O.,233,78,33,45,2022-05-16,Lyon,Lyon Open,Clay,2.62,1.5,0
Kwon S.W.,68,108,53,55,Bedene A.,347,291,131,160,2022-05-16,Lyon,Lyon Open,Clay,1.44,2.75,1
Humbert U.,36,170,80,90,Barrere G.,59,79,31,48,2022-05-16,Lyon,Lyon Open,Clay,1.5,2.62,1
Baez S.,72,95,47,48,Etcheverry T.,34,60,26,34,2022-05-16,Lyon,Lyon Open,Clay,1.2,4.5,1
Ivashka I.,113,159,78,81,Giron M.,69,150,68,82,2022-05-16,Geneva,Geneva Open,Clay,1.5,2.62,1
Berankis R.,212,249,104,145,Delbonis F.,131,340,152,188,2022-05-16,Geneva,Geneva Open,Clay,3.75,1.28,0
Millman J.,140,256,113,143,Gasquet R.,48,948,581,367,2022-05-16,Geneva,Geneva Open,Clay,2.37,1.57,0
Thiem D.,116,517,327,190,Cecchinato M.,108,204,79,125,2022-05-16,Geneva,Geneva Open,Clay,1.4,3.0,0
Ruusuvuori E.,55,158,79,79,Paire B.,149,527,237,290,2022-05-16,Geneva,Geneva Open,Clay,1.4,3.0,0
Medvedev D.,3,406,289,117,Gasquet R.,48,948,581,367,2022-05-17,Geneva,Geneva Open,Clay,1.4,3.0,0
De Minaur A.,19,272,161,111,Humbert U.,36,170,80,90,2022-05-17,Lyon,Lyon Open,Clay,1.36,3.2,1
Cerundolo F.,21,104,58,46,Norrie C.,13,287,172,115,2022-05-17,Lyon,Lyon Open,Clay,3.0,1.4,0
Baez S.,72,95,47,48,Otte O.,233,78,33,45,2022-05-17,Lyon,Lyon Open,Clay,1.4,3.0,1
Watanuki Y.,99,25,11,14,Kwon S.W.,68,108,53,55,2022-05-17,Lyon,Lyon Open,Clay,3.0,1.4,1
Gaston H.,109,58,24,34,Guinard M.,148,9,4,5,2022-05-17,Lyon,Lyon Open,Clay,1.72,2.1,0
Coria F.,108,99,43,56,Altmaier D.,51,79,28,51,2022-05-17,Lyon,Lyon Open,Clay,2.1,1.72,1
Bagnis F.,135,121,39,82,Basilashvili N.,118,301,138,163,2022-05-17,Geneva,Geneva Open,Clay,2.3,1.61,0
Andujar P.,323,404,164,240,Sousa J.,147,436,189,247,2022-05-17,Geneva,Geneva Open,Clay,1.61,2.3,0
Ramos-Vinolas A.,82,437,204,233,O Connell C.,74,65,26,39,2022-05-17,Geneva,Geneva Open,Clay,1.57,2.37,0
Nikles J.,317,4,1,3,Riedi L.,135,5,1,4,2022-05-17,Geneva,Geneva Open,Clay,2.2,1.66,1
Majchrzak K.,121,50,19,31,Cecchinato M.,108,204,79,125,2022-05-17,Geneva,Geneva Open,Clay,1.61,2.3,1
Kokkinakis T.,86,124,55,69,Fognini F.,128,742,383,359,2022-05-17,Geneva,Geneva Open,Clay,2.2,1.66,1
Rune H.,6,131,83,48,Mannarino A.,27,567,264,303,2022-05-18,Lyon,Lyon Open,Clay,1.1,7.0,1
Molcan A.,120,86,45,41,Khachanov K.,11,378,217,161,2022-05-18,Lyon,Lyon Open,Clay,2.5,1.53,1
Coria F.,108,99,43,56,Carreno Busta P.,16,352,214,138,2022-05-18,Lyon,Lyon Open,Clay,4.33,1.22,1
O Connell C.,74,65,26,39,Opelka R.,17,168,88,80,2022-05-18,Geneva,Geneva Open,Clay,2.0,1.8,0
Kokkinakis T.,86,124,55,69,Delbonis F.,131,340,152,188,2022-05-18,Geneva,Geneva Open,Clay,1.61,2.3,1
Griekspoor T.,37,97,47,50,Nikles J.,317,4,1,3,2022-05-18,Geneva,Geneva Open,Clay,1.22,4.33,1
Paire B.,149,527,237,290,Ruud C.,4,275,176,99,2022-05-18,Geneva,Geneva Open,Clay,6.0,1.12,0
Basilashvili N.,118,301,138,163,Sousa J.,147,436,189,247,2022-05-18,Geneva,Geneva Open,Clay,1.44,2.75,0
Shapovalov D.,29,298,166,132,Ivashka I.,113,159,78,81,2022-05-18,Geneva,Geneva Open,Clay,1.44,2.75,0
Opelka R.,17,168,88,80,Griekspoor T.,37,97,47,50,2022-05-19,Geneva,Geneva Open,Clay,1.61,2.3,1
Kokkinakis T.,86,124,55,69,Ruud C.,4,275,176,99,2022-05-19,Geneva,Geneva Open,Clay,4.5,1.2,0
Gasquet R.,48,948,581,367,Majchrzak K.,121,50,19,31,2022-05-19,Geneva,Geneva Open,Clay,1.72,2.1,1
Sousa J.,147,436,189,247,Ivashka I.,113,159,78,81,2022-05-19,Geneva,Geneva Open,Clay,3.0,1.4,1
Coria F.,108,99,43,56,Molcan A.,120,86,45,41,2022-05-19,Lyon,Lyon Open,Clay,2.2,1.66,0
Mmoh M.,112,55,20,35,Guinard M.,148,9,4,5,2022-05-19,Lyon,Lyon Open,Clay,2.37,1.57,0
De Minaur A.,19,272,161,111,Watanuki Y.,99,25,11,14,2022-05-19,Lyon,Lyon Open,Clay,1.16,5.0,1
Rune H.,6,131,83,48,Guinard M.,148,9,4,5,2022-05-19,Lyon,Lyon Open,Clay,1.14,5.5,1
Baez S.,72,95,47,48,Norrie C.,13,287,172,115,2022-05-19,Lyon,Lyon Open,Clay,1.72,2.1,0
De Minaur A.,19,272,161,111,Molcan A.,120,86,45,41,2022-05-20,Lyon,Lyon Open,Clay,1.66,2.2,0
Ruud C.,4,275,176,99,Opelka R.,17,168,88,80,2022-05-20,Geneva,Geneva Open,Clay,1.25,4.0,1
Gasquet R.,48,948,581,367,Sousa J.,147,436,189,247,2022-05-20,Geneva,Geneva Open,Clay,1.44,2.75,0
Rune H.,6,131,83,48,Norrie C.,13,287,172,115,2022-05-20,Lyon,Lyon Open,Clay,2.37,1.57,0
Norrie C.,13,287,172,115,Molcan A.,120,86,45,41,2022-05-21,Lyon,Lyon Open,Clay,1.61,2.3,1
Ruud C.,4,275,176,99,Sousa J.,147,436,189,247,2022-05-21,Geneva,Geneva Open,Clay,1.12,6.0,1
Alcaraz C.,1,164,130,34,Londero J.I.,142,83,34,49,2022-05-22,Paris,French Open,Clay,1.02,19.0,1
Zapata Miralles B.,54,80,32,48,Mmoh M.,112,55,20,35,2022-05-22,Paris,French Open,Clay,1.25,4.0,1
Kubler J.,77,53,24,29,Kudla D.,137,198,70,128,2022-05-22,Paris,French Open,Clay,1.5,2.62,1
Ofner S.,61,34,16,18,Zverev A.,19,500,346,154,2022-05-22,Paris,French Open,Clay,11.0,1.05,0
Ugo Carabelli C.,122,5,2,3,Karatsev A.,75,136,66,70,2022-05-22,Paris,French Open,Clay,2.2,1.66,1
Borges N.,69,28,10,18,Khachanov K.,11,378,217,161,2022-05-22,Paris,French Open,Clay,3.75,1.28,0
Popyrin A.,90,140,59,81,Fognini F.,128,742,383,359,2022-05-22,Paris,French Open,Clay,2.62,1.5,0
Griekspoor T.,37,97,47,50,Davidovich Fokina A.,39,168,84,84,2022-05-22,Paris,French Open,Clay,4.0,1.25,1
Cuevas P.,149,421,210,211,Brooksby J.,39,79,46,33,2022-05-22,Paris,French Open,Clay,3.0,1.4,1
Ramos-Vinolas A.,82,437,204,233,Kokkinakis T.,86,124,55,69,2022-05-22,Paris,French Open,Clay,2.0,1.8,1
Isner J.,114,755,465,290,Halys Q.,79,72,23,49,2022-05-22,Paris,French Open,Clay,1.5,2.62,1
Thiem D.,116,517,327,190,Dellien H.,164,70,22,48,2022-05-22,Paris,French Open,Clay,2.0,1.8,0
Coric B.,15,343,185,158,Taberner C.,181,37,13,24,2022-05-22,Paris,French Open,Clay,1.9,1.9,1
Dimitrov G.,20,651,389,262,Giron M.,69,150,68,82,2022-05-22,Paris,French Open,Clay,1.14,5.5,1
O Connell C.,74,65,26,39,Bedene A.,347,291,131,160,2022-05-22,Paris,French Open,Clay,1.28,3.75,0
Munar J.,104,178,75,103,Altmaier D.,51,79,28,51,2022-05-22,Paris,French Open,Clay,1.4,3.0,1
Kuznetsov An.,228,162,70,92,Schwartzman D.,95,428,233,195,2022-05-22,Paris,French Open,Clay,9.0,1.07,0
Barrere G.,59,79,31,48,Daniel T.,111,178,67,111,2022-05-22,Paris,French Open,Clay,3.5,1.3,1
Van De Zandschulp B.,44,117,63,54,Kotov P.,89,25,10,15,2022-05-22,Paris,French Open,Clay,1.28,3.75,1
Varillas J. P.,1345,20,9,11,Auger-Aliassime F.,12,268,163,105,2022-05-22,Paris,French Open,Clay,5.0,1.16,0
Mcdonald M.,60,190,87,103,Agamenone F.,136,5,3,2,2022-05-23,Paris,French Open,Clay,1.61,2.3,1
Nishioka Y.,31,215,99,116,Djokovic N.,2,1207,1012,195,2022-05-23,Paris,French Open,Clay,26.0,1.01,0
Cilic M.,100,853,543,310,Balazs A.,745,33,16,17,2022-05-23,Paris,French Open,Clay,1.06,10.0,1
Ymer M.,59,130,58,72,Duckworth J.,123,143,55,88,2022-05-23,Paris,French Open,Clay,1.33,3.4,1
Blancaneaux G.,152,6,0,6,Fucsovics M.,67,249,121,128,2022-05-23,Paris,French Open,Clay,3.4,1.33,0
Cachin P.,54,52,23,29,Gombos N.,114,66,21,45,2022-05-23,Paris,French Open,Clay,1.44,2.75,1
Kecmanovic M.,40,210,107,103,Etcheverry T.,34,60,26,34,2022-05-23,Paris,French Open,Clay,1.11,6.5,1
Nadal R.,2,1223,1017,206,Thompson J.,71,221,96,125,2022-05-23,Paris,French Open,Clay,1.01,23.0,1
Rodriguez Taverna S.,201,1,0,1,Fritz T.,9,356,205,151,2022-05-23,Paris,French Open,Clay,6.0,1.12,0
Moutet C.,80,118,50,68,Wawrinka S.,72,854,535,319,2022-05-23,Paris,French Open,Clay,2.3,1.61,1
Gojo B.,115,14,3,11,Giannessi A.,224,35,12,23,2022-05-23,Paris,French Open,Clay,1.72,2.1,1
Opelka R.,17,168,88,80,Krajinovic F.,93,240,115,125,2022-05-23,Paris,French Open,Clay,1.66,2.2,0
Baez S.,72,95,47,48,Lajovic D.,66,378,163,215,2022-05-23,Paris,French Open,Clay,1.33,3.4,1
Evans D.,30,251,124,127,Cerundolo F.,21,104,58,46,2022-05-23,Paris,French Open,Clay,2.0,1.8,1
Basilashvili N.,118,301,138,163,Cressy M.,96,96,42,54,2022-05-23,Paris,French Open,Clay,1.3,3.5,1
Norrie C.,13,287,172,115,Guinard M.,148,9,4,5,2022-05-23,Paris,French Open,Clay,1.08,8.0,1
Nakashima B.,70,106,57,49,Majchrzak K.,121,50,19,31,2022-05-23,Paris,French Open,Clay,2.0,1.8,1
Carreno Busta P.,16,352,214,138,Simon G.,188,869,491,378,2022-05-24,Paris,French Open,Clay,1.04,13.0,0
Musetti L.,18,143,79,64,Tsitsipas S.,5,390,264,126,2022-05-24,Paris,French Open,Clay,7.0,1.1,0
Vesely J.,528,288,130,158,Johnson S.,197,395,196,199,2022-05-24,Paris,French Open,Clay,1.61,2.3,0
Kwon S.W.,68,108,53,55,Rublev A.,7,392,255,137,2022-05-24,Paris,French Open,Clay,8.0,1.08,0
Fratangelo B.,695,62,22,40,Sinner J.,8,224,153,71,2022-05-24,Paris,French Open,Clay,10.0,1.06,0
Zeppieri G.,129,13,4,9,Hurkacz H.,17,238,137,101,2022-05-24,Paris,French Open,Clay,6.0,1.12,0
Cecchinato M.,108,204,79,125,Andujar P.,323,404,164,240,2022-05-24,Paris,French Open,Clay,1.9,1.9,1
Carballes Baena R.,64,207,91,116,Otte O.,233,78,33,45,2022-05-24,Paris,French Open,Clay,2.2,1.66,1
De Minaur A.,19,272,161,111,Gaston H.,109,58,24,34,2022-05-24,Paris,French Open,Clay,1.2,4.5,0
Tiafoe F.,10,303,158,145,Bonzi B.,107,83,37,46,2022-05-24,Paris,French Open,Clay,1.53,2.5,1
Delbonis F.,131,340,152,188,Mannarino A.,27,567,264,303,2022-05-24,Paris,French Open,Clay,1.36,3.2,1
Sonego L.,43,221,107,114,Gojowczyk P.,108,172,75,97,2022-05-24,Paris,French Open,Clay,1.08,8.0,1
Kolar Z.,119,4,1,3,Pouille L.,675,259,134,125,2022-05-24,Paris,French Open,Clay,1.9,1.9,1
Laaksonen H.,125,101,37,64,Martinez P.,135,118,50,68,2022-05-24,Paris,French Open,Clay,4.0,1.25,1
Tsonga J.W.,297,672,444,228,Ruud C.,4,275,176,99,2022-05-24,Paris,French Open,Clay,15.0,1.03,0
Sousa J.,147,436,189,247,Tseng C. H.,108,8,2,6,2022-05-24,Paris,French Open,Clay,1.8,2.0,1
Paire B.,149,527,237,290,Ivashka I.,113,159,78,81,2022-05-24,Paris,French Open,Clay,2.62,1.5,0
Ruusuvuori E.,55,158,79,79,Humbert U.,36,170,80,90,2022-05-24,Paris,French Open,Clay,1.66,2.2,1
Djere L.,38,243,120,123,Berankis R.,212,249,104,145,2022-05-24,Paris,French Open,Clay,1.12,6.0,1
Korda S.,26,126,75,51,Millman J.,140,256,113,143,2022-05-24,Paris,French Open,Clay,1.14,5.5,1
Shapovalov D.,29,298,166,132,Rune H.,6,131,83,48,2022-05-24,Paris,French Open,Clay,1.8,2.0,0
Molcan A.,120,86,45,41,Coria F.,108,99,43,56,2022-05-24,Paris,French Open,Clay,1.44,2.75,1
Gasquet R.,48,948,581,367,Harris L.,186,129,59,70,2022-05-24,Paris,French Open,Clay,1.5,2.62,1
Garin C.,101,190,103,87,Paul T.,14,204,111,93,2022-05-24,Paris,French Open,Clay,1.61,2.3,1
Goffin D.,123,522,296,226,Lehecka J.,33,61,30,31,2022-05-24,Paris,French Open,Clay,1.36,3.2,1
Rinderknech A.,67,96,46,50,Bublik A.,25,219,110,109,2022-05-24,Paris,French Open,Clay,1.53,2.5,0
Bagnis F.,135,121,39,82,Medvedev D.,3,406,289,117,2022-05-24,Paris,French Open,Clay,7.0,1.1,0
Schwartzman D.,95,428,233,195,Munar J.,104,178,75,103,2022-05-25,Paris,French Open,Clay,1.33,3.4,1
Moutet C.,80,118,50,68,Nadal R.,2,1223,1017,206,2022-05-25,Paris,French Open,Clay,15.0,1.03,0
Gasquet R.,48,948,581,367,Korda S.,26,126,75,51,2022-05-25,Paris,French Open,Clay,3.0,1.4,0
Coric B.,15,343,185,158,Dimitrov G.,20,651,389,262,2022-05-25,Paris,French Open,Clay,4.0,1.25,0
Fognini F.,128,742,383,359,Van De Zandschulp B.,44,117,63,54,2022-05-25,Paris,French Open,Clay,2.37,1.57,0
Nakashima B.,70,106,57,49,Griekspoor T.,37,97,47,50,2022-05-25,Paris,French Open,Clay,2.62,1.5,1
Molcan A.,120,86,45,41,Djokovic N.,2,1207,1012,195,2022-05-25,Paris,French Open,Clay,15.0,1.03,0
Alcaraz C.,1,164,130,34,Ramos-Vinolas A.,82,437,204,233,2022-05-25,Paris,French Open,Clay,1.03,15.0,1
Baez S.,72,95,47,48,Zverev A.,19,500,346,154,2022-05-25,Paris,French Open,Clay,5.5,1.14,0
Zapata Miralles B.,54,80,32,48,Fritz T.,9,356,205,151,2022-05-25,Paris,French Open,Clay,2.75,1.44,1
Kubler J.,77,53,24,29,Norrie C.,13,287,172,115,2022-05-25,Paris,French Open,Clay,8.0,1.08,0
Bedene A.,347,291,131,160,Cuevas P.,149,421,210,211,2022-05-25,Paris,French Open,Clay,2.5,1.53,1
Barrere G.,59,79,31,48,Isner J.,114,755,465,290,2022-05-25,Paris,French Open,Clay,4.0,1.25,0
Auger-Aliassime F.,12,268,163,105,Ugo Carabelli C.,122,5,2,3,2022-05-25,Paris,French Open,Clay,1.1,7.0,1
Dellien H.,164,70,22,48,Khachanov K.,11,378,217,161,2022-05-25,Paris,French Open,Clay,2.75,1.44,0
Gojo B.,115,14,3,11,Krajinovic F.,93,240,115,125,2022-05-25,Paris,French Open,Clay,5.0,1.16,0
Delbonis F.,131,340,152,188,Rublev A.,7,392,255,137,2022-05-26,Paris,French Open,Clay,6.0,1.12,0
Carballes Baena R.,64,207,91,116,Sinner J.,8,224,153,71,2022-05-26,Paris,French Open,Clay,9.0,1.07,0
Kolar Z.,119,4,1,3,Tsitsipas S.,5,390,264,126,2022-05-26,Paris,French Open,Clay,17.0,1.02,0
Johnson S.,197,395,196,199,Simon G.,188,869,491,378,2022-05-26,Paris,French Open,Clay,1.5,2.62,0
Ymer M.,59,130,58,72,Evans D.,30,251,124,127,2022-05-26,Paris,French Open,Clay,2.75,1.44,1
Hurkacz H.,17,238,137,101,Cecchinato M.,108,204,79,125,2022-05-26,Paris,French Open,Clay,1.14,5.5,1
Basilashvili N.,118,301,138,163,Mcdonald M.,60,190,87,103,2022-05-26,Paris,French Open,Clay,1.53,2.5,0
Garin C.,101,190,103,87,Ivashka I.,113,159,78,81,2022-05-26,Paris,French Open,Clay,1.5,2.62,1
Fucsovics M.,67,249,121,128,Cilic M.,100,853,543,310,2022-05-26,Paris,French Open,Clay,2.75,1.44,0
Gaston H.,109,58,24,34,Cachin P.,54,52,23,29,2022-05-26,Paris,French Open,Clay,1.9,1.9,1
Tiafoe F.,10,303,158,145,Goffin D.,123,522,296,226,2022-05-26,Paris,French Open,Clay,2.2,1.66,0
Bublik A.,25,219,110,109,Kecmanovic M.,40,210,107,103,2022-05-26,Paris,French Open,Clay,4.5,1.2,0
Djere L.,38,243,120,123,Medvedev D.,3,406,289,117,2022-05-26,Paris,French Open,Clay,3.2,1.36,0
Laaksonen H.,125,101,37,64,Rune H.,6,131,83,48,2022-05-26,Paris,French Open,Clay,6.0,1.12,0
Ruusuvuori E.,55,158,79,79,Ruud C.,4,275,176,99,2022-05-26,Paris,French Open,Clay,6.0,1.12,0
Sousa J.,147,436,189,247,Sonego L.,43,221,107,114,2022-05-26,Paris,French Open,Clay,3.0,1.4,0
Alcaraz C.,1,164,130,34,Korda S.,26,126,75,51,2022-05-27,Paris,French Open,Clay,1.16,5.0,1
Khachanov K.,11,378,217,161,Norrie C.,13,287,172,115,2022-05-27,Paris,French Open,Clay,2.5,1.53,1
Nakashima B.,70,106,57,49,Zverev A.,19,500,346,154,2022-05-27,Paris,French Open,Clay,8.0,1.08,0
Zapata Miralles B.,54,80,32,48,Isner J.,114,755,465,290,2022-05-27,Paris,French Open,Clay,2.37,1.57,1
Krajinovic F.,93,240,115,125,Auger-Aliassime F.,12,268,163,105,2022-05-27,Paris,French Open,Clay,3.5,1.3,0
Bedene A.,347,291,131,160,Djokovic N.,2,1207,1012,195,2022-05-27,Paris,French Open,Clay,21.0,1.01,0
Schwartzman D.,95,428,233,195,Dimitrov G.,20,651,389,262,2022-05-27,Paris,French Open,Clay,2.37,1.57,1
Van De Zandschulp B.,44,117,63,54,Nadal R.,2,1223,1017,206,2022-05-27,Paris,French Open,Clay,11.0,1.05,0
Ymer M.,59,130,58,72,Tsitsipas S.,5,390,264,126,2022-05-28,Paris,French Open,Clay,11.0,1.05,0
Rune H.,6,131,83,48,Gaston H.,109,58,24,34,2022-05-28,Paris,French Open,Clay,1.3,3.5,1
Sonego L.,43,221,107,114,Ruud C.,4,275,176,99,2022-05-28,Paris,French Open,Clay,5.0,1.16,0
Hurkacz H.,17,238,137,101,Goffin D.,123,522,296,226,2022-05-28,Paris,French Open,Clay,1.66,2.2,1
Rublev A.,7,392,255,137,Garin C.,101,190,103,87,2022-05-28,Paris,French Open,Clay,1.25,4.0,1
Kecmanovic M.,40,210,107,103,Medvedev D.,3,406,289,117,2022-05-28,Paris,French Open,Clay,2.2,1.66,0
Cilic M.,100,853,543,310,Simon G.,188,869,491,378,2022-05-28,Paris,French Open,Clay,1.22,4.33,1
Mcdonald M.,60,190,87,103,Sinner J.,8,224,153,71,2022-05-28,Paris,French Open,Clay,9.0,1.07,0
Schwartzman D.,95,428,233,195,Djokovic N.,2,1207,1012,195,2022-05-29,Paris,French Open,Clay,9.0,1.07,0
Zverev A.,19,500,346,154,Zapata Miralles B.,54,80,32,48,2022-05-29,Paris,French Open,Clay,1.06,10.0,1
Auger-Aliassime F.,12,268,163,105,Nadal R.,2,1223,1017,206,2022-05-29,Paris,French Open,Clay,5.5,1.14,0
Alcaraz C.,1,164,130,34,Khachanov K.,11,378,217,161,2022-05-29,Paris,French Open,Clay,1.1,7.0,1
Hurkacz H.,17,238,137,101,Ruud C.,4,275,176,99,2022-05-30,Paris,French Open,Clay,2.37,1.57,0
Rune H.,6,131,83,48,Tsitsipas S.,5,390,264,126,2022-05-30,Paris,French Open,Clay,4.5,1.2,1
Rublev A.,7,392,255,137,Sinner J.,8,224,153,71,2022-05-30,Paris,French Open,Clay,1.8,2.0,1
Cilic M.,100,853,543,310,Medvedev D.,3,406,289,117,2022-05-30,Paris,French Open,Clay,3.75,1.28,1
Alcaraz C.,1,164,130,34,Zverev A.,19,500,346,154,2022-05-31,Paris,French Open,Clay,1.22,4.33,0
Djokovic N.,2,1207,1012,195,Nadal R.,2,1223,1017,206,2022-05-31,Paris,French Open,Clay,1.44,2.75,0
Ruud C.,4,275,176,99,Rune H.,6,131,83,48,2022-06-01,Paris,French Open,Clay,1.44,2.75,1
Cilic M.,100,853,543,310,Rublev A.,7,392,255,137,2022-06-01,Paris,French Open,Clay,2.1,1.72,1
Nadal R.,2,1223,1017,206,Zverev A.,19,500,346,154,2022-06-03,Paris,French Open,Clay,1.33,3.4,1
Ruud C.,4,275,176,99,Cilic M.,100,853,543,310,2022-06-03,Paris,French Open,Clay,1.44,2.75,1
Ruud C.,4,275,176,99,Nadal R.,2,1223,1017,206,2022-06-05,Paris,French Open,Clay,5.5,1.16,0
Otte O.,233,78,33,45,Altmaier D.,51,79,28,51,2022-06-06,Stuttgart,Mercedes Cup,Grass,1.33,3.4,1
Gaston H.,109,58,24,34,Kwon S.W.,68,108,53,55,2022-06-06,'s-Hertogenbosch,Rosmalen Grass Court Championships,Grass,3.75,1.28,1
Paire B.,149,527,237,290,Sonego L.,43,221,107,114,2022-06-06,Stuttgart,Mercedes Cup,Grass,3.2,1.36,0
Albot R.,97,215,86,129,Sousa J.,147,436,189,247,2022-06-06,Stuttgart,Mercedes Cup,Grass,2.1,1.72,1
Struff J.L.,21,369,170,199,Giron M.,69,150,68,82,2022-06-06,Stuttgart,Mercedes Cup,Grass,2.5,1.53,1
Bonzi B.,107,83,37,46,Lopez F.,634,863,441,422,2022-06-06,Stuttgart,Mercedes Cup,Grass,1.3,3.5,1
Kyrgios N.,25,303,195,108,Lehecka J.,33,61,30,31,2022-06-07,Stuttgart,Mercedes Cup,Grass,1.22,4.33,1
Kudla D.,137,198,70,128,Bublik A.,25,219,110,109,2022-06-07,Stuttgart,Mercedes Cup,Grass,2.2,1.66,0
O Connell C.,74,65,26,39,Murray A.,44,932,687,245,2022-06-07,Stuttgart,Mercedes Cup,Grass,3.0,1.4,0
Humbert U.,36,170,80,90,Rinderknech A.,67,96,46,50,2022-06-07,Stuttgart,Mercedes Cup,Grass,1.4,3.0,0
Rodionov J.,118,26,9,17,Fucsovics M.,67,249,121,128,2022-06-07,Stuttgart,Mercedes Cup,Grass,3.2,1.36,0
Stricker D.,106,20,10,10,Cressy M.,96,96,42,54,2022-06-07,Stuttgart,Mercedes Cup,Grass,2.3,1.61,1
Van De Zandschulp B.,44,117,63,54,Ruusuvuori E.,55,158,79,79,2022-06-07,'s-Hertogenbosch,Rosmalen Grass Court Championships,Grass,1.66,2.2,0
Brooksby J.,39,79,46,33,De Jong J.,180,3,0,3,2022-06-07,'s-Hertogenbosch,Rosmalen Grass Court Championships,Grass,1.16,5.0,1
Seppi A.,141,758,363,395,Mannarino A.,27,567,264,303,2022-06-07,'s-Hertogenbosch,Rosmalen Grass Court Championships,Grass,3.0,1.4,0
Ebden M.,432,203,75,128,Van Rijthoven T.,110,19,10,9,2022-06-07,'s-Hertogenbosch,Rosmalen Grass Court Championships,Grass,1.53,2.5,0
Koepfer D.,84,86,38,48,Majchrzak K.,121,50,19,31,2022-06-07,'s-Hertogenbosch,Rosmalen Grass Court Championships,Grass,2.75,1.44,0
Khachanov K.,11,378,217,161,Tabilo A.,122,44,21,23,2022-06-07,'s-Hertogenbosch,Rosmalen Grass Court Championships,Grass,1.14,5.5,1
Nakashima B.,70,106,57,49,Paul T.,14,204,111,93,2022-06-07,'s-Hertogenbosch,Rosmalen Grass Court Championships,Grass,1.5,2.62,1
Griekspoor T.,37,97,47,50,Bedene A.,347,291,131,160,2022-06-07,'s-Hertogenbosch,Rosmalen Grass Court Championships,Grass,1.8,2.0,1
Haase R.,257,458,202,256,Querrey S.,287,678,369,309,2022-06-07,'s-Hertogenbosch,Rosmalen Grass Court Championships,Grass,3.0,1.4,0
Mcdonald M.,60,190,87,103,Ivashka I.,113,159,78,81,2022-06-07,'s-Hertogenbosch,Rosmalen Grass Court Championships,Grass,2.1,1.72,0
Berrettini M.,38,217,142,75,Albot R.,97,215,86,129,2022-06-08,Stuttgart,Mercedes Cup,Grass,1.28,3.75,1
Rinderknech A.,67,96,46,50,Bonzi B.,107,83,37,46,2022-06-08,Stuttgart,Mercedes Cup,Grass,2.1,1.72,0
Basilashvili N.,118,301,138,163,Musetti L.,18,143,79,64,2022-06-08,Stuttgart,Mercedes Cup,Grass,1.61,2.3,1
Shapovalov D.,29,298,166,132,Otte O.,233,78,33,45,2022-06-09,Stuttgart,Mercedes Cup,Grass,1.4,3.0,0
Brooksby J.,39,79,46,33,Gaston H.,109,58,24,34,2022-06-09,'s-Hertogenbosch,Rosmalen Grass Court Championships,Grass,1.25,4.0,0
Struff J.L.,21,369,170,199,Sonego L.,43,221,107,114,2022-06-09,Stuttgart,Mercedes Cup,Grass,2.62,1.5,0
Bublik A.,25,219,110,109,Murray A.,44,932,687,245,2022-06-09,Stuttgart,Mercedes Cup,Grass,2.2,1.66,0
Fucsovics M.,67,249,121,128,Hurkacz H.,17,238,137,101,2022-06-09,Stuttgart,Mercedes Cup,Grass,3.0,1.4,1
Stricker D.,106,20,10,10,Tsitsipas S.,5,390,264,126,2022-06-09,Stuttgart,Mercedes Cup,Grass,3.75,1.28,0
Kyrgios N.,25,303,195,108,Basilashvili N.,118,301,138,163,2022-06-09,Stuttgart,Mercedes Cup,Grass,1.28,3.75,1
Fritz T.,9,356,205,151,Van Rijthoven T.,110,19,10,9,2022-06-09,'s-Hertogenbosch,Rosmalen Grass Court Championships,Grass,1.2,4.5,0
Griekspoor T.,37,97,47,50,Auger-Aliassime F.,12,268,163,105,2022-06-09,'s-Hertogenbosch,Rosmalen Grass Court Championships,Grass,4.5,1.2,0
Nakashima B.,70,106,57,49,Querrey S.,287,678,369,309,2022-06-09,'s-Hertogenbosch,Rosmalen Grass Court Championships,Grass,1.53,2.5,1
Duckworth J.,123,143,55,88,Simon G.,188,869,491,378,2022-06-09,'s-Hertogenbosch,Rosmalen Grass Court Championships,Grass,1.72,2.1,0
Mannarino A.,27,567,264,303,De Minaur A.,19,272,161,111,2022-06-09,'s-Hertogenbosch,Rosmalen Grass Court Championships,Grass,3.2,1.36,1
Ruusuvuori E.,55,158,79,79,Ivashka I.,113,159,78,81,2022-06-09,'s-Hertogenbosch,Rosmalen Grass Court Championships,Grass,2.3,1.61,0
Khachanov K.,11,378,217,161,Majchrzak K.,121,50,19,31,2022-06-09,'s-Hertogenbosch,Rosmalen Grass Court Championships,Grass,1.36,3.2,1
Medvedev D.,3,406,289,117,Simon G.,188,869,491,378,2022-06-09,'s-Hertogenbosch,Rosmalen Grass Court Championships,Grass,1.06,10.0,1
Van Rijthoven T.,110,19,10,9,Gaston H.,109,58,24,34,2022-06-10,'s-Hertogenbosch,Rosmalen Grass Court Championships,Grass,2.0,1.8,1
Auger-Aliassime F.,12,268,163,105,Khachanov K.,11,378,217,161,2022-06-10,'s-Hertogenbosch,Rosmalen Grass Court Championships,Grass,1.33,3.4,1
Medvedev D.,3,406,289,117,Ivashka I.,113,159,78,81,2022-06-10,'s-Hertogenbosch,Rosmalen Grass Court Championships,Grass,1.2,4.5,1
Bonzi B.,107,83,37,46,Otte O.,233,78,33,45,2022-06-10,Stuttgart,Mercedes Cup,Grass,2.1,1.72,0
Sonego L.,43,221,107,114,Berrettini M.,38,217,142,75,2022-06-10,Stuttgart,Mercedes Cup,Grass,2.75,1.44,0
Murray A.,44,932,687,245,Tsitsipas S.,5,390,264,126,2022-06-10,Stuttgart,Mercedes Cup,Grass,2.3,1.61,1
Fucsovics M.,67,249,121,128,Kyrgios N.,25,303,195,108,2022-06-10,Stuttgart,Mercedes Cup,Grass,2.75,1.44,0
Mannarino A.,27,567,264,303,Nakashima B.,70,106,57,49,2022-06-10,'s-Hertogenbosch,Rosmalen Grass Court Championships,Grass,2.0,1.8,1
Otte O.,233,78,33,45,Berrettini M.,38,217,142,75,2022-06-11,Stuttgart,Mercedes Cup,Grass,3.0,1.4,0
Auger-Aliassime F.,12,268,163,105,Van Rijthoven T.,110,19,10,9,2022-06-11,'s-Hertogenbosch,Rosmalen Grass Court Championships,Grass,1.14,5.5,0
Medvedev D.,3,406,289,117,Mannarino A.,27,567,264,303,2022-06-11,'s-Hertogenbosch,Rosmalen Grass Court Championships,Grass,1.22,4.33,1
Murray A.,44,932,687,245,Kyrgios N.,25,303,195,108,2022-06-11,Stuttgart,Mercedes Cup,Grass,2.2,1.66,1
Murray A.,44,932,687,245,Berrettini M.,38,217,142,75,2022-06-12,Stuttgart,Mercedes Cup,Grass,1.9,1.9,0
Medvedev D.,3,406,289,117,Van Rijthoven T.,110,19,10,9,2022-06-12,'s-Hertogenbosch,Rosmalen Grass Court Championships,Grass,1.14,5.5,0
Broady L.,125,47,18,29,Cilic M.,100,853,543,310,2022-06-13,Queens Club,Queen's Club Championships,Grass,4.33,1.22,0
Bublik A.,25,219,110,109,Musetti L.,18,143,79,64,2022-06-13,Queens Club,Queen's Club Championships,Grass,1.44,2.75,1
Norrie C.,13,287,172,115,Dimitrov G.,20,651,389,262,2022-06-13,Queens Club,Queen's Club Championships,Grass,1.66,2.2,0
Fritz T.,9,356,205,151,Draper J.,55,51,29,22,2022-06-13,Queens Club,Queen's Club Championships,Grass,1.44,2.75,0
Opelka R.,17,168,88,80,De Minaur A.,19,272,161,111,2022-06-13,Queens Club,Queen's Club Championships,Grass,2.1,1.72,0
Ramos-Vinolas A.,82,437,204,233,Davidovich Fokina A.,39,168,84,84,2022-06-13,Queens Club,Queen's Club Championships,Grass,3.2,1.36,0
Ivashka I.,113,159,78,81,Struff J.L.,21,369,170,199,2022-06-13,Halle,Halle Open,Grass,1.36,3.2,1
Carreno Busta P.,16,352,214,138,Rune H.,6,131,83,48,2022-06-13,Halle,Halle Open,Grass,2.1,1.72,1
Basilashvili N.,118,301,138,163,Rublev A.,7,392,255,137,2022-06-13,Halle,Halle Open,Grass,4.0,1.25,1
Humbert U.,36,170,80,90,Albot R.,97,215,86,129,2022-06-13,Halle,Halle Open,Grass,1.36,3.2,1
Squire H.,291,1,0,1,Djere L.,38,243,120,123,2022-06-13,Halle,Halle Open,Grass,2.75,1.44,0
Huesler M.A.,88,58,21,37,Mcdonald M.,60,190,87,103,2022-06-13,Halle,Halle Open,Grass,2.37,1.57,0
Tiafoe F.,10,303,158,145,Wawrinka S.,72,854,535,319,2022-06-14,Queens Club,Queen's Club Championships,Grass,1.5,2.62,0
Kudla D.,137,198,70,128,Sonego L.,43,221,107,114,2022-06-14,Queens Club,Queen's Club Championships,Grass,2.3,1.61,1
Evans D.,30,251,124,127,Berrettini M.,38,217,142,75,2022-06-14,Queens Club,Queen's Club Championships,Grass,2.75,1.44,0
Brooksby J.,39,79,46,33,Krajinovic F.,93,240,115,125,2022-06-14,Queens Club,Queen's Club Championships,Grass,1.44,2.75,0
Cerundolo F.,21,104,58,46,Martinez P.,135,118,50,68,2022-06-14,Queens Club,Queen's Club Championships,Grass,2.1,1.72,1
Ruud C.,4,275,176,99,Peniston R.,268,13,6,7,2022-06-14,Queens Club,Queen's Club Championships,Grass,1.3,3.5,0
Van De Zandschulp B.,44,117,63,54,Jubb P.,219,4,0,4,2022-06-14,Queens Club,Queen's Club Championships,Grass,1.57,2.37,1
Halys Q.,79,72,23,49,Ruusuvuori E.,55,158,79,79,2022-06-14,Queens Club,Queen's Club Championships,Grass,2.37,1.57,0
Schwartzman D.,95,428,233,195,Querrey S.,287,678,369,309,2022-06-14,Queens Club,Queen's Club Championships,Grass,2.0,1.8,0
Korda S.,26,126,75,51,Garin C.,101,190,103,87,2022-06-14,Halle,Halle Open,Grass,1.28,3.75,1
Auger-Aliassime F.,12,268,163,105,Giron M.,69,150,68,82,2022-06-14,Halle,Halle Open,Grass,1.14,5.5,1
Molcan A.,120,86,45,41,Griekspoor T.,37,97,47,50,2022-06-14,Halle,Halle Open,Grass,2.62,1.5,0
Hurkacz H.,17,238,137,101,Cressy M.,96,96,42,54,2022-06-14,Halle,Halle Open,Grass,1.4,3.0,1
Kyrgios N.,25,303,195,108,Altmaier D.,51,79,28,51,2022-06-14,Halle,Halle Open,Grass,1.16,5.0,1
Tsitsipas S.,5,390,264,126,Bonzi B.,107,83,37,46,2022-06-14,Halle,Halle Open,Grass,1.3,3.5,1
Karatsev A.,75,136,66,70,Khachanov K.,11,378,217,161,2022-06-14,Halle,Halle Open,Grass,4.0,1.25,0
Kecmanovic M.,40,210,107,103,Otte O.,233,78,33,45,2022-06-14,Halle,Halle Open,Grass,1.8,2.0,0
Fucsovics M.,67,249,121,128,Bautista Agut R.,25,379,234,145,2022-06-14,Halle,Halle Open,Grass,1.72,2.1,0
Humbert U.,36,170,80,90,Hurkacz H.,17,238,137,101,2022-06-15,Halle,Halle Open,Grass,2.75,1.44,0
Dimitrov G.,20,651,389,262,Van De Zandschulp B.,44,117,63,54,2022-06-15,Queens Club,Queen's Club Championships,Grass,1.3,3.5,0
Davidovich Fokina A.,39,168,84,84,De Minaur A.,19,272,161,111,2022-06-15,Queens Club,Queen's Club Championships,Grass,2.75,1.44,1
Paul T.,14,204,111,93,Shapovalov D.,29,298,166,132,2022-06-15,Queens Club,Queen's Club Championships,Grass,2.75,1.44,1
Medvedev D.,3,406,289,117,Goffin D.,123,522,296,226,2022-06-15,Halle,Halle Open,Grass,1.2,4.5,1
Draper J.,55,51,29,22,Ruusuvuori E.,55,158,79,79,2022-06-15,Queens Club,Queen's Club Championships,Grass,1.57,2.37,0
Bublik A.,25,219,110,109,Cilic M.,100,853,543,310,2022-06-15,Queens Club,Queen's Club Championships,Grass,2.75,1.44,0
Kyrgios N.,25,303,195,108,Tsitsipas S.,5,390,264,126,2022-06-15,Halle,Halle Open,Grass,1.61,2.3,1
Mcdonald M.,60,190,87,103,Auger-Aliassime F.,12,268,163,105,2022-06-15,Halle,Halle Open,Grass,4.5,1.2,0
Korda S.,26,126,75,51,Carreno Busta P.,16,352,214,138,2022-06-15,Halle,Halle Open,Grass,1.36,3.2,0
Paul T.,14,204,111,93,Wawrinka S.,72,854,535,319,2022-06-16,Queens Club,Queen's Club Championships,Grass,1.61,2.3,1
Djere L.,38,243,120,123,Khachanov K.,11,378,217,161,2022-06-16,Halle,Halle Open,Grass,5.5,1.14,0
Kudla D.,137,198,70,128,Berrettini M.,38,217,142,75,2022-06-16,Queens Club,Queen's Club Championships,Grass,5.0,1.16,0
Cerundolo F.,21,104,58,46,Peniston R.,268,13,6,7,2022-06-16,Queens Club,Queen's Club Championships,Grass,2.5,1.53,0
Querrey S.,287,678,369,309,Krajinovic F.,93,240,115,125,2022-06-16,Queens Club,Queen's Club Championships,Grass,1.44,2.75,0
Basilashvili N.,118,301,138,163,Otte O.,233,78,33,45,2022-06-16,Halle,Halle Open,Grass,1.9,1.9,0
Griekspoor T.,37,97,47,50,Bautista Agut R.,25,379,234,145,2022-06-16,Halle,Halle Open,Grass,2.37,1.57,0
Ivashka I.,113,159,78,81,Medvedev D.,3,406,289,117,2022-06-16,Halle,Halle Open,Grass,5.0,1.16,0
Van De Zandschulp B.,44,117,63,54,Davidovich Fokina A.,39,168,84,84,2022-06-17,Queens Club,Queen's Club Championships,Grass,1.66,2.2,1
Paul T.,14,204,111,93,Berrettini M.,38,217,142,75,2022-06-17,Queens Club,Queen's Club Championships,Grass,3.2,1.36,0
Ruusuvuori E.,55,158,79,79,Cilic M.,100,853,543,310,2022-06-17,Queens Club,Queen's Club Championships,Grass,3.2,1.36,0
Krajinovic F.,93,240,115,125,Peniston R.,268,13,6,7,2022-06-17,Queens Club,Queen's Club Championships,Grass,1.5,2.62,1
Hurkacz H.,17,238,137,101,Auger-Aliassime F.,12,268,163,105,2022-06-17,Halle,Halle Open,Grass,2.5,1.53,1
Kyrgios N.,25,303,195,108,Carreno Busta P.,16,352,214,138,2022-06-17,Halle,Halle Open,Grass,1.25,4.0,1
Medvedev D.,3,406,289,117,Bautista Agut R.,25,379,234,145,2022-06-17,Halle,Halle Open,Grass,1.33,3.4,1
Khachanov K.,11,378,217,161,Otte O.,233,78,33,45,2022-06-17,Halle,Halle Open,Grass,1.61,2.3,0
Kyrgios N.,25,303,195,108,Hurkacz H.,17,238,137,101,2022-06-18,Halle,Halle Open,Grass,1.57,2.37,0
Medvedev D.,3,406,289,117,Otte O.,233,78,33,45,2022-06-18,Halle,Halle Open,Grass,1.14,5.5,1
Berrettini M.,38,217,142,75,Van De Zandschulp B.,44,117,63,54,2022-06-18,Queens Club,Queen's Club Championships,Grass,1.28,3.75,1
Cilic M.,100,853,543,310,Krajinovic F.,93,240,115,125,2022-06-18,Queens Club,Queen's Club Championships,Grass,1.2,4.5,0
Medvedev D.,3,406,289,117,Hurkacz H.,17,238,137,101,2022-06-19,Halle,Halle Open,Grass,1.4,3.0,0
Karatsev A.,75,136,66,70,Munar J.,104,178,75,103,2022-06-19,Mallorca,Mallorca Championships,Grass,1.8,2.0,1
Berrettini M.,38,217,142,75,Krajinovic F.,93,240,115,125,2022-06-19,Queens Club,Queen's Club Championships,Grass,1.16,5.0,1
Sousa J.,147,436,189,247,Mcdonald M.,60,190,87,103,2022-06-19,Mallorca,Mallorca Championships,Grass,2.62,1.5,0
Molcan A.,120,86,45,41,Kecmanovic M.,40,210,107,103,2022-06-19,Mallorca,Mallorca Championships,Grass,2.75,1.44,1
Lopez F.,634,863,441,422,Griekspoor T.,37,97,47,50,2022-06-20,Mallorca,Mallorca Championships,Grass,3.5,1.3,0
Delbonis F.,131,340,152,188,Bellier A.,190,9,4,5,2022-06-20,Mallorca,Mallorca Championships,Grass,2.37,1.57,0
Daniel T.,111,178,67,111,Bautista Agut R.,25,379,234,145,2022-06-20,Mallorca,Mallorca Championships,Grass,4.5,1.2,0
Bonzi B.,107,83,37,46,Tabilo A.,122,44,21,23,2022-06-20,Mallorca,Mallorca Championships,Grass,1.4,3.0,1
Ruusuvuori E.,55,158,79,79,Ivashka I.,113,159,78,81,2022-06-20,Mallorca,Mallorca Championships,Grass,2.37,1.57,0
De Minaur A.,19,272,161,111,Garin C.,101,190,103,87,2022-06-20,Eastbourne,Eastbourne International,Grass,1.16,5.0,1
Cressy M.,96,96,42,54,Opelka R.,17,168,88,80,2022-06-20,Eastbourne,Eastbourne International,Grass,2.1,1.72,1
Korda S.,26,126,75,51,Millman J.,140,256,113,143,2022-06-20,Eastbourne,Eastbourne International,Grass,1.28,3.75,0
Brooksby J.,39,79,46,33,Draper J.,55,51,29,22,2022-06-20,Eastbourne,Eastbourne International,Grass,2.0,1.8,0
Clarke J.,156,13,2,11,Nakashima B.,70,106,57,49,2022-06-20,Eastbourne,Eastbourne International,Grass,5.5,1.14,0
Tiafoe F.,10,303,158,145,Bublik A.,25,219,110,109,2022-06-20,Eastbourne,Eastbourne International,Grass,1.9,1.9,0
Sonego L.,43,221,107,114,Duckworth J.,123,143,55,88,2022-06-21,Eastbourne,Eastbourne International,Grass,1.33,3.4,1
Van De Zandschulp B.,44,117,63,54,Giron M.,69,150,68,82,2022-06-21,Mallorca,Mallorca Championships,Grass,1.44,2.75,0
Altmaier D.,51,79,28,51,Lajovic D.,66,378,163,215,2022-06-21,Mallorca,Mallorca Championships,Grass,1.53,2.5,1
Djere L.,38,243,120,123,Kyrgios N.,25,303,195,108,2022-06-21,Mallorca,Mallorca Championships,Grass,7.0,1.1,0
Baez S.,72,95,47,48,Thompson J.,71,221,96,125,2022-06-21,Mallorca,Mallorca Championships,Grass,3.75,1.28,1
Davidovich Fokina A.,39,168,84,84,Martinez P.,135,118,50,68,2022-06-21,Eastbourne,Eastbourne International,Grass,1.25,4.0,0
Mannarino A.,27,567,264,303,Evans D.,30,251,124,127,2022-06-21,Eastbourne,Eastbourne International,Grass,2.62,1.5,0
Paul T.,14,204,111,93,Cerundolo F.,21,104,58,46,2022-06-21,Eastbourne,Eastbourne International,Grass,1.28,3.75,1
Monteiro T.,121,171,69,102,Humbert U.,36,170,80,90,2022-06-21,Eastbourne,Eastbourne International,Grass,3.75,1.28,1
Rune H.,6,131,83,48,Peniston R.,268,13,6,7,2022-06-21,Eastbourne,Eastbourne International,Grass,1.53,2.5,0
Carreno Busta P.,16,352,214,138,Bellier A.,190,9,4,5,2022-06-22,Mallorca,Mallorca Championships,Grass,1.16,5.0,0
Giron M.,69,150,68,82,Mcdonald M.,60,190,87,103,2022-06-22,Mallorca,Mallorca Championships,Grass,2.3,1.61,1
Ivashka I.,113,159,78,81,Tsitsipas S.,5,390,264,126,2022-06-22,Mallorca,Mallorca Championships,Grass,2.62,1.5,0
Baez S.,72,95,47,48,Altmaier D.,51,79,28,51,2022-06-22,Mallorca,Mallorca Championships,Grass,1.66,2.2,0
Bonzi B.,107,83,37,46,Shapovalov D.,29,298,166,132,2022-06-22,Mallorca,Mallorca Championships,Grass,2.3,1.61,1
Karatsev A.,75,136,66,70,Medvedev D.,3,406,289,117,2022-06-22,Mallorca,Mallorca Championships,Grass,6.0,1.12,0
Kyrgios N.,25,303,195,108,Bautista Agut R.,25,379,234,145,2022-06-22,Mallorca,Mallorca Championships,Grass,1.61,2.3,0
Griekspoor T.,37,97,47,50,Molcan A.,120,86,45,41,2022-06-22,Mallorca,Mallorca Championships,Grass,1.61,2.3,1
De Minaur A.,19,272,161,111,Sonego L.,43,221,107,114,2022-06-22,Eastbourne,Eastbourne International,Grass,1.44,2.75,1
Millman J.,140,256,113,143,Bublik A.,25,219,110,109,2022-06-22,Eastbourne,Eastbourne International,Grass,2.75,1.44,0
Nakashima B.,70,106,57,49,Norrie C.,13,287,172,115,2022-06-22,Eastbourne,Eastbourne International,Grass,2.2,1.66,0
Monteiro T.,121,171,69,102,Fritz T.,9,356,205,151,2022-06-22,Eastbourne,Eastbourne International,Grass,3.75,1.28,0
Cressy M.,96,96,42,54,Evans D.,30,251,124,127,2022-06-22,Eastbourne,Eastbourne International,Grass,2.37,1.57,1
Sinner J.,8,224,153,71,Paul T.,14,204,111,93,2022-06-22,Eastbourne,Eastbourne International,Grass,1.61,2.3,0
Schwartzman D.,95,428,233,195,Draper J.,55,51,29,22,2022-06-22,Eastbourne,Eastbourne International,Grass,3.0,1.4,0
Altmaier D.,51,79,28,51,Bonzi B.,107,83,37,46,2022-06-23,Mallorca,Mallorca Championships,Grass,3.5,1.3,0
Tsitsipas S.,5,390,264,126,Giron M.,69,150,68,82,2022-06-23,Mallorca,Mallorca Championships,Grass,1.22,4.33,1
Medvedev D.,3,406,289,117,Bautista Agut R.,25,379,234,145,2022-06-23,Mallorca,Mallorca Championships,Grass,1.33,3.4,0
Norrie C.,13,287,172,115,Cressy M.,96,96,42,54,2022-06-23,Eastbourne,Eastbourne International,Grass,1.44,2.75,0
Bublik A.,25,219,110,109,Fritz T.,9,356,205,151,2022-06-23,Eastbourne,Eastbourne International,Grass,1.72,2.1,0
Draper J.,55,51,29,22,Peniston R.,268,13,6,7,2022-06-23,Eastbourne,Eastbourne International,Grass,1.4,3.0,1
De Minaur A.,19,272,161,111,Paul T.,14,204,111,93,2022-06-23,Eastbourne,Eastbourne International,Grass,1.4,3.0,1
Martinez P.,135,118,50,68,Peniston R.,268,13,6,7,2022-06-23,Eastbourne,Eastbourne International,Grass,3.0,1.4,0
Griekspoor T.,37,97,47,50,Bellier A.,190,9,4,5,2022-06-23,Mallorca,Mallorca Championships,Grass,1.33,3.4,0
Bonzi B.,107,83,37,46,Tsitsipas S.,5,390,264,126,2022-06-24,Mallorca,Mallorca Championships,Grass,2.75,1.44,0
Bautista Agut R.,25,379,234,145,Bellier A.,190,9,4,5,2022-06-24,Mallorca,Mallorca Championships,Grass,1.14,5.5,1
Fritz T.,9,356,205,151,De Minaur A.,19,272,161,111,2022-06-24,Eastbourne,Eastbourne International,Grass,2.1,1.72,1
Draper J.,55,51,29,22,Cressy M.,96,96,42,54,2022-06-24,Eastbourne,Eastbourne International,Grass,2.2,1.66,0
Bautista Agut R.,25,379,234,145,Tsitsipas S.,5,390,264,126,2022-06-25,Mallorca,Mallorca Championships,Grass,2.2,1.66,0
Fritz T.,9,356,205,151,Cressy M.,96,96,42,54,2022-06-25,Eastbourne,Eastbourne International,Grass,1.53,2.5,1
Gojowczyk P.,108,172,75,97,Otte O.,233,78,33,45,2022-06-27,London,Wimbledon,Grass,5.5,1.14,0
Fucsovics M.,67,249,121,128,Bublik A.,25,219,110,109,2022-06-27,London,Wimbledon,Grass,2.37,1.57,0
Duckworth J.,123,143,55,88,Murray A.,44,932,687,245,2022-06-27,London,Wimbledon,Grass,5.0,1.16,0
Griekspoor T.,37,97,47,50,Fognini F.,128,742,383,359,2022-06-27,London,Wimbledon,Grass,1.36,3.2,1
Lajovic D.,66,378,163,215,Carreno Busta P.,16,352,214,138,2022-06-27,London,Wimbledon,Grass,3.4,1.33,1
Millman J.,140,256,113,143,Kecmanovic M.,40,210,107,103,2022-06-27,London,Wimbledon,Grass,2.75,1.44,0
Sinner J.,8,224,153,71,Wawrinka S.,72,854,535,319,2022-06-27,London,Wimbledon,Grass,1.33,3.4,1
Van Rijthoven T.,110,19,10,9,Delbonis F.,131,340,152,188,2022-06-27,London,Wimbledon,Grass,1.12,6.0,1
Vesely J.,528,288,130,158,Coria F.,108,99,43,56,2022-06-27,London,Wimbledon,Grass,1.05,11.0,1
Djere L.,38,243,120,123,Tabilo A.,122,44,21,23,2022-06-27,London,Wimbledon,Grass,1.5,2.62,0
Struff J.L.,21,369,170,199,Alcaraz C.,1,164,130,34,2022-06-27,London,Wimbledon,Grass,4.0,1.25,0
Couacaud E.,158,9,2,7,Isner J.,114,755,465,290,2022-06-27,London,Wimbledon,Grass,5.0,1.16,0
Kokkinakis T.,86,124,55,69,Majchrzak K.,121,50,19,31,2022-06-27,London,Wimbledon,Grass,2.1,1.72,1
Vavassori A.,128,12,5,7,Tiafoe F.,10,303,158,145,2022-06-27,London,Wimbledon,Grass,6.5,1.11,0
Djokovic N.,2,1207,1012,195,Kwon S.W.,68,108,53,55,2022-06-27,London,Wimbledon,Grass,1.005,34.0,1
Rosol L.,226,259,110,149,Basilashvili N.,118,301,138,163,2022-06-27,London,Wimbledon,Grass,3.5,1.3,0
Halys Q.,79,72,23,49,Paire B.,149,527,237,290,2022-06-27,London,Wimbledon,Grass,1.36,3.2,1
Etcheverry T.,34,60,26,34,Humbert U.,36,170,80,90,2022-06-27,London,Wimbledon,Grass,6.5,1.11,0
Ruud C.,4,275,176,99,Ramos-Vinolas A.,82,437,204,233,2022-06-27,London,Wimbledon,Grass,1.2,4.5,1
Andujar P.,323,404,164,240,Norrie C.,13,287,172,115,2022-06-27,London,Wimbledon,Grass,17.0,1.02,0
Paul T.,14,204,111,93,Verdasco F.,244,962,537,425,2022-06-27,London,Wimbledon,Grass,1.14,5.5,1
Monteiro T.,121,171,69,102,Munar J.,104,178,75,103,2022-06-27,London,Wimbledon,Grass,1.61,2.3,0
Hurkacz H.,17,238,137,101,Davidovich Fokina A.,39,168,84,84,2022-06-27,London,Wimbledon,Grass,1.14,5.5,0
Purcell M.,78,28,9,19,Mannarino A.,27,567,264,303,2022-06-27,London,Wimbledon,Grass,3.75,1.28,0
Marterer M.,144,91,31,60,Bedene A.,347,291,131,160,2022-06-27,London,Wimbledon,Grass,2.1,1.72,1
Lehecka J.,33,61,30,31,Krajinovic F.,93,240,115,125,2022-06-28,London,Wimbledon,Grass,3.2,1.36,0
Draper J.,55,51,29,22,Bergs Z.,175,15,4,11,2022-06-28,London,Wimbledon,Grass,1.33,3.4,1
Cerundolo F.,21,104,58,46,Nadal R.,2,1223,1017,206,2022-06-28,London,Wimbledon,Grass,13.0,1.04,0
Carballes Baena R.,64,207,91,116,Thompson J.,71,221,96,125,2022-06-28,London,Wimbledon,Grass,8.0,1.08,0
Auger-Aliassime F.,12,268,163,105,Cressy M.,96,96,42,54,2022-06-28,London,Wimbledon,Grass,1.3,3.5,0
Van De Zandschulp B.,44,117,63,54,Lopez F.,634,863,441,422,2022-06-28,London,Wimbledon,Grass,1.2,4.5,1
Ruusuvuori E.,55,158,79,79,Nishioka Y.,31,215,99,116,2022-06-28,London,Wimbledon,Grass,1.14,5.5,1
Tseng C.H.,145,9,1,8,Gray A.,288,4,1,3,2022-06-28,London,Wimbledon,Grass,1.66,2.2,0
Rinderknech A.,67,96,46,50,Shapovalov D.,29,298,166,132,2022-06-28,London,Wimbledon,Grass,3.2,1.36,0
Nakashima B.,70,106,57,49,Kuhn N.,259,12,3,9,2022-06-28,London,Wimbledon,Grass,1.08,8.0,1
Klein L.,142,7,2,5,Broady L.,125,47,18,29,2022-06-28,London,Wimbledon,Grass,2.2,1.66,0
Ritschard A.,163,9,3,6,Tsitsipas S.,5,390,264,126,2022-06-28,London,Wimbledon,Grass,11.0,1.05,0
Koepfer D.,84,86,38,48,Galan D.E.,76,78,33,45,2022-06-28,London,Wimbledon,Grass,1.57,2.37,0
Balazs A.,745,33,16,17,Bautista Agut R.,25,379,234,145,2022-06-28,London,Wimbledon,Grass,19.0,1.02,0
Novak D.,166,58,15,43,Bagnis F.,135,121,39,82,2022-06-28,London,Wimbledon,Grass,1.2,4.5,1
Evans D.,30,251,124,127,Kubler J.,77,53,24,29,2022-06-28,London,Wimbledon,Grass,1.25,4.0,0
Musetti L.,18,143,79,64,Fritz T.,9,356,205,151,2022-06-28,London,Wimbledon,Grass,5.0,1.16,0
Kozlov S.,108,35,9,26,Schwartzman D.,95,428,233,195,2022-06-28,London,Wimbledon,Grass,4.5,1.2,0
Giron M.,69,150,68,82,Rune H.,6,131,83,48,2022-06-28,London,Wimbledon,Grass,1.72,2.1,1
Kudla D.,137,198,70,128,Sonego L.,43,221,107,114,2022-06-28,London,Wimbledon,Grass,1.9,1.9,0
Zapata Miralles B.,54,80,32,48,Sock J.,166,324,177,147,2022-06-28,London,Wimbledon,Grass,3.4,1.33,0
Peniston R.,268,13,6,7,Laaksonen H.,125,101,37,64,2022-06-28,London,Wimbledon,Grass,1.2,4.5,1
Huesler M.A.,88,58,21,37,Grenier H.,122,16,5,11,2022-06-28,London,Wimbledon,Grass,1.57,2.37,0
Albot R.,97,215,86,129,Goffin D.,123,522,296,226,2022-06-28,London,Wimbledon,Grass,2.62,1.5,0
Baez S.,72,95,47,48,Daniel T.,111,178,67,111,2022-06-28,London,Wimbledon,Grass,1.9,1.9,1
Johnson S.,197,395,196,199,Dimitrov G.,20,651,389,262,2022-06-28,London,Wimbledon,Grass,4.5,1.2,1
Sousa J.,147,436,189,247,Gasquet R.,48,948,581,367,2022-06-28,London,Wimbledon,Grass,2.62,1.5,0
Taberner C.,181,37,13,24,Opelka R.,17,168,88,80,2022-06-28,London,Wimbledon,Grass,5.0,1.16,0
Martinez P.,135,118,50,68,Molcan A.,120,86,45,41,2022-06-28,London,Wimbledon,Grass,2.75,1.44,0
Kyrgios N.,25,303,195,108,Jubb P.,219,4,0,4,2022-06-28,London,Wimbledon,Grass,1.07,9.0,1
De Minaur A.,19,272,161,111,Dellien H.,164,70,22,48,2022-06-28,London,Wimbledon,Grass,1.03,15.0,1
Kukushkin M.,221,352,141,211,Brooksby J.,39,79,46,33,2022-06-28,London,Wimbledon,Grass,3.0,1.4,0
Berankis R.,212,249,104,145,Querrey S.,287,678,369,309,2022-06-28,London,Wimbledon,Grass,4.0,1.25,1
Harrison C.,251,15,6,9,Clarke J.,156,13,2,11,2022-06-28,London,Wimbledon,Grass,1.72,2.1,1
Kolar Z.,119,4,1,3,Bonzi B.,107,83,37,46,2022-06-28,London,Wimbledon,Grass,7.0,1.1,0
Garin C.,101,190,103,87,Ymer E.,186,81,24,57,2022-06-28,London,Wimbledon,Grass,1.53,2.5,1
Gaston H.,109,58,24,34,Popyrin A.,90,140,59,81,2022-06-28,London,Wimbledon,Grass,2.5,1.53,1
Altmaier D.,51,79,28,51,Ymer M.,59,130,58,72,2022-06-28,London,Wimbledon,Grass,1.9,1.9,0
Mcdonald M.,60,190,87,103,Borges N.,69,28,10,18,2022-06-28,London,Wimbledon,Grass,1.33,3.4,1
Mannarino A.,27,567,264,303,Paul T.,14,204,111,93,2022-06-29,London,Wimbledon,Grass,2.3,1.61,0
Ymer M.,59,130,58,72,Sinner J.,8,224,153,71,2022-06-29,London,Wimbledon,Grass,4.5,1.2,0
Davidovich Fokina A.,39,168,84,84,Vesely J.,528,288,130,158,2022-06-29,London,Wimbledon,Grass,1.61,2.3,0
Harrison C.,251,15,6,9,Otte O.,233,78,33,45,2022-06-29,London,Wimbledon,Grass,5.0,1.16,0
Isner J.,114,755,465,290,Murray A.,44,932,687,245,2022-06-29,London,Wimbledon,Grass,3.2,1.36,1
Griekspoor T.,37,97,47,50,Alcaraz C.,1,164,130,34,2022-06-29,London,Wimbledon,Grass,3.4,1.33,0
Van Rijthoven T.,110,19,10,9,Opelka R.,17,168,88,80,2022-06-29,London,Wimbledon,Grass,1.8,2.0,1
Basilashvili N.,118,301,138,163,Halys Q.,79,72,23,49,2022-06-29,London,Wimbledon,Grass,1.66,2.2,1
Kecmanovic M.,40,210,107,103,Tabilo A.,122,44,21,23,2022-06-29,London,Wimbledon,Grass,1.22,4.33,1
Bublik A.,25,219,110,109,Lajovic D.,66,378,163,215,2022-06-29,London,Wimbledon,Grass,1.2,4.5,1
Djokovic N.,2,1207,1012,195,Kokkinakis T.,86,124,55,69,2022-06-29,London,Wimbledon,Grass,1.02,17.0,1
Marterer M.,144,91,31,60,Tiafoe F.,10,303,158,145,2022-06-29,London,Wimbledon,Grass,4.5,1.2,0
Humbert U.,36,170,80,90,Ruud C.,4,275,176,99,2022-06-29,London,Wimbledon,Grass,2.37,1.57,1
Peniston R.,268,13,6,7,Johnson S.,197,395,196,199,2022-06-29,London,Wimbledon,Grass,1.66,2.2,0
Baez S.,72,95,47,48,Goffin D.,123,522,296,226,2022-06-29,London,Wimbledon,Grass,2.37,1.57,0
Munar J.,104,178,75,103,Norrie C.,13,287,172,115,2022-06-29,London,Wimbledon,Grass,6.5,1.11,0
Draper J.,55,51,29,22,De Minaur A.,19,272,161,111,2022-06-30,London,Wimbledon,Grass,2.37,1.57,0
Brooksby J.,39,79,46,33,Bonzi B.,107,83,37,46,2022-06-30,London,Wimbledon,Grass,2.2,1.66,1
Nadal R.,2,1223,1017,206,Berankis R.,212,249,104,145,2022-06-30,London,Wimbledon,Grass,1.03,15.0,1
Shapovalov D.,29,298,166,132,Nakashima B.,70,106,57,49,2022-06-30,London,Wimbledon,Grass,1.61,2.3,0
Bautista Agut R.,25,379,234,145,Galan D.E.,76,78,33,45,2022-06-30,London,Wimbledon,Grass,1.1,7.0,0
Garin C.,101,190,103,87,Grenier H.,122,16,5,11,2022-06-30,London,Wimbledon,Grass,1.4,3.0,1
Tsitsipas S.,5,390,264,126,Thompson J.,71,221,96,125,2022-06-30,London,Wimbledon,Grass,1.2,4.5,1
Gaston H.,109,58,24,34,Sonego L.,43,221,107,114,2022-06-30,London,Wimbledon,Grass,4.0,1.25,0
Krajinovic F.,93,240,115,125,Kyrgios N.,25,303,195,108,2022-06-30,London,Wimbledon,Grass,3.75,1.28,0
Gray A.,288,4,1,3,Fritz T.,9,356,205,151,2022-06-30,London,Wimbledon,Grass,11.0,1.05,0
Ruusuvuori E.,55,158,79,79,Van De Zandschulp B.,44,117,63,54,2022-06-30,London,Wimbledon,Grass,2.1,1.72,0
Molcan A.,120,86,45,41,Giron M.,69,150,68,82,2022-06-30,London,Wimbledon,Grass,2.3,1.61,1
Gasquet R.,48,948,581,367,Mcdonald M.,60,190,87,103,2022-06-30,London,Wimbledon,Grass,2.2,1.66,1
Schwartzman D.,95,428,233,195,Broady L.,125,47,18,29,2022-06-30,London,Wimbledon,Grass,1.33,3.4,0
Kecmanovic M.,40,210,107,103,Djokovic N.,2,1207,1012,195,2022-07-01,London,Wimbledon,Grass,17.0,1.02,0
Otte O.,233,78,33,45,Alcaraz C.,1,164,130,34,2022-07-01,London,Wimbledon,Grass,3.4,1.33,0
Sinner J.,8,224,153,71,Isner J.,114,755,465,290,2022-07-01,London,Wimbledon,Grass,1.57,2.37,1
Norrie C.,13,287,172,115,Johnson S.,197,395,196,199,2022-07-01,London,Wimbledon,Grass,1.28,3.75,1
Vesely J.,528,288,130,158,Paul T.,14,204,111,93,2022-07-01,London,Wimbledon,Grass,2.75,1.44,0
Bublik A.,25,219,110,109,Tiafoe F.,10,303,158,145,2022-07-01,London,Wimbledon,Grass,1.8,2.0,0
Basilashvili N.,118,301,138,163,Van Rijthoven T.,110,19,10,9,2022-07-01,London,Wimbledon,Grass,3.0,1.4,0
Novak D.,166,58,15,43,Kubler J.,77,53,24,29,2022-07-01,London,Wimbledon,Grass,2.5,1.53,0
Cressy M.,96,96,42,54,Sock J.,166,324,177,147,2022-07-01,London,Wimbledon,Grass,1.44,2.75,0
Goffin D.,123,522,296,226,Humbert U.,36,170,80,90,2022-07-01,London,Wimbledon,Grass,1.66,2.2,1
Nadal R.,2,1223,1017,206,Sonego L.,43,221,107,114,2022-07-02,London,Wimbledon,Grass,1.16,5.0,1
Molcan A.,120,86,45,41,Fritz T.,9,356,205,151,2022-07-02,London,Wimbledon,Grass,4.5,1.2,0
Nakashima B.,70,106,57,49,Galan D.E.,76,78,33,45,2022-07-02,London,Wimbledon,Grass,1.1,7.0,1
Kyrgios N.,25,303,195,108,Tsitsipas S.,5,390,264,126,2022-07-02,London,Wimbledon,Grass,1.72,2.1,1
Gasquet R.,48,948,581,367,Van De Zandschulp B.,44,117,63,54,2022-07-02,London,Wimbledon,Grass,3.2,1.36,0
Sock J.,166,324,177,147,Kubler J.,77,53,24,29,2022-07-02,London,Wimbledon,Grass,1.57,2.37,0
Brooksby J.,39,79,46,33,Garin C.,101,190,103,87,2022-07-02,London,Wimbledon,Grass,1.4,3.0,0
De Minaur A.,19,272,161,111,Broady L.,125,47,18,29,2022-07-02,London,Wimbledon,Grass,1.12,6.0,1
Tiafoe F.,10,303,158,145,Goffin D.,123,522,296,226,2022-07-03,London,Wimbledon,Grass,2.0,1.8,0
Paul T.,14,204,111,93,Norrie C.,13,287,172,115,2022-07-03,London,Wimbledon,Grass,2.5,1.53,0
Alcaraz C.,1,164,130,34,Sinner J.,8,224,153,71,2022-07-03,London,Wimbledon,Grass,1.36,3.2,0
Djokovic N.,2,1207,1012,195,Van Rijthoven T.,110,19,10,9,2022-07-03,London,Wimbledon,Grass,1.05,11.0,1
Garin C.,101,190,103,87,De Minaur A.,19,272,161,111,2022-07-04,London,Wimbledon,Grass,5.5,1.14,1
Nakashima B.,70,106,57,49,Kyrgios N.,25,303,195,108,2022-07-04,London,Wimbledon,Grass,3.5,1.3,0
Kubler J.,77,53,24,29,Fritz T.,9,356,205,151,2022-07-04,London,Wimbledon,Grass,4.33,1.22,0
Van De Zandschulp B.,44,117,63,54,Nadal R.,2,1223,1017,206,2022-07-04,London,Wimbledon,Grass,5.0,1.16,0
Goffin D.,123,522,296,226,Norrie C.,13,287,172,115,2022-07-05,London,Wimbledon,Grass,2.75,1.44,0
Sinner J.,8,224,153,71,Djokovic N.,2,1207,1012,195,2022-07-05,London,Wimbledon,Grass,6.5,1.11,0
Nadal R.,2,1223,1017,206,Fritz T.,9,356,205,151,2022-07-06,London,Wimbledon,Grass,1.44,2.75,1
Garin C.,101,190,103,87,Kyrgios N.,25,303,195,108,2022-07-06,London,Wimbledon,Grass,4.33,1.22,0
Norrie C.,13,287,172,115,Djokovic N.,2,1207,1012,195,2022-07-08,London,Wimbledon,Grass,10.0,1.06,0
Nadal R.,2,1223,1017,206,Kyrgios N.,25,303,195,108,2022-07-08,London,Wimbledon,Grass,2.3,1.61,0
Djokovic N.,2,1207,1012,195,Kyrgios N.,25,303,195,108,2022-07-10,London,Wimbledon,Grass,1.28,3.75,1
Johnson S.,197,395,196,199,Kozlov S.,108,35,9,26,2022-07-11,Newport,Hall of Fame Championships,Grass,1.4,3.0,1
Sock J.,166,324,177,147,Albot R.,97,215,86,129,2022-07-11,Newport,Hall of Fame Championships,Grass,1.33,3.4,1
Thompson J.,71,221,96,125,Kubler J.,77,53,24,29,2022-07-11,Newport,Hall of Fame Championships,Grass,1.9,1.9,0
Gojowczyk P.,108,172,75,97,Humbert U.,36,170,80,90,2022-07-11,Newport,Hall of Fame Championships,Grass,4.5,1.2,1
Altmaier D.,51,79,28,51,Ymer E.,186,81,24,57,2022-07-11,Bastad,Nordea Open,Clay,1.72,2.1,0
Carreno Busta P.,16,352,214,138,Wawrinka S.,72,854,535,319,2022-07-11,Bastad,Nordea Open,Clay,1.53,2.5,1
Djere L.,38,243,120,123,Musetti L.,18,143,79,64,2022-07-11,Bastad,Nordea Open,Clay,1.8,2.0,1
Delbonis F.,131,340,152,188,Coria F.,108,99,43,56,2022-07-12,Bastad,Nordea Open,Clay,2.1,1.72,0
Eubanks C.,29,64,28,36,Koepfer D.,84,86,38,48,2022-07-12,Newport,Hall of Fame Championships,Grass,1.66,2.2,1
Blumberg W.,773,1,0,1,Bonzi B.,107,83,37,46,2022-07-12,Newport,Hall of Fame Championships,Grass,5.0,1.16,0
Lopez F.,634,863,441,422,Vesely J.,528,288,130,158,2022-07-12,Newport,Hall of Fame Championships,Grass,3.75,1.28,0
Broady L.,125,47,18,29,Duckworth J.,123,143,55,88,2022-07-12,Newport,Hall of Fame Championships,Grass,1.72,2.1,0
Purcell M.,78,28,9,19,Mannarino A.,27,567,264,303,2022-07-12,Newport,Hall of Fame Championships,Grass,3.0,1.4,1
Popyrin A.,90,140,59,81,Halys Q.,79,72,23,49,2022-07-12,Newport,Hall of Fame Championships,Grass,1.8,2.0,0
Van Rijthoven T.,110,19,10,9,Krueger M.,228,24,7,17,2022-07-12,Newport,Hall of Fame Championships,Grass,1.11,6.5,0
Querrey S.,287,678,369,309,Murray A.,44,932,687,245,2022-07-12,Newport,Hall of Fame Championships,Grass,3.4,1.33,0
Basilashvili N.,118,301,138,163,Gaston H.,109,58,24,34,2022-07-12,Bastad,Nordea Open,Clay,2.0,1.8,0
Huesler M.A.,88,58,21,37,Rune H.,6,131,83,48,2022-07-12,Bastad,Nordea Open,Clay,3.5,1.3,1
Sousa P.,475,36,9,27,Cerundolo F.,21,104,58,46,2022-07-12,Bastad,Nordea Open,Clay,3.5,1.3,0
Thiem D.,116,517,327,190,Ruusuvuori E.,55,158,79,79,2022-07-12,Bastad,Nordea Open,Clay,2.37,1.57,1
Sonego L.,43,221,107,114,Karatsev A.,75,136,66,70,2022-07-12,Bastad,Nordea Open,Clay,1.44,2.75,0
Sousa J.,147,436,189,247,Davidovich Fokina A.,39,168,84,84,2022-07-12,Bastad,Nordea Open,Clay,3.75,1.28,0
Ramos-Vinolas A.,82,437,204,233,Etcheverry T.,34,60,26,34,2022-07-12,Bastad,Nordea Open,Clay,1.57,2.37,1
Baez S.,72,95,47,48,Fognini F.,128,742,383,359,2022-07-12,Bastad,Nordea Open,Clay,1.4,3.0,1
Krueger M.,228,24,7,17,Cressy M.,96,96,42,54,2022-07-13,Newport,Hall of Fame Championships,Grass,4.0,1.25,0
Duckworth J.,123,143,55,88,Halys Q.,79,72,23,49,2022-07-13,Newport,Hall of Fame Championships,Grass,2.2,1.66,1
Purcell M.,78,28,9,19,Murray A.,44,932,687,245,2022-07-13,Newport,Hall of Fame Championships,Grass,5.0,1.16,0
Gojowczyk P.,108,172,75,97,Isner J.,114,755,465,290,2022-07-13,Newport,Hall of Fame Championships,Grass,4.5,1.2,0
Johnson S.,197,395,196,199,Vesely J.,528,288,130,158,2022-07-13,Newport,Hall of Fame Championships,Grass,2.0,1.8,1
Sock J.,166,324,177,147,Bublik A.,25,219,110,109,2022-07-13,Newport,Hall of Fame Championships,Grass,1.8,2.0,0
Karatsev A.,75,136,66,70,Gaston H.,109,58,24,34,2022-07-13,Bastad,Nordea Open,Clay,1.66,2.2,1
Schwartzman D.,95,428,233,195,Ymer E.,186,81,24,57,2022-07-13,Bastad,Nordea Open,Clay,1.25,4.0,1
Ruud C.,4,275,176,99,Cerundolo F.,21,104,58,46,2022-07-13,Bastad,Nordea Open,Clay,1.16,5.0,0
Ramos-Vinolas A.,82,437,204,233,Carreno Busta P.,16,352,214,138,2022-07-13,Bastad,Nordea Open,Clay,3.0,1.4,0
Bonzi B.,107,83,37,46,Eubanks C.,29,64,28,36,2022-07-13,Newport,Hall of Fame Championships,Grass,1.36,3.2,1
Kubler J.,77,53,24,29,Auger-Aliassime F.,12,268,163,105,2022-07-14,Newport,Hall of Fame Championships,Grass,3.75,1.28,1
Cressy M.,96,96,42,54,Johnson S.,197,395,196,199,2022-07-14,Newport,Hall of Fame Championships,Grass,1.44,2.75,1
Isner J.,114,755,465,290,Bonzi B.,107,83,37,46,2022-07-14,Newport,Hall of Fame Championships,Grass,1.66,2.2,1
Baez S.,72,95,47,48,Davidovich Fokina A.,39,168,84,84,2022-07-14,Bastad,Nordea Open,Clay,1.72,2.1,1
Rublev A.,7,392,255,137,Coria F.,108,99,43,56,2022-07-14,Bastad,Nordea Open,Clay,1.28,3.75,1
Huesler M.A.,88,58,21,37,Djere L.,38,243,120,123,2022-07-14,Bastad,Nordea Open,Clay,2.75,1.44,0
Bautista Agut R.,25,379,234,145,Thiem D.,116,517,327,190,2022-07-14,Bastad,Nordea Open,Clay,1.44,2.75,0
Bublik A.,25,219,110,109,Murray A.,44,932,687,245,2022-07-15,Newport,Hall of Fame Championships,Grass,2.37,1.57,1
Duckworth J.,123,143,55,88,Kubler J.,77,53,24,29,2022-07-15,Newport,Hall of Fame Championships,Grass,2.62,1.5,0
Rublev A.,7,392,255,137,Djere L.,38,243,120,123,2022-07-15,Bastad,Nordea Open,Clay,1.44,2.75,1
Baez S.,72,95,47,48,Thiem D.,116,517,327,190,2022-07-15,Bastad,Nordea Open,Clay,1.4,3.0,1
Schwartzman D.,95,428,233,195,Carreno Busta P.,16,352,214,138,2022-07-15,Bastad,Nordea Open,Clay,1.9,1.9,0
Cerundolo F.,21,104,58,46,Karatsev A.,75,136,66,70,2022-07-15,Bastad,Nordea Open,Clay,1.66,2.2,1
Baez S.,72,95,47,48,Rublev A.,7,392,255,137,2022-07-16,Bastad,Nordea Open,Clay,2.1,1.72,1
Cerundolo F.,21,104,58,46,Carreno Busta P.,16,352,214,138,2022-07-16,Bastad,Nordea Open,Clay,3.0,1.4,1
Isner J.,114,755,465,290,Cressy M.,96,96,42,54,2022-07-16,Newport,Hall of Fame Championships,Grass,2.1,1.72,0
Kubler J.,77,53,24,29,Bublik A.,25,219,110,109,2022-07-16,Newport,Hall of Fame Championships,Grass,2.37,1.57,0
Cressy M.,96,96,42,54,Bublik A.,25,219,110,109,2022-07-17,Newport,Hall of Fame Championships,Grass,2.2,1.66,1
Cerundolo F.,21,104,58,46,Baez S.,72,95,47,48,2022-07-17,Bastad,Nordea Open,Clay,2.75,1.44,1
Lajovic D.,66,378,163,215,Musetti L.,18,143,79,64,2022-07-18,Hamburg,European Open,Clay,2.37,1.57,0
Rehberg M.,412,3,0,3,Kovalik J.,172,68,24,44,2022-07-18,Hamburg,European Open,Clay,5.5,1.14,0
Khachanov K.,11,378,217,161,Struff J.L.,21,369,170,199,2022-07-18,Hamburg,European Open,Clay,1.72,2.1,1
Topo M.,478,4,0,4,Molcan A.,120,86,45,41,2022-07-18,Hamburg,European Open,Clay,6.0,1.12,0
Davidovich Fokina A.,39,168,84,84,Van De Zandschulp B.,44,117,63,54,2022-07-18,Hamburg,European Open,Clay,1.8,2.0,1
Martinez P.,135,118,50,68,Taberner C.,181,37,13,24,2022-07-18,Gstaad,Suisse Open Gstaad,Clay,1.57,2.37,1
Ritschard A.,163,9,3,6,Sousa J.,147,436,189,247,2022-07-18,Gstaad,Suisse Open Gstaad,Clay,2.37,1.57,1
Delbonis F.,131,340,152,188,Ymer M.,59,130,58,72,2022-07-18,Gstaad,Suisse Open Gstaad,Clay,1.8,2.0,1
Lehecka J.,33,61,30,31,Etcheverry T.,34,60,26,34,2022-07-18,Gstaad,Suisse Open Gstaad,Clay,2.0,1.8,1
Carballes Baena R.,64,207,91,116,Gasquet R.,48,948,581,367,2022-07-19,Gstaad,Suisse Open Gstaad,Clay,2.0,1.8,0
Cerundolo F.,21,104,58,46,Altmaier D.,51,79,28,51,2022-07-19,Hamburg,European Open,Clay,1.44,2.75,1
Schwartzman D.,95,428,233,195,Ruusuvuori E.,55,158,79,79,2022-07-19,Hamburg,European Open,Clay,1.36,3.2,0
Griekspoor T.,37,97,47,50,Rune H.,6,131,83,48,2022-07-19,Hamburg,European Open,Clay,2.37,1.57,1
Djere L.,38,243,120,123,Coric B.,15,343,185,158,2022-07-19,Hamburg,European Open,Clay,1.57,2.37,0
Carreno Busta P.,16,352,214,138,Nardi L.,151,11,2,9,2022-07-19,Hamburg,European Open,Clay,1.16,5.0,1
Bedene A.,347,291,131,160,Fognini F.,128,742,383,359,2022-07-19,Hamburg,European Open,Clay,3.2,1.36,0
Kuhn N.,259,12,3,9,Alcaraz C.,1,164,130,34,2022-07-19,Hamburg,European Open,Clay,13.0,1.04,0
Baez S.,72,95,47,48,Krajinovic F.,93,240,115,125,2022-07-19,Hamburg,European Open,Clay,1.44,2.75,0
Karatsev A.,75,136,66,70,Basilashvili N.,118,301,138,163,2022-07-19,Hamburg,European Open,Clay,1.72,2.1,1
Coria F.,108,99,43,56,Galan D.E.,76,78,33,45,2022-07-19,Hamburg,European Open,Clay,1.9,1.9,0
Stricker D.,106,20,10,10,Huesler M.A.,88,58,21,37,2022-07-19,Gstaad,Suisse Open Gstaad,Clay,2.75,1.44,1
Monteiro T.,121,171,69,102,Jarry N.,28,141,73,68,2022-07-19,Gstaad,Suisse Open Gstaad,Clay,1.8,2.0,0
Thiem D.,116,517,327,190,Gaston H.,109,58,24,34,2022-07-19,Gstaad,Suisse Open Gstaad,Clay,1.44,2.75,1
Paire B.,149,527,237,290,Ymer E.,186,81,24,57,2022-07-19,Gstaad,Suisse Open Gstaad,Clay,2.5,1.53,0
Varillas J.P.,77,22,10,12,Sonego L.,43,221,107,114,2022-07-19,Gstaad,Suisse Open Gstaad,Clay,2.37,1.57,1
Zapata Miralles B.,54,80,32,48,Munar J.,104,178,75,103,2022-07-19,Gstaad,Suisse Open Gstaad,Clay,2.2,1.66,0
Hanfmann Y.,50,99,50,49,Garin C.,101,190,103,87,2022-07-19,Gstaad,Suisse Open Gstaad,Clay,3.4,1.33,1
Coric B.,15,343,185,158,Griekspoor T.,37,97,47,50,2022-07-20,Hamburg,European Open,Clay,2.1,1.72,1
Kovalik J.,172,68,24,44,Davidovich Fokina A.,39,168,84,84,2022-07-20,Hamburg,European Open,Clay,5.0,1.16,0
Musetti L.,18,143,79,64,Ruusuvuori E.,55,158,79,79,2022-07-20,Hamburg,European Open,Clay,1.53,2.5,1
Berankis R.,212,249,104,145,Rublev A.,7,392,255,137,2022-07-20,Hamburg,European Open,Clay,8.0,1.08,0
Munar J.,104,178,75,103,Ritschard A.,163,9,3,6,2022-07-20,Gstaad,Suisse Open Gstaad,Clay,1.28,3.75,1
Molcan A.,120,86,45,41,Carreno Busta P.,16,352,214,138,2022-07-20,Hamburg,European Open,Clay,2.62,1.5,1
Karatsev A.,75,136,66,70,Galan D.E.,76,78,33,45,2022-07-21,Hamburg,European Open,Clay,1.57,2.37,1
Cerundolo F.,21,104,58,46,Rublev A.,7,392,255,137,2022-07-21,Hamburg,European Open,Clay,3.0,1.4,1
Fognini F.,128,742,383,359,Khachanov K.,11,378,217,161,2022-07-21,Hamburg,European Open,Clay,2.62,1.5,0
Jarry N.,28,141,73,68,Hanfmann Y.,50,99,50,49,2022-07-21,Gstaad,Suisse Open Gstaad,Clay,1.57,2.37,1
Ramos-Vinolas A.,82,437,204,233,Stricker D.,106,20,10,10,2022-07-21,Gstaad,Suisse Open Gstaad,Clay,1.4,3.0,1
Gasquet R.,48,948,581,367,Berrettini M.,38,217,142,75,2022-07-21,Gstaad,Suisse Open Gstaad,Clay,4.0,1.25,0
Varillas J.P.,77,22,10,12,Bautista Agut R.,25,379,234,145,2022-07-21,Gstaad,Suisse Open Gstaad,Clay,3.0,1.4,1
Thiem D.,116,517,327,190,Delbonis F.,131,340,152,188,2022-07-21,Gstaad,Suisse Open Gstaad,Clay,1.44,2.75,1
Martinez P.,135,118,50,68,Ymer E.,186,81,24,57,2022-07-21,Gstaad,Suisse Open Gstaad,Clay,1.61,2.3,1
Krajinovic F.,93,240,115,125,Alcaraz C.,1,164,130,34,2022-07-21,Hamburg,European Open,Clay,4.5,1.2,0
Lehecka J.,33,61,30,31,Ruud C.,4,275,176,99,2022-07-21,Gstaad,Suisse Open Gstaad,Clay,4.5,1.2,0
Berrettini M.,38,217,142,75,Martinez P.,135,118,50,68,2022-07-22,Gstaad,Suisse Open Gstaad,Clay,1.16,5.0,1
Coric B.,15,343,185,158,Molcan A.,120,86,45,41,2022-07-22,Hamburg,European Open,Clay,2.0,1.8,0
Jarry N.,28,141,73,68,Ramos-Vinolas A.,82,437,204,233,2022-07-22,Gstaad,Suisse Open Gstaad,Clay,2.0,1.8,0
Munar J.,104,178,75,103,Ruud C.,4,275,176,99,2022-07-22,Gstaad,Suisse Open Gstaad,Clay,4.0,1.25,0
Varillas J.P.,77,22,10,12,Thiem D.,116,517,327,190,2022-07-22,Gstaad,Suisse Open Gstaad,Clay,2.62,1.5,0
Cerundolo F.,21,104,58,46,Karatsev A.,75,136,66,70,2022-07-22,Hamburg,European Open,Clay,1.44,2.75,1
Khachanov K.,11,378,217,161,Alcaraz C.,1,164,130,34,2022-07-22,Hamburg,European Open,Clay,5.0,1.16,0
Musetti L.,18,143,79,64,Davidovich Fokina A.,39,168,84,84,2022-07-22,Hamburg,European Open,Clay,2.2,1.66,1
Alcaraz C.,1,164,130,34,Molcan A.,120,86,45,41,2022-07-23,Hamburg,European Open,Clay,1.11,6.5,1
Cerundolo F.,21,104,58,46,Musetti L.,18,143,79,64,2022-07-23,Hamburg,European Open,Clay,2.1,1.72,0
Ramos-Vinolas A.,82,437,204,233,Ruud C.,4,275,176,99,2022-07-23,Gstaad,Suisse Open Gstaad,Clay,4.5,1.2,0
Thiem D.,116,517,327,190,Berrettini M.,38,217,142,75,2022-07-23,Gstaad,Suisse Open Gstaad,Clay,2.37,1.57,0
Musetti L.,18,143,79,64,Alcaraz C.,1,164,130,34,2022-07-24,Hamburg,European Open,Clay,5.5,1.14,1
Ruud C.,4,275,176,99,Berrettini M.,38,217,142,75,2022-07-24,Gstaad,Suisse Open Gstaad,Clay,1.8,2.0,1
Poljicak M.,537,1,0,1,Cecchinato M.,108,204,79,125,2022-07-25,Umag,Croatia Open,Clay,3.5,1.3,0
Ymer M.,59,130,58,72,Munar J.,104,178,75,103,2022-07-25,Umag,Croatia Open,Clay,3.5,1.3,0
Fognini F.,128,742,383,359,Galan D.E.,76,78,33,45,2022-07-25,Umag,Croatia Open,Clay,1.72,2.1,0
Carballes Baena R.,64,207,91,116,Laaksonen H.,125,101,37,64,2022-07-25,Umag,Croatia Open,Clay,1.44,2.75,1
Coria F.,108,99,43,56,Garin C.,101,190,103,87,2022-07-25,Kitzbuhel,Generali Open,Clay,2.37,1.57,1
Rodionov J.,118,26,9,17,Casanova H.,321,1,0,1,2022-07-25,Kitzbuhel,Generali Open,Clay,1.4,3.0,1
Sachko V.,1041,3,0,3,Lajovic D.,66,378,163,215,2022-07-25,Kitzbuhel,Generali Open,Clay,5.0,1.16,0
Lehecka J.,33,61,30,31,Monteiro T.,121,171,69,102,2022-07-25,Kitzbuhel,Generali Open,Clay,2.2,1.66,1
Misolic F.,158,11,6,5,Dutra Da Silva D.,215,1,0,1,2022-07-25,Kitzbuhel,Generali Open,Clay,1.4,3.0,1
Varillas J. P.,1345,20,9,11,Taberner C.,181,37,13,24,2022-07-25,Kitzbuhel,Generali Open,Clay,1.33,3.4,1
Sousa J.,147,436,189,247,Kopriva V.,159,9,5,4,2022-07-25,Kitzbuhel,Generali Open,Clay,2.0,1.8,1
Zeppieri G.,129,13,4,9,Cachin P.,54,52,23,29,2022-07-25,Umag,Croatia Open,Clay,2.5,1.53,1
Thompson J.,71,221,96,125,Nakashima B.,70,106,57,49,2022-07-25,Atlanta,Atlanta Open,Hard,4.33,1.22,0
Popyrin A.,90,140,59,81,Millman J.,140,256,113,143,2022-07-25,Atlanta,Atlanta Open,Hard,1.9,1.9,0
Giron M.,69,150,68,82,Kwon S.W.,68,108,53,55,2022-07-25,Atlanta,Atlanta Open,Hard,1.72,2.1,0
Daniel T.,111,178,67,111,Korda S.,26,126,75,51,2022-07-25,Atlanta,Atlanta Open,Hard,2.62,1.5,1
Shevchenko A.,93,20,8,12,Thiem D.,116,517,327,190,2022-07-26,Kitzbuhel,Generali Open,Clay,5.0,1.16,0
Ofner S.,61,34,16,18,Gasquet R.,48,948,581,367,2022-07-26,Kitzbuhel,Generali Open,Clay,2.37,1.57,1
Hanfmann Y.,50,99,50,49,Melzer G.,188,46,16,30,2022-07-26,Kitzbuhel,Generali Open,Clay,1.53,2.5,1
Martinez P.,135,118,50,68,Jarry N.,28,141,73,68,2022-07-26,Kitzbuhel,Generali Open,Clay,1.8,2.0,1
Andujar P.,323,404,164,240,Sonego L.,43,221,107,114,2022-07-26,Kitzbuhel,Generali Open,Clay,2.75,1.44,1
Paire B.,149,527,237,290,Brooksby J.,39,79,46,33,2022-07-26,Atlanta,Atlanta Open,Hard,6.0,1.12,0
Ivashka I.,113,159,78,81,Halys Q.,79,72,23,49,2022-07-26,Atlanta,Atlanta Open,Hard,1.57,2.37,1
Sock J.,166,324,177,147,Paul T.,14,204,111,93,2022-07-26,Atlanta,Atlanta Open,Hard,2.3,1.61,0
Kudla D.,137,198,70,128,Mcdonald M.,60,190,87,103,2022-07-26,Atlanta,Atlanta Open,Hard,2.75,1.44,0
Shelton B.,43,34,13,21,Ramanathan R.,435,40,14,26,2022-07-26,Atlanta,Atlanta Open,Hard,1.57,2.37,1
Molcan A.,120,86,45,41,Ajdukovic D.,299,4,1,3,2022-07-26,Umag,Croatia Open,Clay,1.14,5.5,1
Etcheverry T.,34,60,26,34,Bagnis F.,135,121,39,82,2022-07-26,Umag,Croatia Open,Clay,1.8,2.0,0
Zapata Miralles B.,54,80,32,48,Prizmic D.,287,5,2,3,2022-07-26,Umag,Croatia Open,Clay,1.08,8.0,1
Moutet C.,80,118,50,68,Altmaier D.,51,79,28,51,2022-07-26,Umag,Croatia Open,Clay,1.66,2.2,1
Gombos N.,114,66,21,45,Delbonis F.,131,340,152,188,2022-07-26,Umag,Croatia Open,Clay,2.5,1.53,1
Agamenone F.,136,5,3,2,Djere L.,38,243,120,123,2022-07-26,Umag,Croatia Open,Clay,4.33,1.22,1
Bedene A.,347,291,131,160,Musetti L.,18,143,79,64,2022-07-26,Umag,Croatia Open,Clay,3.4,1.33,0
Lajovic D.,66,378,163,215,Karatsev A.,75,136,66,70,2022-07-27,Kitzbuhel,Generali Open,Clay,2.1,1.72,1
Mannarino A.,27,567,264,303,Gojowczyk P.,108,172,75,97,2022-07-27,Atlanta,Atlanta Open,Hard,,,1
Galan D.E.,76,78,33,45,Zeppieri G.,129,13,4,9,2022-07-27,Umag,Croatia Open,Clay,1.57,2.37,0
Molcan A.,120,86,45,41,Carballes Baena R.,64,207,91,116,2022-07-27,Umag,Croatia Open,Clay,1.5,2.62,0
Zapata Miralles B.,54,80,32,48,Rune H.,6,131,83,48,2022-07-27,Umag,Croatia Open,Clay,2.62,1.5,1
Munar J.,104,178,75,103,Sinner J.,8,224,153,71,2022-07-27,Umag,Croatia Open,Clay,3.0,1.4,0
Thiem D.,116,517,327,190,Ofner S.,61,34,16,18,2022-07-27,Kitzbuhel,Generali Open,Clay,1.25,4.0,1
Lehecka J.,33,61,30,31,Sousa J.,147,436,189,247,2022-07-27,Kitzbuhel,Generali Open,Clay,1.61,2.3,1
Andujar P.,323,404,164,240,Misolic F.,158,11,6,5,2022-07-27,Kitzbuhel,Generali Open,Clay,1.66,2.2,0
Paul T.,14,204,111,93,Kwon S.W.,68,108,53,55,2022-07-27,Atlanta,Atlanta Open,Hard,1.36,3.2,1
Bautista Agut R.,25,379,234,145,Rodionov J.,118,26,9,17,2022-07-27,Kitzbuhel,Generali Open,Clay,1.3,3.5,1
Ramos-Vinolas A.,82,437,204,233,Varillas J. P.,1345,20,9,11,2022-07-27,Kitzbuhel,Generali Open,Clay,1.66,2.2,1
Martinez P.,135,118,50,68,Coria F.,108,99,43,56,2022-07-27,Kitzbuhel,Generali Open,Clay,1.61,2.3,1
Kokkinakis T.,86,124,55,69,Martin A.,723,258,107,151,2022-07-27,Atlanta,Atlanta Open,Hard,1.12,6.0,0
Tiafoe F.,10,303,158,145,Daniel T.,111,178,67,111,2022-07-27,Atlanta,Atlanta Open,Hard,1.57,2.37,1
Nakashima B.,70,106,57,49,Millman J.,140,256,113,143,2022-07-27,Atlanta,Atlanta Open,Hard,1.33,3.4,1
Gakhov I.,198,3,1,2,Hanfmann Y.,50,99,50,49,2022-07-27,Kitzbuhel,Generali Open,Clay,,,0
Koepfer D.,84,86,38,48,Duckworth J.,123,143,55,88,2022-07-27,Atlanta,Atlanta Open,Hard,2.1,1.72,0
Johnson S.,197,395,196,199,Ivashka I.,113,159,78,81,2022-07-28,Atlanta,Atlanta Open,Hard,3.4,1.33,0
Cecchinato M.,108,204,79,125,Musetti L.,18,143,79,64,2022-07-28,Umag,Croatia Open,Clay,3.75,1.28,1
Bagnis F.,135,121,39,82,Moutet C.,80,118,50,68,2022-07-28,Umag,Croatia Open,Clay,2.37,1.57,1
Agamenone F.,136,5,3,2,Baez S.,72,95,47,48,2022-07-28,Umag,Croatia Open,Clay,5.0,1.16,1
Brooksby J.,39,79,46,33,Mcdonald M.,60,190,87,103,2022-07-28,Atlanta,Atlanta Open,Hard,1.5,2.62,1
Martin A.,723,258,107,151,Mannarino A.,27,567,264,303,2022-07-28,Atlanta,Atlanta Open,Hard,3.5,1.3,0
Hanfmann Y.,50,99,50,49,Thiem D.,116,517,327,190,2022-07-28,Kitzbuhel,Generali Open,Clay,3.75,1.28,1
Bautista Agut R.,25,379,234,145,Lehecka J.,33,61,30,31,2022-07-28,Kitzbuhel,Generali Open,Clay,1.36,3.2,1
Martinez P.,135,118,50,68,Ramos-Vinolas A.,82,437,204,233,2022-07-28,Kitzbuhel,Generali Open,Clay,1.72,2.1,0
Gombos N.,114,66,21,45,Alcaraz C.,1,164,130,34,2022-07-28,Umag,Croatia Open,Clay,11.0,1.05,0
Carballes Baena R.,64,207,91,116,Sinner J.,8,224,153,71,2022-07-29,Umag,Croatia Open,Clay,5.0,1.16,0
Zapata Miralles B.,54,80,32,48,Zeppieri G.,129,13,4,9,2022-07-29,Umag,Croatia Open,Clay,1.57,2.37,0
Agamenone F.,136,5,3,2,Cecchinato M.,108,204,79,125,2022-07-29,Umag,Croatia Open,Clay,2.37,1.57,1
Alcaraz C.,1,164,130,34,Bagnis F.,135,121,39,82,2022-07-29,Umag,Croatia Open,Clay,1.07,9.0,1
Isner J.,114,755,465,290,Shelton B.,43,34,13,21,2022-07-29,Atlanta,Atlanta Open,Hard,1.36,3.2,1
Misolic F.,158,11,6,5,Lajovic D.,66,378,163,215,2022-07-29,Kitzbuhel,Generali Open,Clay,3.0,1.4,1
Nakashima B.,70,106,57,49,Tiafoe F.,10,303,158,145,2022-07-29,Atlanta,Atlanta Open,Hard,2.0,1.8,0
Bautista Agut R.,25,379,234,145,Ramos-Vinolas A.,82,437,204,233,2022-07-29,Kitzbuhel,Generali Open,Clay,1.8,2.0,1
Duckworth J.,123,143,55,88,De Minaur A.,19,272,161,111,2022-07-29,Atlanta,Atlanta Open,Hard,3.5,1.3,0
Mannarino A.,27,567,264,303,De Minaur A.,19,272,161,111,2022-07-29,Atlanta,Atlanta Open,Hard,4.0,1.25,0
Ivashka I.,113,159,78,81,Paul T.,14,204,111,93,2022-07-29,Atlanta,Atlanta Open,Hard,2.62,1.5,1
Sinner J.,8,224,153,71,Agamenone F.,136,5,3,2,2022-07-30,Umag,Croatia Open,Clay,1.1,7.0,1
Hanfmann Y.,50,99,50,49,Misolic F.,158,11,6,5,2022-07-30,Kitzbuhel,Generali Open,Clay,1.5,2.62,0
Isner J.,114,755,465,290,Brooksby J.,39,79,46,33,2022-07-30,Atlanta,Atlanta Open,Hard,2.37,1.57,0
De Minaur A.,19,272,161,111,Ivashka I.,113,159,78,81,2022-07-30,Atlanta,Atlanta Open,Hard,1.53,2.5,1
Misolic F.,158,11,6,5,Bautista Agut R.,25,379,234,145,2022-07-30,Kitzbuhel,Generali Open,Clay,3.5,1.3,0
Alcaraz C.,1,164,130,34,Zeppieri G.,129,13,4,9,2022-07-30,Umag,Croatia Open,Clay,1.07,9.0,1
Brooksby J.,39,79,46,33,De Minaur A.,19,272,161,111,2022-07-31,Atlanta,Atlanta Open,Hard,1.72,2.1,0
Tiafoe F.,10,303,158,145,Brooksby J.,39,79,46,33,2022-07-31,Atlanta,Atlanta Open,Hard,2.1,1.72,0
Alcaraz C.,1,164,130,34,Sinner J.,8,224,153,71,2022-07-31,Umag,Croatia Open,Clay,1.61,2.3,0
Mannarino A.,27,567,264,303,Klahn B.,797,56,13,43,2022-08-01,Washington,Citi Open,Hard,1.16,5.0,1
Mmoh M.,112,55,20,35,Kudla D.,137,198,70,128,2022-08-01,Washington,Citi Open,Hard,2.2,1.66,0
Koepfer D.,84,86,38,48,Kwon S.W.,68,108,53,55,2022-08-01,Washington,Citi Open,Hard,2.1,1.72,1
Watanuki Y.,99,25,11,14,Edmund K.,473,233,113,120,2022-08-01,Washington,Citi Open,Hard,1.66,2.2,0
Ymer M.,59,130,58,72,Murray A.,44,932,687,245,2022-08-01,Washington,Citi Open,Hard,3.5,1.3,1
Wu T.L.,175,6,1,5,Popyrin A.,90,140,59,81,2022-08-01,Washington,Citi Open,Hard,2.5,1.53,0
Draper J.,55,51,29,22,Kozlov S.,108,35,9,26,2022-08-01,Washington,Citi Open,Hard,1.2,4.5,1
Wolf J.J.,45,75,39,36,Daniel T.,111,178,67,111,2022-08-01,Washington,Citi Open,Hard,2.75,1.44,1
Duckworth J.,123,143,55,88,Gojo B.,115,14,3,11,2022-08-01,Washington,Citi Open,Hard,1.57,2.37,0
Brooksby J.,39,79,46,33,Nishioka Y.,31,215,99,116,2022-08-02,Washington,Citi Open,Hard,1.33,3.4,0
Berankis R.,212,249,104,145,Halys Q.,79,72,23,49,2022-08-02,Los Cabos,Los Cabos Open,Hard,2.3,1.61,1
Pacheco Mendez R.,817,3,0,3,Hijikata R.,110,16,7,9,2022-08-02,Los Cabos,Los Cabos Open,Hard,10.0,1.06,0
Chappell N.,432,2,0,2,Tseng C. H.,108,8,2,6,2022-08-02,Los Cabos,Los Cabos Open,Hard,5.0,1.16,0
Purcell M.,78,28,9,19,Laaksonen H.,125,101,37,64,2022-08-02,Los Cabos,Los Cabos Open,Hard,1.44,2.75,1
Draper J.,55,51,29,22,Rublev A.,7,392,255,137,2022-08-02,Washington,Citi Open,Hard,3.2,1.36,0
Evans D.,30,251,124,127,Edmund K.,473,233,113,120,2022-08-02,Washington,Citi Open,Hard,1.44,2.75,1
Goffin D.,123,522,296,226,Sock J.,166,324,177,147,2022-08-02,Washington,Citi Open,Hard,1.57,2.37,0
Ivashka I.,113,159,78,81,Korda S.,26,126,75,51,2022-08-02,Washington,Citi Open,Hard,1.9,1.9,0
Mcdonald M.,60,190,87,103,Ruusuvuori E.,55,158,79,79,2022-08-02,Washington,Citi Open,Hard,2.2,1.66,0
Eubanks C.,29,64,28,36,Bonzi B.,107,83,37,46,2022-08-02,Washington,Citi Open,Hard,2.37,1.57,1
Gojowczyk P.,108,172,75,97,Paire B.,149,527,237,290,2022-08-02,Washington,Citi Open,Hard,1.61,2.3,0
Cressy M.,96,96,42,54,Sock J.,166,324,177,147,2022-08-03,Washington,Citi Open,Hard,1.57,2.37,1
Wolf J.J.,45,75,39,36,Shapovalov D.,29,298,166,132,2022-08-03,Washington,Citi Open,Hard,2.62,1.5,1
Nishioka Y.,31,215,99,116,De Minaur A.,19,272,161,111,2022-08-03,Washington,Citi Open,Hard,3.2,1.36,1
Giron M.,69,150,68,82,Kyrgios N.,25,303,195,108,2022-08-03,Washington,Citi Open,Hard,4.0,1.25,0
Gojo B.,115,14,3,11,Van De Zandschulp B.,44,117,63,54,2022-08-03,Washington,Citi Open,Hard,3.5,1.3,0
Koepfer D.,84,86,38,48,Khachanov K.,11,378,217,161,2022-08-03,Washington,Citi Open,Hard,3.2,1.36,0
Paire B.,149,527,237,290,Rune H.,6,131,83,48,2022-08-03,Washington,Citi Open,Hard,3.4,1.33,0
Ruusuvuori E.,55,158,79,79,Hurkacz H.,17,238,137,101,2022-08-03,Washington,Citi Open,Hard,2.62,1.5,1
Karatsev A.,75,136,66,70,Ymer M.,59,130,58,72,2022-08-03,Washington,Citi Open,Hard,1.72,2.1,0
Popyrin A.,90,140,59,81,Fritz T.,9,356,205,151,2022-08-03,Washington,Citi Open,Hard,5.0,1.16,0
Baez S.,72,95,47,48,Korda S.,26,126,75,51,2022-08-03,Washington,Citi Open,Hard,3.2,1.36,0
Mannarino A.,27,567,264,303,Dimitrov G.,20,651,389,262,2022-08-03,Washington,Citi Open,Hard,2.37,1.57,0
Johnson S.,197,395,196,199,Villanueva G.,279,1,0,1,2022-08-03,Los Cabos,Los Cabos Open,Hard,1.12,6.0,1
Kubler J.,77,53,24,29,Etcheverry T.,34,60,26,34,2022-08-03,Los Cabos,Los Cabos Open,Hard,1.3,3.5,1
Bagnis F.,135,121,39,82,Escobedo E.,377,57,20,37,2022-08-03,Los Cabos,Los Cabos Open,Hard,2.1,1.72,1
Hernandez A.,521,5,1,4,Barrientos N.,354,4,0,4,2022-08-03,Los Cabos,Los Cabos Open,Hard,,,1
Lopez F.,634,863,441,422,Albot R.,97,215,86,129,2022-08-03,Los Cabos,Los Cabos Open,Hard,4.0,1.25,0
Nakashima B.,70,106,57,49,Uchida K.,155,4,1,3,2022-08-03,Los Cabos,Los Cabos Open,Hard,1.08,8.0,1
Thompson J.,71,221,96,125,Hanfmann Y.,50,99,50,49,2022-08-03,Los Cabos,Los Cabos Open,Hard,1.57,2.37,1
Kokkinakis T.,86,124,55,69,Verdasco F.,244,962,537,425,2022-08-03,Los Cabos,Los Cabos Open,Hard,1.4,3.0,1
Fritz T.,9,356,205,151,Evans D.,30,251,124,127,2022-08-04,Washington,Citi Open,Hard,1.3,3.5,0
Ruusuvuori E.,55,158,79,79,Ymer M.,59,130,58,72,2022-08-04,Washington,Citi Open,Hard,1.4,3.0,0
Kyrgios N.,25,303,195,108,Paul T.,14,204,111,93,2022-08-04,Washington,Citi Open,Hard,1.4,3.0,1
Opelka R.,17,168,88,80,Kudla D.,137,198,70,128,2022-08-04,Washington,Citi Open,Hard,1.44,2.75,1
Eubanks C.,29,64,28,36,Tiafoe F.,10,303,158,145,2022-08-04,Washington,Citi Open,Hard,3.0,1.4,0
Nishioka Y.,31,215,99,116,Khachanov K.,11,378,217,161,2022-08-04,Washington,Citi Open,Hard,2.75,1.44,1
Purcell M.,78,28,9,19,Nakashima B.,70,106,57,49,2022-08-04,Los Cabos,Los Cabos Open,Hard,4.0,1.25,0
Hernandez A.,521,5,1,4,Auger-Aliassime F.,12,268,163,105,2022-08-04,Los Cabos,Los Cabos Open,Hard,19.0,1.02,0
Albot R.,97,215,86,129,Kubler J.,77,53,24,29,2022-08-04,Los Cabos,Los Cabos Open,Hard,2.75,1.44,1
Bagnis F.,135,121,39,82,Berankis R.,212,249,104,145,2022-08-04,Los Cabos,Los Cabos Open,Hard,2.62,1.5,0
Kokkinakis T.,86,124,55,69,Johnson S.,197,395,196,199,2022-08-04,Los Cabos,Los Cabos Open,Hard,1.57,2.37,0
Medvedev D.,3,406,289,117,Hijikata R.,110,16,7,9,2022-08-04,Los Cabos,Los Cabos Open,Hard,1.05,11.0,1
Norrie C.,13,287,172,115,Tseng C. H.,108,8,2,6,2022-08-04,Los Cabos,Los Cabos Open,Hard,1.1,7.0,1
Kecmanovic M.,40,210,107,103,Thompson J.,71,221,96,125,2022-08-04,Los Cabos,Los Cabos Open,Hard,1.44,2.75,1
Dimitrov G.,20,651,389,262,Korda S.,26,126,75,51,2022-08-05,Washington,Citi Open,Hard,2.5,1.53,0
Van De Zandschulp B.,44,117,63,54,Tiafoe F.,10,303,158,145,2022-08-05,Washington,Citi Open,Hard,2.2,1.66,0
Cressy M.,96,96,42,54,Rublev A.,7,392,255,137,2022-08-05,Washington,Citi Open,Hard,2.75,1.44,0
Rune H.,6,131,83,48,Wolf J.J.,45,75,39,36,2022-08-05,Washington,Citi Open,Hard,1.9,1.9,0
Albot R.,97,215,86,129,Norrie C.,13,287,172,115,2022-08-05,Los Cabos,Los Cabos Open,Hard,6.5,1.11,0
Berankis R.,212,249,104,145,Medvedev D.,3,406,289,117,2022-08-05,Los Cabos,Los Cabos Open,Hard,8.0,1.08,0
Johnson S.,197,395,196,199,Auger-Aliassime F.,12,268,163,105,2022-08-05,Los Cabos,Los Cabos Open,Hard,4.0,1.25,0
Kecmanovic M.,40,210,107,103,Nakashima B.,70,106,57,49,2022-08-05,Los Cabos,Los Cabos Open,Hard,2.0,1.8,1
Kyrgios N.,25,303,195,108,Opelka R.,17,168,88,80,2022-08-05,Washington,Citi Open,Hard,1.33,3.4,1
Evans D.,30,251,124,127,Nishioka Y.,31,215,99,116,2022-08-05,Washington,Citi Open,Hard,1.8,2.0,0
Kyrgios N.,25,303,195,108,Tiafoe F.,10,303,158,145,2022-08-06,Washington,Citi Open,Hard,1.36,3.2,1
Ymer M.,59,130,58,72,Korda S.,26,126,75,51,2022-08-06,Washington,Citi Open,Hard,3.2,1.36,1
Wolf J.J.,45,75,39,36,Rublev A.,7,392,255,137,2022-08-06,Washington,Citi Open,Hard,5.0,1.16,0
Auger-Aliassime F.,12,268,163,105,Norrie C.,13,287,172,115,2022-08-06,Los Cabos,Los Cabos Open,Hard,1.8,2.0,0
Medvedev D.,3,406,289,117,Kecmanovic M.,40,210,107,103,2022-08-06,Los Cabos,Los Cabos Open,Hard,1.2,4.5,1
Norrie C.,13,287,172,115,Medvedev D.,3,406,289,117,2022-08-07,Los Cabos,Los Cabos Open,Hard,3.4,1.33,0
Kyrgios N.,25,303,195,108,Ymer M.,59,130,58,72,2022-08-07,Washington,Citi Open,Hard,1.16,5.0,1
Rublev A.,7,392,255,137,Nishioka Y.,31,215,99,116,2022-08-07,Washington,Citi Open,Hard,1.2,4.5,0
Kyrgios N.,25,303,195,108,Nishioka Y.,31,215,99,116,2022-08-07,Washington,Citi Open,Hard,1.16,5.0,1
Ruusuvuori E.,55,158,79,79,Wawrinka S.,72,854,535,319,2022-08-08,Montreal,Canadian Open,Hard,1.3,3.5,1
Brooksby J.,39,79,46,33,Bublik A.,25,219,110,109,2022-08-08,Montreal,Canadian Open,Hard,1.57,2.37,1
Khachanov K.,11,378,217,161,Cerundolo F.,21,104,58,46,2022-08-08,Montreal,Canadian Open,Hard,1.44,2.75,1
Mcdonald M.,60,190,87,103,Molcan A.,120,86,45,41,2022-08-08,Montreal,Canadian Open,Hard,1.66,2.2,0
De Minaur A.,19,272,161,111,Shapovalov D.,29,298,166,132,2022-08-09,Montreal,Canadian Open,Hard,1.66,2.2,1
Paire B.,149,527,237,290,Nishioka Y.,31,215,99,116,2022-08-09,Montreal,Canadian Open,Hard,2.37,1.57,0
Norrie C.,13,287,172,115,Nakashima B.,70,106,57,49,2022-08-09,Montreal,Canadian Open,Hard,1.5,2.62,1
Bautista Agut R.,25,379,234,145,Giron M.,69,150,68,82,2022-08-09,Montreal,Canadian Open,Hard,1.3,3.5,1
Bonzi B.,107,83,37,46,Tiafoe F.,10,303,158,145,2022-08-09,Montreal,Canadian Open,Hard,2.75,1.44,0
Fognini F.,128,742,383,359,Rune H.,6,131,83,48,2022-08-09,Montreal,Canadian Open,Hard,2.1,1.72,0
Baez S.,72,95,47,48,Kyrgios N.,25,303,195,108,2022-08-09,Montreal,Canadian Open,Hard,5.0,1.16,0
Draper J.,55,51,29,22,Gaston H.,109,58,24,34,2022-08-09,Montreal,Canadian Open,Hard,1.33,3.4,1
Dimitrov G.,20,651,389,262,Galarneau A.,237,1,0,1,2022-08-09,Montreal,Canadian Open,Hard,1.14,5.5,1
Rinderknech A.,67,96,46,50,Mannarino A.,27,567,264,303,2022-08-09,Montreal,Canadian Open,Hard,2.2,1.66,0
Krajinovic F.,93,240,115,125,Evans D.,30,251,124,127,2022-08-09,Montreal,Canadian Open,Hard,2.2,1.66,0
Monfils G.,323,816,510,306,Martinez P.,135,118,50,68,2022-08-09,Montreal,Canadian Open,Hard,1.57,2.37,1
Coric B.,15,343,185,158,Cilic M.,100,853,543,310,2022-08-09,Montreal,Canadian Open,Hard,2.62,1.5,0
Karatsev A.,75,136,66,70,Cressy M.,96,96,42,54,2022-08-09,Montreal,Canadian Open,Hard,2.37,1.57,0
Pospisil V.,99,280,122,158,Paul T.,14,204,111,93,2022-08-09,Montreal,Canadian Open,Hard,4.0,1.25,0
Berrettini M.,38,217,142,75,Carreno Busta P.,16,352,214,138,2022-08-09,Montreal,Canadian Open,Hard,1.36,3.2,0
Ramos-Vinolas A.,82,437,204,233,Schwartzman D.,95,428,233,195,2022-08-10,Montreal,Canadian Open,Hard,3.0,1.4,1
Tiafoe F.,10,303,158,145,Fritz T.,9,356,205,151,2022-08-10,Montreal,Canadian Open,Hard,2.75,1.44,0
Monfils G.,323,816,510,306,Cressy M.,96,96,42,54,2022-08-10,Montreal,Canadian Open,Hard,2.1,1.72,1
Dimitrov G.,20,651,389,262,De Minaur A.,19,272,161,111,2022-08-10,Montreal,Canadian Open,Hard,2.62,1.5,0
Khachanov K.,11,378,217,161,Cilic M.,100,853,543,310,2022-08-10,Montreal,Canadian Open,Hard,1.8,2.0,0
Kyrgios N.,25,303,195,108,Medvedev D.,3,406,289,117,2022-08-10,Montreal,Canadian Open,Hard,2.62,1.5,1
Sinner J.,8,224,153,71,Mannarino A.,27,567,264,303,2022-08-10,Montreal,Canadian Open,Hard,1.12,6.0,1
Rune H.,6,131,83,48,Carreno Busta P.,16,352,214,138,2022-08-10,Montreal,Canadian Open,Hard,2.75,1.44,0
Van De Zandschulp B.,44,117,63,54,Norrie C.,13,287,172,115,2022-08-10,Montreal,Canadian Open,Hard,3.0,1.4,0
Ruud C.,4,275,176,99,Molcan A.,120,86,45,41,2022-08-10,Montreal,Canadian Open,Hard,1.33,3.4,1
Paul T.,14,204,111,93,Alcaraz C.,1,164,130,34,2022-08-10,Montreal,Canadian Open,Hard,4.5,1.2,1
Ruusuvuori E.,55,158,79,79,Hurkacz H.,17,238,137,101,2022-08-10,Montreal,Canadian Open,Hard,2.5,1.53,0
Ramos-Vinolas A.,82,437,204,233,Goffin D.,123,522,296,226,2022-08-10,Montreal,Canadian Open,Hard,3.0,1.4,1
Davidovich Fokina A.,39,168,84,84,Schwartzman D.,95,428,233,195,2022-08-10,Montreal,Canadian Open,Hard,2.0,1.8,0
Van De Zandschulp B.,44,117,63,54,Kecmanovic M.,40,210,107,103,2022-08-10,Montreal,Canadian Open,Hard,2.2,1.66,1
Fritz T.,9,356,205,151,Murray A.,44,932,687,245,2022-08-10,Montreal,Canadian Open,Hard,1.4,3.0,1
Brooksby J.,39,79,46,33,Bautista Agut R.,25,379,234,145,2022-08-10,Montreal,Canadian Open,Hard,2.1,1.72,0
Evans D.,30,251,124,127,Fritz T.,9,356,205,151,2022-08-11,Montreal,Canadian Open,Hard,2.75,1.44,1
Auger-Aliassime F.,12,268,163,105,Norrie C.,13,287,172,115,2022-08-11,Montreal,Canadian Open,Hard,1.72,2.1,1
Ramos-Vinolas A.,82,437,204,233,Hurkacz H.,17,238,137,101,2022-08-11,Montreal,Canadian Open,Hard,5.0,1.16,0
De Minaur A.,19,272,161,111,Kyrgios N.,25,303,195,108,2022-08-11,Montreal,Canadian Open,Hard,3.0,1.4,0
Draper J.,55,51,29,22,Tsitsipas S.,5,390,264,126,2022-08-11,Montreal,Canadian Open,Hard,3.75,1.28,1
Auger-Aliassime F.,12,268,163,105,Nishioka Y.,31,215,99,116,2022-08-11,Montreal,Canadian Open,Hard,1.33,3.4,1
Rublev A.,7,392,255,137,Evans D.,30,251,124,127,2022-08-11,Montreal,Canadian Open,Hard,1.33,3.4,0
Ruud C.,4,275,176,99,Bautista Agut R.,25,379,234,145,2022-08-11,Montreal,Canadian Open,Hard,1.72,2.1,1
Auger-Aliassime F.,12,268,163,105,Ruud C.,4,275,176,99,2022-08-12,Montreal,Canadian Open,Hard,1.53,2.5,0
Kyrgios N.,25,303,195,108,Hurkacz H.,17,238,137,101,2022-08-12,Montreal,Canadian Open,Hard,1.3,3.5,0
Evans D.,30,251,124,127,Paul T.,14,204,111,93,2022-08-12,Montreal,Canadian Open,Hard,2.37,1.57,1
Cilic M.,100,853,543,310,Paul T.,14,204,111,93,2022-08-12,Montreal,Canadian Open,Hard,1.66,2.2,0
Draper J.,55,51,29,22,Monfils G.,323,816,510,306,2022-08-12,Montreal,Canadian Open,Hard,2.1,1.72,1
Carreno Busta P.,16,352,214,138,Sinner J.,8,224,153,71,2022-08-12,Montreal,Canadian Open,Hard,2.62,1.5,1
Draper J.,55,51,29,22,Carreno Busta P.,16,352,214,138,2022-08-13,Montreal,Canadian Open,Hard,3.0,1.4,0
Ruud C.,4,275,176,99,Hurkacz H.,17,238,137,101,2022-08-13,Montreal,Canadian Open,Hard,1.9,1.9,0
Carreno Busta P.,16,352,214,138,Evans D.,30,251,124,127,2022-08-14,Montreal,Canadian Open,Hard,1.44,2.75,1
Hurkacz H.,17,238,137,101,Carreno Busta P.,16,352,214,138,2022-08-14,Montreal,Canadian Open,Hard,1.57,2.37,0
Cressy M.,96,96,42,54,Van De Zandschulp B.,44,117,63,54,2022-08-14,Cincinnati,Western & Southern Financial Group Masters,Hard,2.1,1.72,0
Rune H.,6,131,83,48,Norrie C.,13,287,172,115,2022-08-15,Cincinnati,Western & Southern Financial Group Masters,Hard,4.0,1.25,0
Goffin D.,123,522,296,226,Giron M.,69,150,68,82,2022-08-15,Cincinnati,Western & Southern Financial Group Masters,Hard,1.66,2.2,0
Murray A.,44,932,687,245,Wawrinka S.,72,854,535,319,2022-08-15,Cincinnati,Western & Southern Financial Group Masters,Hard,1.5,2.62,1
Bonzi B.,107,83,37,46,Isner J.,114,755,465,290,2022-08-15,Cincinnati,Western & Southern Financial Group Masters,Hard,2.3,1.61,0
Munar J.,104,178,75,103,Cilic M.,100,853,543,310,2022-08-15,Cincinnati,Western & Southern Financial Group Masters,Hard,3.0,1.4,0
Cerundolo F.,21,104,58,46,Bautista Agut R.,25,379,234,145,2022-08-15,Cincinnati,Western & Southern Financial Group Masters,Hard,3.2,1.36,0
Nakashima B.,70,106,57,49,Karatsev A.,75,136,66,70,2022-08-15,Cincinnati,Western & Southern Financial Group Masters,Hard,1.44,2.75,0
Schwartzman D.,95,428,233,195,Molcan A.,120,86,45,41,2022-08-15,Cincinnati,Western & Southern Financial Group Masters,Hard,1.66,2.2,1
Wolf J.J.,45,75,39,36,Ruusuvuori E.,55,158,79,79,2022-08-15,Cincinnati,Western & Southern Financial Group Masters,Hard,2.5,1.53,0
Basilashvili N.,118,301,138,163,Mcdonald M.,60,190,87,103,2022-08-15,Cincinnati,Western & Southern Financial Group Masters,Hard,3.2,1.36,0
Shelton B.,43,34,13,21,Sonego L.,43,221,107,114,2022-08-16,Cincinnati,Western & Southern Financial Group Masters,Hard,2.37,1.57,1
Baez S.,72,95,47,48,Fritz T.,9,356,205,151,2022-08-16,Cincinnati,Western & Southern Financial Group Masters,Hard,5.0,1.16,0
Davidovich Fokina A.,39,168,84,84,Kyrgios N.,25,303,195,108,2022-08-16,Cincinnati,Western & Southern Financial Group Masters,Hard,4.5,1.2,0
Carreno Busta P.,16,352,214,138,Kecmanovic M.,40,210,107,103,2022-08-16,Cincinnati,Western & Southern Financial Group Masters,Hard,1.72,2.1,0
Fognini F.,128,742,383,359,Ramos-Vinolas A.,82,437,204,233,2022-08-16,Cincinnati,Western & Southern Financial Group Masters,Hard,2.1,1.72,1
Laaksonen H.,125,101,37,64,De Minaur A.,19,272,161,111,2022-08-16,Cincinnati,Western & Southern Financial Group Masters,Hard,9.0,1.07,0
Kokkinakis T.,86,124,55,69,Sinner J.,8,224,153,71,2022-08-16,Cincinnati,Western & Southern Financial Group Masters,Hard,4.5,1.2,0
Coric B.,15,343,185,158,Musetti L.,18,143,79,64,2022-08-16,Cincinnati,Western & Southern Financial Group Masters,Hard,2.37,1.57,1
Shapovalov D.,29,298,166,132,Dimitrov G.,20,651,389,262,2022-08-16,Cincinnati,Western & Southern Financial Group Masters,Hard,2.1,1.72,1
Berrettini M.,38,217,142,75,Tiafoe F.,10,303,158,145,2022-08-16,Cincinnati,Western & Southern Financial Group Masters,Hard,1.57,2.37,0
Khachanov K.,11,378,217,161,Korda S.,26,126,75,51,2022-08-16,Cincinnati,Western & Southern Financial Group Masters,Hard,2.1,1.72,0
Brooksby J.,39,79,46,33,Paul T.,14,204,111,93,2022-08-16,Cincinnati,Western & Southern Financial Group Masters,Hard,2.1,1.72,0
Hurkacz H.,17,238,137,101,Isner J.,114,755,465,290,2022-08-17,Cincinnati,Western & Southern Financial Group Masters,Hard,1.5,2.62,0
Bautista Agut R.,25,379,234,145,Giron M.,69,150,68,82,2022-08-17,Cincinnati,Western & Southern Financial Group Masters,Hard,1.4,3.0,1
Tsitsipas S.,5,390,264,126,Krajinovic F.,93,240,115,125,2022-08-17,Cincinnati,Western & Southern Financial Group Masters,Hard,1.25,4.0,1
Fritz T.,9,356,205,151,Kyrgios N.,25,303,195,108,2022-08-17,Cincinnati,Western & Southern Financial Group Masters,Hard,2.1,1.72,1
Sinner J.,8,224,153,71,Kecmanovic M.,40,210,107,103,2022-08-17,Cincinnati,Western & Southern Financial Group Masters,Hard,1.36,3.2,1
Paul T.,14,204,111,93,Shapovalov D.,29,298,166,132,2022-08-17,Cincinnati,Western & Southern Financial Group Masters,Hard,1.53,2.5,0
Rublev A.,7,392,255,137,Fognini F.,128,742,383,359,2022-08-17,Cincinnati,Western & Southern Financial Group Masters,Hard,1.2,4.5,1
Shelton B.,43,34,13,21,Ruud C.,4,275,176,99,2022-08-17,Cincinnati,Western & Southern Financial Group Masters,Hard,4.5,1.2,1
Auger-Aliassime F.,12,268,163,105,De Minaur A.,19,272,161,111,2022-08-17,Cincinnati,Western & Southern Financial Group Masters,Hard,1.72,2.1,1
Karatsev A.,75,136,66,70,Schwartzman D.,95,428,233,195,2022-08-17,Cincinnati,Western & Southern Financial Group Masters,Hard,1.9,1.9,0
Medvedev D.,3,406,289,117,Van De Zandschulp B.,44,117,63,54,2022-08-17,Cincinnati,Western & Southern Financial Group Masters,Hard,1.14,5.5,1
Ruusuvuori E.,55,158,79,79,Cilic M.,100,853,543,310,2022-08-17,Cincinnati,Western & Southern Financial Group Masters,Hard,2.37,1.57,0
Mcdonald M.,60,190,87,103,Alcaraz C.,1,164,130,34,2022-08-17,Cincinnati,Western & Southern Financial Group Masters,Hard,6.0,1.12,0
Evans D.,30,251,124,127,Krajinovic F.,93,240,115,125,2022-08-17,Cincinnati,Western & Southern Financial Group Masters,Hard,1.57,2.37,0
Norrie C.,13,287,172,115,Murray A.,44,932,687,245,2022-08-17,Cincinnati,Western & Southern Financial Group Masters,Hard,1.36,3.2,1
Coric B.,15,343,185,158,Nadal R.,2,1223,1017,206,2022-08-18,Cincinnati,Western & Southern Financial Group Masters,Hard,5.5,1.14,1
Korda S.,26,126,75,51,Tiafoe F.,10,303,158,145,2022-08-18,Cincinnati,Western & Southern Financial Group Masters,Hard,2.1,1.72,1
Rublev A.,7,392,255,137,Fritz T.,9,356,205,151,2022-08-18,Cincinnati,Western & Southern Financial Group Masters,Hard,2.75,1.44,0
Medvedev D.,3,406,289,117,Shapovalov D.,29,298,166,132,2022-08-18,Cincinnati,Western & Southern Financial Group Masters,Hard,1.22,4.33,1
Schwartzman D.,95,428,233,195,Tsitsipas S.,5,390,264,126,2022-08-18,Cincinnati,Western & Southern Financial Group Masters,Hard,3.75,1.28,0
Coric B.,15,343,185,158,Bautista Agut R.,25,379,234,145,2022-08-18,Cincinnati,Western & Southern Financial Group Masters,Hard,2.75,1.44,1
Isner J.,114,755,465,290,Korda S.,26,126,75,51,2022-08-18,Cincinnati,Western & Southern Financial Group Masters,Hard,2.37,1.57,1
Isner J.,114,755,465,290,Tsitsipas S.,5,390,264,126,2022-08-19,Cincinnati,Western & Southern Financial Group Masters,Hard,3.2,1.36,0
Medvedev D.,3,406,289,117,Fritz T.,9,356,205,151,2022-08-19,Cincinnati,Western & Southern Financial Group Masters,Hard,1.44,2.75,1
Cilic M.,100,853,543,310,Alcaraz C.,1,164,130,34,2022-08-19,Cincinnati,Western & Southern Financial Group Masters,Hard,4.0,1.25,0
Auger-Aliassime F.,12,268,163,105,Sinner J.,8,224,153,71,2022-08-19,Cincinnati,Western & Southern Financial Group Masters,Hard,2.0,1.8,1
Shelton B.,43,34,13,21,Norrie C.,13,287,172,115,2022-08-19,Cincinnati,Western & Southern Financial Group Masters,Hard,3.0,1.4,0
Auger-Aliassime F.,12,268,163,105,Coric B.,15,343,185,158,2022-08-20,Cincinnati,Western & Southern Financial Group Masters,Hard,1.5,2.62,0
Norrie C.,13,287,172,115,Alcaraz C.,1,164,130,34,2022-08-20,Cincinnati,Western & Southern Financial Group Masters,Hard,3.5,1.3,1
Norrie C.,13,287,172,115,Coric B.,15,343,185,158,2022-08-21,Cincinnati,Western & Southern Financial Group Masters,Hard,1.66,2.2,0
Tsitsipas S.,5,390,264,126,Medvedev D.,3,406,289,117,2022-08-21,Cincinnati,Western & Southern Financial Group Masters,Hard,3.4,1.33,1
Coric B.,15,343,185,158,Tsitsipas S.,5,390,264,126,2022-08-21,Cincinnati,Western & Southern Financial Group Masters,Hard,2.37,1.57,1
Gasquet R.,48,948,581,367,Majchrzak K.,121,50,19,31,2022-08-21,Winston-Salem,Winston-Salem Open at Wake Forest University,Hard,1.36,3.2,1
Altmaier D.,51,79,28,51,Kwon S.W.,68,108,53,55,2022-08-21,Winston-Salem,Winston-Salem Open at Wake Forest University,Hard,2.37,1.57,0
Kudla D.,137,198,70,128,Monteiro T.,121,171,69,102,2022-08-21,Winston-Salem,Winston-Salem Open at Wake Forest University,Hard,1.72,2.1,0
O Connell C.,74,65,26,39,Mannarino A.,27,567,264,303,2022-08-22,Winston-Salem,Winston-Salem Open at Wake Forest University,Hard,1.9,1.9,0
Johnson S.,197,395,196,199,Nava E.,242,13,2,11,2022-08-22,Winston-Salem,Winston-Salem Open at Wake Forest University,Hard,1.5,2.62,1
Tseng C.H.,145,9,1,8,Fucsovics M.,67,249,121,128,2022-08-22,Winston-Salem,Winston-Salem Open at Wake Forest University,Hard,2.0,1.8,1
Coria F.,108,99,43,56,Ymer M.,59,130,58,72,2022-08-22,Winston-Salem,Winston-Salem Open at Wake Forest University,Hard,4.5,1.2,0
Mochizuki S.,200,8,0,8,Tabilo A.,122,44,21,23,2022-08-22,Winston-Salem,Winston-Salem Open at Wake Forest University,Hard,3.0,1.4,0
Daniel T.,111,178,67,111,Griekspoor T.,37,97,47,50,2022-08-22,Winston-Salem,Winston-Salem Open at Wake Forest University,Hard,,,0
Gojowczyk P.,108,172,75,97,Lehecka J.,33,61,30,31,2022-08-22,Winston-Salem,Winston-Salem Open at Wake Forest University,Hard,3.0,1.4,1
Gaston H.,109,58,24,34,Millman J.,140,256,113,143,2022-08-22,Winston-Salem,Winston-Salem Open at Wake Forest University,Hard,2.5,1.53,0
Djere L.,38,243,120,123,Goffin D.,123,522,296,226,2022-08-22,Winston-Salem,Winston-Salem Open at Wake Forest University,Hard,3.4,1.33,1
Duckworth J.,123,143,55,88,Kokkinakis T.,86,124,55,69,2022-08-22,Winston-Salem,Winston-Salem Open at Wake Forest University,Hard,3.2,1.36,1
Bonzi B.,107,83,37,46,Edmund K.,473,233,113,120,2022-08-23,Winston-Salem,Winston-Salem Open at Wake Forest University,Hard,1.28,3.75,1
Martinez P.,135,118,50,68,Johnson S.,197,395,196,199,2022-08-23,Winston-Salem,Winston-Salem Open at Wake Forest University,Hard,2.3,1.61,0
Ruusuvuori E.,55,158,79,79,Mannarino A.,27,567,264,303,2022-08-23,Winston-Salem,Winston-Salem Open at Wake Forest University,Hard,1.44,2.75,0
Cressy M.,96,96,42,54,Duckworth J.,123,143,55,88,2022-08-23,Winston-Salem,Winston-Salem Open at Wake Forest University,Hard,1.44,2.75,1
Ramos-Vinolas A.,82,437,204,233,Millman J.,140,256,113,143,2022-08-23,Winston-Salem,Winston-Salem Open at Wake Forest University,Hard,2.3,1.61,1
Kubler J.,77,53,24,29,Kwon S.W.,68,108,53,55,2022-08-23,Winston-Salem,Winston-Salem Open at Wake Forest University,Hard,1.72,2.1,1
Djere L.,38,243,120,123,Sousa J.,147,436,189,247,2022-08-23,Winston-Salem,Winston-Salem Open at Wake Forest University,Hard,1.61,2.3,1
Ivashka I.,113,159,78,81,Gojowczyk P.,108,172,75,97,2022-08-23,Winston-Salem,Winston-Salem Open at Wake Forest University,Hard,1.2,4.5,1
Gasquet R.,48,948,581,367,Musetti L.,18,143,79,64,2022-08-23,Winston-Salem,Winston-Salem Open at Wake Forest University,Hard,2.37,1.57,1
Monteiro T.,121,171,69,102,Basilashvili N.,118,301,138,163,2022-08-23,Winston-Salem,Winston-Salem Open at Wake Forest University,Hard,1.44,2.75,1
Lajovic D.,66,378,163,215,Fognini F.,128,742,383,359,2022-08-23,Winston-Salem,Winston-Salem Open at Wake Forest University,Hard,2.37,1.57,0
Edmund K.,473,233,113,120,Pervolarakis M.,377,1,0,1,2022-08-23,Winston-Salem,Winston-Salem Open at Wake Forest University,Hard,1.2,4.5,1
Wolf J.J.,45,75,39,36,Thiem D.,116,517,327,190,2022-08-23,Winston-Salem,Winston-Salem Open at Wake Forest University,Hard,2.0,1.8,0
Sonego L.,43,221,107,114,Cressy M.,96,96,42,54,2022-08-24,Winston-Salem,Winston-Salem Open at Wake Forest University,Hard,2.37,1.57,0
Munar J.,104,178,75,103,Van De Zandschulp B.,44,117,63,54,2022-08-24,Winston-Salem,Winston-Salem Open at Wake Forest University,Hard,2.37,1.57,0
Mannarino A.,27,567,264,303,Ramos-Vinolas A.,82,437,204,233,2022-08-24,Winston-Salem,Winston-Salem Open at Wake Forest University,Hard,1.72,2.1,1
Johnson S.,197,395,196,199,Gasquet R.,48,948,581,367,2022-08-24,Winston-Salem,Winston-Salem Open at Wake Forest University,Hard,1.9,1.9,0
Sonego L.,43,221,107,114,Tabilo A.,122,44,21,23,2022-08-24,Winston-Salem,Winston-Salem Open at Wake Forest University,Hard,1.33,3.4,1
Djere L.,38,243,120,123,Kubler J.,77,53,24,29,2022-08-24,Winston-Salem,Winston-Salem Open at Wake Forest University,Hard,2.5,1.53,1
Griekspoor T.,37,97,47,50,Van De Zandschulp B.,44,117,63,54,2022-08-24,Winston-Salem,Winston-Salem Open at Wake Forest University,Hard,2.5,1.53,0
Huesler M.A.,88,58,21,37,Ymer M.,59,130,58,72,2022-08-24,Winston-Salem,Winston-Salem Open at Wake Forest University,Hard,3.2,1.36,1
Draper J.,55,51,29,22,Fognini F.,128,742,383,359,2022-08-24,Winston-Salem,Winston-Salem Open at Wake Forest University,Hard,1.44,2.75,1
Thiem D.,116,517,327,190,Dimitrov G.,20,651,389,262,2022-08-24,Winston-Salem,Winston-Salem Open at Wake Forest University,Hard,2.3,1.61,1
Tseng C.H.,145,9,1,8,Munar J.,104,178,75,103,2022-08-24,Winston-Salem,Winston-Salem Open at Wake Forest University,Hard,2.5,1.53,0
Monteiro T.,121,171,69,102,Bonzi B.,107,83,37,46,2022-08-25,Winston-Salem,Winston-Salem Open at Wake Forest University,Hard,2.5,1.53,0
Draper J.,55,51,29,22,Thiem D.,116,517,327,190,2022-08-25,Winston-Salem,Winston-Salem Open at Wake Forest University,Hard,1.5,2.62,1
Huesler M.A.,88,58,21,37,Ivashka I.,113,159,78,81,2022-08-25,Winston-Salem,Winston-Salem Open at Wake Forest University,Hard,3.75,1.28,1
Cressy M.,96,96,42,54,Mannarino A.,27,567,264,303,2022-08-25,Winston-Salem,Winston-Salem Open at Wake Forest University,Hard,1.57,2.37,0
Bonzi B.,107,83,37,46,Van De Zandschulp B.,44,117,63,54,2022-08-25,Winston-Salem,Winston-Salem Open at Wake Forest University,Hard,2.62,1.5,0
Gasquet R.,48,948,581,367,Djere L.,38,243,120,123,2022-08-26,Winston-Salem,Winston-Salem Open at Wake Forest University,Hard,1.72,2.1,0
Huesler M.A.,88,58,21,37,Draper J.,55,51,29,22,2022-08-26,Winston-Salem,Winston-Salem Open at Wake Forest University,Hard,3.2,1.36,1
Djere L.,38,243,120,123,Mannarino A.,27,567,264,303,2022-08-27,Winston-Salem,Winston-Salem Open at Wake Forest University,Hard,2.75,1.44,0
Huesler M.A.,88,58,21,37,Djere L.,38,243,120,123,2022-08-27,Winston-Salem,Winston-Salem Open at Wake Forest University,Hard,1.66,2.2,0
Van De Zandschulp B.,44,117,63,54,Mannarino A.,27,567,264,303,2022-08-27,Winston-Salem,Winston-Salem Open at Wake Forest University,Hard,1.5,2.62,0
Wawrinka S.,72,854,535,319,Moutet C.,80,118,50,68,2022-08-29,New York,US Open,Hard,2.0,1.8,0
Ruusuvuori E.,55,158,79,79,Draper J.,55,51,29,22,2022-08-29,New York,US Open,Hard,1.8,2.0,0
Thompson J.,71,221,96,125,Sonego L.,43,221,107,114,2022-08-29,New York,US Open,Hard,2.62,1.5,1
Gaston H.,109,58,24,34,Bublik A.,25,219,110,109,2022-08-29,New York,US Open,Hard,3.2,1.36,0
Machac T.,108,18,6,12,Van De Zandschulp B.,44,117,63,54,2022-08-29,New York,US Open,Hard,3.0,1.4,0
Molcan A.,120,86,45,41,Monteiro T.,121,171,69,102,2022-08-29,New York,US Open,Hard,1.53,2.5,0
Garin C.,101,190,103,87,Lehecka J.,33,61,30,31,2022-08-29,New York,US Open,Hard,2.0,1.8,1
Ritschard A.,163,9,3,6,Auger-Aliassime F.,12,268,163,105,2022-08-29,New York,US Open,Hard,13.0,1.04,0
De Minaur A.,19,272,161,111,Krajinovic F.,93,240,115,125,2022-08-29,New York,US Open,Hard,1.25,4.0,1
Thiem D.,116,517,327,190,Carreno Busta P.,16,352,214,138,2022-08-29,New York,US Open,Hard,4.33,1.22,0
Khachanov K.,11,378,217,161,Kudla D.,137,198,70,128,2022-08-29,New York,US Open,Hard,1.16,5.0,1
Shelton B.,43,34,13,21,Borges N.,69,28,10,18,2022-08-29,New York,US Open,Hard,1.4,3.0,0
Grenier H.,122,16,5,11,Etcheverry T.,34,60,26,34,2022-08-29,New York,US Open,Hard,1.44,2.75,1
Holt B.,193,7,2,5,Fritz T.,9,356,205,151,2022-08-29,New York,US Open,Hard,13.0,1.04,1
Edmund K.,473,233,113,120,Ruud C.,4,275,176,99,2022-08-29,New York,US Open,Hard,9.0,1.07,0
Wu Y.,90,36,15,21,Basilashvili N.,118,301,138,163,2022-08-29,New York,US Open,Hard,1.22,4.33,1
Korda S.,26,126,75,51,Bagnis F.,135,121,39,82,2022-08-29,New York,US Open,Hard,1.12,6.0,1
Zhang Zh.,53,44,20,24,Van Rijthoven T.,110,19,10,9,2022-08-29,New York,US Open,Hard,1.61,2.3,0
Wolf J.J.,45,75,39,36,Bautista Agut R.,25,379,234,145,2022-08-29,New York,US Open,Hard,4.0,1.25,1
Millman J.,140,256,113,143,Nava E.,242,13,2,11,2022-08-29,New York,US Open,Hard,1.33,3.4,0
Nishioka Y.,31,215,99,116,Davidovich Fokina A.,39,168,84,84,2022-08-29,New York,US Open,Hard,2.2,1.66,0
Paul T.,14,204,111,93,Zapata Miralles B.,54,80,32,48,2022-08-29,New York,US Open,Hard,1.12,6.0,1
Tabilo A.,122,44,21,23,Majchrzak K.,121,50,19,31,2022-08-29,New York,US Open,Hard,1.72,2.1,1
Cerundolo F.,21,104,58,46,Murray A.,44,932,687,245,2022-08-29,New York,US Open,Hard,2.2,1.66,0
Medvedev D.,3,406,289,117,Kozlov S.,108,35,9,26,2022-08-29,New York,US Open,Hard,1.005,29.0,1
Fucsovics M.,67,249,121,128,Cressy M.,96,96,42,54,2022-08-29,New York,US Open,Hard,3.2,1.36,1
Berrettini M.,38,217,142,75,Jarry N.,28,141,73,68,2022-08-29,New York,US Open,Hard,1.14,5.5,1
Halys Q.,79,72,23,49,Rinderknech A.,67,96,46,50,2022-08-29,New York,US Open,Hard,2.75,1.44,0
Ramos-Vinolas A.,82,437,204,233,Gombos N.,114,66,21,45,2022-08-30,New York,US Open,Hard,1.66,2.2,1
Marterer M.,144,91,31,60,Cilic M.,100,853,543,310,2022-08-30,New York,US Open,Hard,6.0,1.12,0
Eubanks C.,29,64,28,36,Martinez P.,135,118,50,68,2022-08-30,New York,US Open,Hard,1.72,2.1,1
Couacaud E.,158,9,2,7,Coric B.,15,343,185,158,2022-08-30,New York,US Open,Hard,6.0,1.12,0
Musetti L.,18,143,79,64,Goffin D.,123,522,296,226,2022-08-30,New York,US Open,Hard,2.0,1.8,1
Brooksby J.,39,79,46,33,Lajovic D.,66,378,163,215,2022-08-30,New York,US Open,Hard,1.14,5.5,1
Huesler M.A.,88,58,21,37,Shapovalov D.,29,298,166,132,2022-08-30,New York,US Open,Hard,4.0,1.25,0
Ivashka I.,113,159,78,81,Querrey S.,287,678,369,309,2022-08-30,New York,US Open,Hard,1.1,7.0,1
Otte O.,233,78,33,45,Hurkacz H.,17,238,137,101,2022-08-30,New York,US Open,Hard,5.5,1.14,0
Fognini F.,128,742,383,359,Karatsev A.,75,136,66,70,2022-08-30,New York,US Open,Hard,2.1,1.72,1
Tseng C.H.,145,9,1,8,Popyrin A.,90,140,59,81,2022-08-30,New York,US Open,Hard,1.72,2.1,0
Tiafoe F.,10,303,158,145,Giron M.,69,150,68,82,2022-08-30,New York,US Open,Hard,1.36,3.2,1
Coria F.,108,99,43,56,Griekspoor T.,37,97,47,50,2022-08-30,New York,US Open,Hard,7.0,1.1,1
Brouwer G.,144,21,11,10,Mannarino A.,27,567,264,303,2022-08-30,New York,US Open,Hard,3.75,1.28,1
Kecmanovic M.,40,210,107,103,Tien L.,1042,1,0,1,2022-08-30,New York,US Open,Hard,1.01,23.0,1
Sinner J.,8,224,153,71,Altmaier D.,51,79,28,51,2022-08-30,New York,US Open,Hard,1.03,15.0,1
Gojowczyk P.,108,172,75,97,Rune H.,6,131,83,48,2022-08-30,New York,US Open,Hard,3.75,1.28,0
Rublev A.,7,392,255,137,Djere L.,38,243,120,123,2022-08-30,New York,US Open,Hard,1.11,6.5,1
Bedene A.,347,291,131,160,Cachin P.,54,52,23,29,2022-08-30,New York,US Open,Hard,2.3,1.61,0
Galan D.E.,76,78,33,45,Tsitsipas S.,5,390,264,126,2022-08-30,New York,US Open,Hard,13.0,1.04,1
Humbert U.,36,170,80,90,Bonzi B.,107,83,37,46,2022-08-30,New York,US Open,Hard,2.1,1.72,0
Kyrgios N.,25,303,195,108,Kokkinakis T.,86,124,55,69,2022-08-30,New York,US Open,Hard,1.16,5.0,1
Kotov P.,89,25,10,15,Nakashima B.,70,106,57,49,2022-08-30,New York,US Open,Hard,3.75,1.28,0
Johnson S.,197,395,196,199,Dimitrov G.,20,651,389,262,2022-08-30,New York,US Open,Hard,2.62,1.5,0
Daniel T.,111,178,67,111,Gasquet R.,48,948,581,367,2022-08-30,New York,US Open,Hard,2.2,1.66,0
Mcdonald M.,60,190,87,103,Sousa J.,147,436,189,247,2022-08-30,New York,US Open,Hard,1.4,3.0,0
Alcaraz C.,1,164,130,34,Baez S.,72,95,47,48,2022-08-30,New York,US Open,Hard,1.03,15.0,1
Isner J.,114,755,465,290,Delbonis F.,131,340,152,188,2022-08-30,New York,US Open,Hard,1.11,6.5,1
Vesely J.,528,288,130,158,Evans D.,30,251,124,127,2022-08-30,New York,US Open,Hard,3.2,1.36,0
Duckworth J.,123,143,55,88,O Connell C.,74,65,26,39,2022-08-30,New York,US Open,Hard,2.37,1.57,1
Verdasco F.,244,962,537,425,Kwon S.W.,68,108,53,55,2022-08-30,New York,US Open,Hard,3.2,1.36,0
Paire B.,149,527,237,290,Norrie C.,13,287,172,115,2022-08-30,New York,US Open,Hard,11.0,1.05,0
Wolf J.J.,45,75,39,36,Tabilo A.,122,44,21,23,2022-08-31,New York,US Open,Hard,1.33,3.4,1
Wu Y.,90,36,15,21,Borges N.,69,28,10,18,2022-08-31,New York,US Open,Hard,1.33,3.4,1
Bonzi B.,107,83,37,46,Kyrgios N.,25,303,195,108,2022-08-31,New York,US Open,Hard,6.0,1.12,0
Korda S.,26,126,75,51,Paul T.,14,204,111,93,2022-08-31,New York,US Open,Hard,1.8,2.0,0
Davidovich Fokina A.,39,168,84,84,Fucsovics M.,67,249,121,128,2022-08-31,New York,US Open,Hard,1.44,2.75,1
Ruud C.,4,275,176,99,Van Rijthoven T.,110,19,10,9,2022-08-31,New York,US Open,Hard,1.12,6.0,1
Thompson J.,71,221,96,125,Galan D.E.,76,78,33,45,2022-08-31,New York,US Open,Hard,2.1,1.72,0
Berrettini M.,38,217,142,75,Grenier H.,122,16,5,11,2022-08-31,New York,US Open,Hard,1.12,6.0,1
Bublik A.,25,219,110,109,Carreno Busta P.,16,352,214,138,2022-08-31,New York,US Open,Hard,3.75,1.28,0
Garin C.,101,190,103,87,De Minaur A.,19,272,161,111,2022-08-31,New York,US Open,Hard,6.0,1.12,0
Holt B.,193,7,2,5,Cachin P.,54,52,23,29,2022-08-31,New York,US Open,Hard,1.53,2.5,0
Van De Zandschulp B.,44,117,63,54,Moutet C.,80,118,50,68,2022-08-31,New York,US Open,Hard,1.44,2.75,0
Kubler J.,77,53,24,29,Ymer M.,59,130,58,72,2022-08-31,New York,US Open,Hard,2.2,1.66,1
Munar J.,104,178,75,103,Carballes Baena R.,64,207,91,116,2022-08-31,New York,US Open,Hard,1.2,4.5,0
Schwartzman D.,95,428,233,195,Sock J.,166,324,177,147,2022-08-31,New York,US Open,Hard,1.44,2.75,1
Nadal R.,2,1223,1017,206,Hijikata R.,110,16,7,9,2022-08-31,New York,US Open,Hard,1.01,26.0,1
Murray A.,44,932,687,245,Nava E.,242,13,2,11,2022-08-31,New York,US Open,Hard,1.2,4.5,1
Norrie C.,13,287,172,115,Sousa J.,147,436,189,247,2022-09-01,New York,US Open,Hard,1.05,11.0,1
Shapovalov D.,29,298,166,132,Carballes Baena R.,64,207,91,116,2022-09-01,New York,US Open,Hard,1.16,5.0,1
Kecmanovic M.,40,210,107,103,Gasquet R.,48,948,581,367,2022-09-01,New York,US Open,Hard,1.4,3.0,0
Schwartzman D.,95,428,233,195,Popyrin A.,90,140,59,81,2022-09-01,New York,US Open,Hard,1.28,3.75,1
Nakashima B.,70,106,57,49,Dimitrov G.,20,651,389,262,2022-09-01,New York,US Open,Hard,2.2,1.66,1
Kwon S.W.,68,108,53,55,Rublev A.,7,392,255,137,2022-09-01,New York,US Open,Hard,5.0,1.16,0
Musetti L.,18,143,79,64,Brouwer G.,144,21,11,10,2022-09-01,New York,US Open,Hard,1.44,2.75,1
Alcaraz C.,1,164,130,34,Coria F.,108,99,43,56,2022-09-01,New York,US Open,Hard,1.02,19.0,1
Auger-Aliassime F.,12,268,163,105,Draper J.,55,51,29,22,2022-09-01,New York,US Open,Hard,1.4,3.0,0
Coric B.,15,343,185,158,Brooksby J.,39,79,46,33,2022-09-01,New York,US Open,Hard,1.9,1.9,0
Duckworth J.,123,143,55,88,Evans D.,30,251,124,127,2022-09-01,New York,US Open,Hard,4.0,1.25,0
Cilic M.,100,853,543,310,Ramos-Vinolas A.,82,437,204,233,2022-09-01,New York,US Open,Hard,1.2,4.5,1
Rune H.,6,131,83,48,Isner J.,114,755,465,290,2022-09-01,New York,US Open,Hard,,,1
Medvedev D.,3,406,289,117,Rinderknech A.,67,96,46,50,2022-09-01,New York,US Open,Hard,1.01,21.0,1
Sinner J.,8,224,153,71,Eubanks C.,29,64,28,36,2022-09-01,New York,US Open,Hard,1.08,8.0,1
Monteiro T.,121,171,69,102,Khachanov K.,11,378,217,161,2022-09-01,New York,US Open,Hard,4.0,1.25,0
De Minaur A.,19,272,161,111,Carreno Busta P.,16,352,214,138,2022-09-02,New York,US Open,Hard,2.1,1.72,0
Cachin P.,54,52,23,29,Moutet C.,80,118,50,68,2022-09-02,New York,US Open,Hard,3.4,1.33,0
Khachanov K.,11,378,217,161,Draper J.,55,51,29,22,2022-09-02,New York,US Open,Hard,2.2,1.66,1
Murray A.,44,932,687,245,Berrettini M.,38,217,142,75,2022-09-02,New York,US Open,Hard,2.75,1.44,0
Ruud C.,4,275,176,99,Paul T.,14,204,111,93,2022-09-02,New York,US Open,Hard,1.57,2.37,1
Nadal R.,2,1223,1017,206,Fognini F.,128,742,383,359,2022-09-02,New York,US Open,Hard,1.08,8.0,1
Tiafoe F.,10,303,158,145,Kubler J.,77,53,24,29,2022-09-02,New York,US Open,Hard,1.33,3.4,1
Hurkacz H.,17,238,137,101,Ivashka I.,113,159,78,81,2022-09-02,New York,US Open,Hard,1.3,3.5,0
Galan D.E.,76,78,33,45,Davidovich Fokina A.,39,168,84,84,2022-09-02,New York,US Open,Hard,3.0,1.4,0
Wolf J.J.,45,75,39,36,Kyrgios N.,25,303,195,108,2022-09-03,New York,US Open,Hard,6.0,1.12,0
Wu Y.,90,36,15,21,Medvedev D.,3,406,289,117,2022-09-03,New York,US Open,Hard,13.0,1.04,0
Rune H.,6,131,83,48,Norrie C.,13,287,172,115,2022-09-03,New York,US Open,Hard,3.75,1.28,0
Rublev A.,7,392,255,137,Shapovalov D.,29,298,166,132,2022-09-03,New York,US Open,Hard,1.53,2.5,1
Alcaraz C.,1,164,130,34,Brooksby J.,39,79,46,33,2022-09-03,New York,US Open,Hard,1.25,4.0,1
Tiafoe F.,10,303,158,145,Schwartzman D.,95,428,233,195,2022-09-03,New York,US Open,Hard,1.44,2.75,1
Ivashka I.,113,159,78,81,Musetti L.,18,143,79,64,2022-09-03,New York,US Open,Hard,1.5,2.62,1
Evans D.,30,251,124,127,Cilic M.,100,853,543,310,2022-09-03,New York,US Open,Hard,2.37,1.57,0
Ruud C.,4,275,176,99,Moutet C.,80,118,50,68,2022-09-04,New York,US Open,Hard,1.16,5.0,1
Berrettini M.,38,217,142,75,Davidovich Fokina A.,39,168,84,84,2022-09-04,New York,US Open,Hard,1.33,3.4,1
Khachanov K.,11,378,217,161,Carreno Busta P.,16,352,214,138,2022-09-04,New York,US Open,Hard,2.75,1.44,1
Gasquet R.,48,948,581,367,Nadal R.,2,1223,1017,206,2022-09-04,New York,US Open,Hard,10.0,1.06,0
Sinner J.,8,224,153,71,Nakashima B.,70,106,57,49,2022-09-04,New York,US Open,Hard,1.36,3.2,1
Medvedev D.,3,406,289,117,Kyrgios N.,25,303,195,108,2022-09-05,New York,US Open,Hard,1.53,2.5,0
Norrie C.,13,287,172,115,Rublev A.,7,392,255,137,2022-09-05,New York,US Open,Hard,1.61,2.3,0
Tiafoe F.,10,303,158,145,Nadal R.,2,1223,1017,206,2022-09-05,New York,US Open,Hard,4.5,1.2,1
Ivashka I.,113,159,78,81,Sinner J.,8,224,153,71,2022-09-06,New York,US Open,Hard,4.33,1.22,0
Alcaraz C.,1,164,130,34,Cilic M.,100,853,543,310,2022-09-06,New York,US Open,Hard,1.2,4.5,1
Ruud C.,4,275,176,99,Berrettini M.,38,217,142,75,2022-09-06,New York,US Open,Hard,2.0,1.8,1
Khachanov K.,11,378,217,161,Kyrgios N.,25,303,195,108,2022-09-07,New York,US Open,Hard,4.5,1.2,1
Rublev A.,7,392,255,137,Tiafoe F.,10,303,158,145,2022-09-07,New York,US Open,Hard,1.8,2.0,0
Alcaraz C.,1,164,130,34,Sinner J.,8,224,153,71,2022-09-08,New York,US Open,Hard,1.61,2.3,1
Ruud C.,4,275,176,99,Khachanov K.,11,378,217,161,2022-09-09,New York,US Open,Hard,1.44,2.75,1
Tiafoe F.,10,303,158,145,Alcaraz C.,1,164,130,34,2022-09-10,New York,US Open,Hard,2.62,1.5,0
Alcaraz C.,1,164,130,34,Ruud C.,4,275,176,99,2022-09-11,New York,US Open,Hard,1.45,2.8,1
Sonego L.,43,221,107,114,Karatsev A.,75,136,66,70,2022-09-19,Metz,Open de Moselle,Hard,2.1,1.72,1
Etcheverry T.,34,60,26,34,Mena F.,151,1,0,1,2022-09-19,San Diego,San Diego Open,Hard,1.72,2.1,1
Korda S.,26,126,75,51,Gaston H.,109,58,24,34,2022-09-19,Metz,Open de Moselle,Hard,1.28,3.75,1
Popyrin A.,90,140,59,81,Duckworth J.,123,143,55,88,2022-09-19,San Diego,San Diego Open,Hard,2.0,1.8,0
Lehecka J.,33,61,30,31,Ruusuvuori E.,55,158,79,79,2022-09-20,Metz,Open de Moselle,Hard,3.2,1.36,0
Basilashvili N.,118,301,138,163,Bergs Z.,175,15,4,11,2022-09-20,Metz,Open de Moselle,Hard,2.75,1.44,1
Rinderknech A.,67,96,46,50,Munar J.,104,178,75,103,2022-09-20,Metz,Open de Moselle,Hard,1.53,2.5,1
Simon G.,188,869,491,378,Goffin D.,123,522,296,226,2022-09-20,Metz,Open de Moselle,Hard,3.75,1.28,1
Daniel T.,111,178,67,111,Nava E.,242,13,2,11,2022-09-20,San Diego,San Diego Open,Hard,1.66,2.2,1
Krueger M.,228,24,7,17,Eubanks C.,29,64,28,36,2022-09-20,San Diego,San Diego Open,Hard,3.4,1.33,1
Lestienne C.,109,40,13,27,Holt B.,193,7,2,5,2022-09-20,San Diego,San Diego Open,Hard,1.61,2.3,1
Kozlov S.,108,35,9,26,Wolf J.J.,45,75,39,36,2022-09-20,San Diego,San Diego Open,Hard,5.0,1.16,0
Kubler J.,77,53,24,29,O Connell C.,74,65,26,39,2022-09-21,San Diego,San Diego Open,Hard,1.72,2.1,0
Mcdonald M.,60,190,87,103,Laaksonen H.,125,101,37,64,2022-09-21,San Diego,San Diego Open,Hard,1.2,4.5,1
Huesler M.A.,88,58,21,37,Galan D.E.,76,78,33,45,2022-09-21,San Diego,San Diego Open,Hard,1.9,1.9,0
Svajda Z.,233,8,2,6,Nakashima B.,70,106,57,49,2022-09-21,San Diego,San Diego Open,Hard,6.0,1.12,0
Verdasco F.,244,962,537,425,Kudla D.,137,198,70,128,2022-09-21,San Diego,San Diego Open,Hard,2.5,1.53,0
Mannarino A.,27,567,264,303,Ymer M.,59,130,58,72,2022-09-21,Metz,Open de Moselle,Hard,1.61,2.3,0
Sousa J.,147,436,189,247,Wawrinka S.,72,854,535,319,2022-09-21,Metz,Open de Moselle,Hard,2.37,1.57,0
Furness E.,208,1,0,1,Bublik A.,25,219,110,109,2022-09-21,Metz,Open de Moselle,Hard,5.0,1.16,0
Humbert U.,36,170,80,90,Bonzi B.,107,83,37,46,2022-09-21,Metz,Open de Moselle,Hard,1.9,1.9,0
Barrere G.,59,79,31,48,Otte O.,233,78,33,45,2022-09-21,Metz,Open de Moselle,Hard,1.9,1.9,1
Gasquet R.,48,948,581,367,Thiem D.,116,517,327,190,2022-09-21,Metz,Open de Moselle,Hard,1.8,2.0,0
Korda S.,26,126,75,51,Musetti L.,18,143,79,64,2022-09-21,Metz,Open de Moselle,Hard,1.5,2.62,1
Wawrinka S.,72,854,535,319,Medvedev D.,3,406,289,117,2022-09-22,Metz,Open de Moselle,Hard,6.0,1.12,1
Tabilo A.,122,44,21,23,Johnson S.,197,395,196,199,2022-09-22,San Diego,San Diego Open,Hard,2.3,1.61,1
Galan D.E.,76,78,33,45,Martinez P.,135,118,50,68,2022-09-22,San Diego,San Diego Open,Hard,1.44,2.75,1
Rinderknech A.,67,96,46,50,Basilashvili N.,118,301,138,163,2022-09-22,Metz,Open de Moselle,Hard,1.36,3.2,1
Duckworth J.,123,143,55,88,Krueger M.,228,24,7,17,2022-09-22,San Diego,San Diego Open,Hard,1.4,3.0,1
Bublik A.,25,219,110,109,Ruusuvuori E.,55,158,79,79,2022-09-22,Metz,Open de Moselle,Hard,2.2,1.66,1
Barrere G.,59,79,31,48,Ymer M.,59,130,58,72,2022-09-22,Metz,Open de Moselle,Hard,2.75,1.44,0
O Connell C.,74,65,26,39,Wolf J.J.,45,75,39,36,2022-09-22,San Diego,San Diego Open,Hard,2.5,1.53,1
Mcdonald M.,60,190,87,103,Brooksby J.,39,79,46,33,2022-09-22,San Diego,San Diego Open,Hard,3.0,1.4,0
Lestienne C.,109,40,13,27,Tabilo A.,122,44,21,23,2022-09-22,San Diego,San Diego Open,Hard,2.2,1.66,1
Hurkacz H.,17,238,137,101,Thiem D.,116,517,327,190,2022-09-22,Metz,Open de Moselle,Hard,1.4,3.0,1
Rune H.,6,131,83,48,Bonzi B.,107,83,37,46,2022-09-22,Metz,Open de Moselle,Hard,2.37,1.57,1
Simon G.,188,869,491,378,Sonego L.,43,221,107,114,2022-09-22,Metz,Open de Moselle,Hard,3.0,1.4,0
Etcheverry T.,34,60,26,34,Giron M.,69,150,68,82,2022-09-22,San Diego,San Diego Open,Hard,3.5,1.3,0
Evans D.,30,251,124,127,Daniel T.,111,178,67,111,2022-09-23,San Diego,San Diego Open,Hard,1.4,3.0,1
Giron M.,69,150,68,82,Duckworth J.,123,143,55,88,2022-09-23,San Diego,San Diego Open,Hard,1.53,2.5,1
Evans D.,30,251,124,127,Lestienne C.,109,40,13,27,2022-09-23,San Diego,San Diego Open,Hard,1.4,3.0,1
Nakashima B.,70,106,57,49,Kudla D.,137,198,70,128,2022-09-23,San Diego,San Diego Open,Hard,1.28,3.75,1
Rune H.,6,131,83,48,Bublik A.,25,219,110,109,2022-09-23,Metz,Open de Moselle,Hard,1.9,1.9,0
Sonego L.,43,221,107,114,Korda S.,26,126,75,51,2022-09-23,Metz,Open de Moselle,Hard,2.75,1.44,1
Ymer M.,59,130,58,72,Wawrinka S.,72,854,535,319,2022-09-23,Metz,Open de Moselle,Hard,1.8,2.0,0
Rinderknech A.,67,96,46,50,Hurkacz H.,17,238,137,101,2022-09-23,Metz,Open de Moselle,Hard,4.33,1.22,0
Bublik A.,25,219,110,109,Wawrinka S.,72,854,535,319,2022-09-24,Metz,Open de Moselle,Hard,1.66,2.2,1
Sonego L.,43,221,107,114,Hurkacz H.,17,238,137,101,2022-09-24,Metz,Open de Moselle,Hard,3.5,1.3,1
O Connell C.,74,65,26,39,Brooksby J.,39,79,46,33,2022-09-24,San Diego,San Diego Open,Hard,3.5,1.3,1
Nakashima B.,70,106,57,49,Galan D.E.,76,78,33,45,2022-09-24,San Diego,San Diego Open,Hard,1.3,3.5,1
Giron M.,69,150,68,82,Evans D.,30,251,124,127,2022-09-24,San Diego,San Diego Open,Hard,2.62,1.5,1
Bublik A.,25,219,110,109,Sonego L.,43,221,107,114,2022-09-25,Metz,Open de Moselle,Hard,1.9,1.9,0
O Connell C.,74,65,26,39,Nakashima B.,70,106,57,49,2022-09-25,San Diego,San Diego Open,Hard,3.2,1.36,0
Berankis R.,212,249,104,145,Majchrzak K.,121,50,19,31,2022-09-26,Sofia,Sofia Open,Hard,1.66,2.2,0
Lehecka J.,33,61,30,31,Lazarov A.,301,6,1,5,2022-09-26,Sofia,Sofia Open,Hard,1.28,3.75,0
Ivashka I.,113,159,78,81,Ymer M.,59,130,58,72,2022-09-26,Sofia,Sofia Open,Hard,1.72,2.1,1
Thiem D.,116,517,327,190,Djere L.,38,243,120,123,2022-09-26,Tel Aviv,Tel Aviv Open,Hard,1.44,2.75,1
Grenier H.,122,16,5,11,Safiullin R.,92,42,20,22,2022-09-26,Tel Aviv,Tel Aviv Open,Hard,1.8,2.0,0
Moriya H.,253,14,3,11,Albot R.,97,215,86,129,2022-09-26,Seoul,Korea Open,Hard,,,0
Giron M.,69,150,68,82,Nakashima B.,70,106,57,49,2022-09-26,San Diego,San Diego Open,Hard,2.75,1.4,0
Munar J.,104,178,75,103,Watanuki Y.,99,25,11,14,2022-09-26,Seoul,Korea Open,Hard,1.44,2.75,1
Uchida K.,155,4,1,3,Hong S.,471,1,0,1,2022-09-26,Seoul,Korea Open,Hard,1.61,2.3,1
Kecmanovic M.,40,210,107,103,Kovacevic A.,129,14,6,8,2022-09-26,Seoul,Korea Open,Hard,1.12,6.0,0
Basic M.,292,50,22,28,Borges N.,69,28,10,18,2022-09-27,Sofia,Sofia Open,Hard,3.4,1.33,0
Otte O.,233,78,33,45,Madaras D.,191,2,0,2,2022-09-27,Sofia,Sofia Open,Hard,,,1
Van Rijthoven T.,110,19,10,9,Rune H.,6,131,83,48,2022-09-27,Sofia,Sofia Open,Hard,2.75,1.44,0
Vukic A.,62,36,15,21,Fognini F.,128,742,383,359,2022-09-27,Sofia,Sofia Open,Hard,2.62,1.5,1
Sousa J.,147,436,189,247,Van De Zandschulp B.,44,117,63,54,2022-09-27,Tel Aviv,Tel Aviv Open,Hard,3.5,1.3,0
Broady L.,125,47,18,29,Medjedovic H.,147,11,3,8,2022-09-27,Tel Aviv,Tel Aviv Open,Hard,1.33,3.4,1
Etcheverry T.,34,60,26,34,Karatsev A.,75,136,66,70,2022-09-27,Tel Aviv,Tel Aviv Open,Hard,3.5,1.3,1
Copil M.,350,128,47,81,Rinderknech A.,67,96,46,50,2022-09-27,Tel Aviv,Tel Aviv Open,Hard,3.4,1.33,0
Ruusuvuori E.,55,158,79,79,Wolf J.J.,45,75,39,36,2022-09-27,Tel Aviv,Tel Aviv Open,Hard,1.5,2.62,1
Ilkel C.,382,17,1,16,Korda S.,26,126,75,51,2022-09-27,Tel Aviv,Tel Aviv Open,Hard,5.5,1.14,0
Kuzmanov D.,207,12,4,8,Humbert U.,36,170,80,90,2022-09-27,Sofia,Sofia Open,Hard,4.0,1.25,0
Griekspoor T.,37,97,47,50,Pospisil V.,99,280,122,158,2022-09-27,Tel Aviv,Tel Aviv Open,Hard,1.44,2.75,0
Jarry N.,28,141,73,68,Peniston R.,268,13,6,7,2022-09-27,Seoul,Korea Open,Hard,1.5,2.62,1
O Connell C.,74,65,26,39,Tseng C. H.,108,8,2,6,2022-09-27,Seoul,Korea Open,Hard,1.53,2.5,0
Nam J.S.,590,3,0,3,Johnson S.,197,395,196,199,2022-09-27,Seoul,Korea Open,Hard,5.0,1.16,0
Martinez P.,135,118,50,68,Mcdonald M.,60,190,87,103,2022-09-27,Seoul,Korea Open,Hard,2.75,1.44,0
Chung Y.,322,2,0,2,Kwon S.W.,68,108,53,55,2022-09-27,Seoul,Korea Open,Hard,5.0,1.16,0
Nishioka Y.,31,215,99,116,Evans D.,30,251,124,127,2022-09-27,Seoul,Korea Open,Hard,2.0,1.8,1
Oliel Y.,383,2,0,2,Leshem E.,446,3,1,2,2022-09-27,Tel Aviv,Tel Aviv Open,Hard,2.1,1.72,0
Brooksby J.,39,79,46,33,Wu T.L.,175,6,1,5,2022-09-27,Seoul,Korea Open,Hard,1.14,5.5,1
Musetti L.,18,143,79,64,Lazarov A.,301,6,1,5,2022-09-28,Sofia,Sofia Open,Hard,1.25,4.0,1
Ivashka I.,113,159,78,81,Dimitrov G.,20,651,389,262,2022-09-28,Sofia,Sofia Open,Hard,2.0,1.8,1
Verdasco F.,244,962,537,425,Basilashvili N.,118,301,138,163,2022-09-28,Sofia,Sofia Open,Hard,2.2,1.66,1
Struff J.L.,21,369,170,199,Lajovic D.,66,378,163,215,2022-09-28,Sofia,Sofia Open,Hard,1.44,2.75,1
Huesler M.A.,88,58,21,37,Blancaneaux G.,152,6,0,6,2022-09-28,Sofia,Sofia Open,Hard,1.5,2.62,1
Sonego L.,43,221,107,114,Zapata Miralles B.,54,80,32,48,2022-09-28,Sofia,Sofia Open,Hard,1.33,3.4,1
Andujar P.,323,404,164,240,Monteiro T.,121,171,69,102,2022-09-28,Tel Aviv,Tel Aviv Open,Hard,2.75,1.44,1
Shapovalov D.,29,298,166,132,Munar J.,104,178,75,103,2022-09-28,Seoul,Korea Open,Hard,1.3,3.5,1
Albot R.,97,215,86,129,Johnson S.,197,395,196,199,2022-09-28,Seoul,Korea Open,Hard,1.66,2.2,1
Thiem D.,116,517,327,190,Cilic M.,100,853,543,310,2022-09-28,Tel Aviv,Tel Aviv Open,Hard,2.5,1.53,0
Cressy M.,96,96,42,54,Korda S.,26,126,75,51,2022-09-28,Tel Aviv,Tel Aviv Open,Hard,2.5,1.53,1
Safiullin R.,92,42,20,22,Etcheverry T.,34,60,26,34,2022-09-28,Tel Aviv,Tel Aviv Open,Hard,1.33,3.4,1
Lestienne C.,109,40,13,27,Mannarino A.,27,567,264,303,2022-09-28,Tel Aviv,Tel Aviv Open,Hard,2.37,1.57,1
Gomez E.,155,26,7,19,Daniel T.,111,178,67,111,2022-09-28,Seoul,Korea Open,Hard,3.75,1.28,0
Lestienne C.,109,40,13,27,Ruusuvuori E.,55,158,79,79,2022-09-29,Tel Aviv,Tel Aviv Open,Hard,3.0,1.4,1
Van De Zandschulp B.,44,117,63,54,Broady L.,125,47,18,29,2022-09-29,Tel Aviv,Tel Aviv Open,Hard,1.22,4.33,0
Djokovic N.,2,1207,1012,195,Andujar P.,323,404,164,240,2022-09-29,Tel Aviv,Tel Aviv Open,Hard,1.03,15.0,1
Nishioka Y.,31,215,99,116,Daniel T.,111,178,67,111,2022-09-29,Seoul,Korea Open,Hard,1.61,2.3,1
Leshem E.,446,3,1,2,Pospisil V.,99,280,122,158,2022-09-29,Tel Aviv,Tel Aviv Open,Hard,3.4,1.33,0
Rinderknech A.,67,96,46,50,Schwartzman D.,95,428,233,195,2022-09-29,Tel Aviv,Tel Aviv Open,Hard,2.1,1.72,1
Norrie C.,13,287,172,115,Uchida K.,155,4,1,3,2022-09-29,Seoul,Korea Open,Hard,1.08,8.0,1
Brooksby J.,39,79,46,33,Kwon S.W.,68,108,53,55,2022-09-29,Seoul,Korea Open,Hard,1.5,2.62,1
Tseng C. H.,108,8,2,6,Kovacevic A.,129,14,6,8,2022-09-29,Seoul,Korea Open,Hard,1.61,2.3,0
Mcdonald M.,60,190,87,103,Mochizuki S.,200,8,0,8,2022-09-29,Seoul,Korea Open,Hard,1.07,9.0,1
Sinner J.,8,224,153,71,Borges N.,69,28,10,18,2022-09-29,Sofia,Sofia Open,Hard,1.07,9.0,1
Huesler M.A.,88,58,21,37,Carreno Busta P.,16,352,214,138,2022-09-29,Sofia,Sofia Open,Hard,3.75,1.28,1
Sonego L.,43,221,107,114,Rune H.,6,131,83,48,2022-09-29,Sofia,Sofia Open,Hard,1.72,2.1,0
Majchrzak K.,121,50,19,31,Otte O.,233,78,33,45,2022-09-29,Sofia,Sofia Open,Hard,2.37,1.57,1
Struff J.L.,21,369,170,199,Humbert U.,36,170,80,90,2022-09-29,Sofia,Sofia Open,Hard,2.3,1.61,1
Jarry N.,28,141,73,68,Ruud C.,4,275,176,99,2022-09-29,Seoul,Korea Open,Hard,5.0,1.16,0
Vukic A.,62,36,15,21,Verdasco F.,244,962,537,425,2022-09-29,Sofia,Sofia Open,Hard,1.61,2.3,1
Shapovalov D.,29,298,166,132,Albot R.,97,215,86,129,2022-09-30,Seoul,Korea Open,Hard,1.28,3.75,1
Brooksby J.,39,79,46,33,Norrie C.,13,287,172,115,2022-09-30,Seoul,Korea Open,Hard,2.75,1.44,1
Huesler M.A.,88,58,21,37,Majchrzak K.,121,50,19,31,2022-09-30,Sofia,Sofia Open,Hard,1.66,2.2,1
Kovacevic A.,129,14,6,8,Mcdonald M.,60,190,87,103,2022-09-30,Seoul,Korea Open,Hard,3.75,1.28,1
Safiullin R.,92,42,20,22,Rinderknech A.,67,96,46,50,2022-09-30,Tel Aviv,Tel Aviv Open,Hard,1.9,1.9,1
Broady L.,125,47,18,29,Cilic M.,100,853,543,310,2022-09-30,Tel Aviv,Tel Aviv Open,Hard,5.0,1.16,0
Cressy M.,96,96,42,54,Lestienne C.,109,40,13,27,2022-09-30,Tel Aviv,Tel Aviv Open,Hard,1.53,2.5,0
Rune H.,6,131,83,48,Ivashka I.,113,159,78,81,2022-09-30,Sofia,Sofia Open,Hard,2.1,1.72,1
Sinner J.,8,224,153,71,Vukic A.,62,36,15,21,2022-09-30,Sofia,Sofia Open,Hard,1.12,6.0,1
Struff J.L.,21,369,170,199,Musetti L.,18,143,79,64,2022-09-30,Sofia,Sofia Open,Hard,1.66,2.2,0
Nishioka Y.,31,215,99,116,Ruud C.,4,275,176,99,2022-09-30,Seoul,Korea Open,Hard,4.33,1.22,1
Djokovic N.,2,1207,1012,195,Pospisil V.,99,280,122,158,2022-09-30,Tel Aviv,Tel Aviv Open,Hard,1.06,10.0,1
Lestienne C.,109,40,13,27,Cilic M.,100,853,543,310,2022-10-01,Tel Aviv,Tel Aviv Open,Hard,3.75,1.28,0
Djokovic N.,2,1207,1012,195,Safiullin R.,92,42,20,22,2022-10-01,Tel Aviv,Tel Aviv Open,Hard,1.06,10.0,1
Sinner J.,8,224,153,71,Rune H.,6,131,83,48,2022-10-01,Sofia,Sofia Open,Hard,1.28,3.75,0
Huesler M.A.,88,58,21,37,Musetti L.,18,143,79,64,2022-10-01,Sofia,Sofia Open,Hard,2.37,1.57,1
Kovacevic A.,129,14,6,8,Nishioka Y.,31,215,99,116,2022-10-01,Seoul,Korea Open,Hard,4.0,1.25,0
Shapovalov D.,29,298,166,132,Brooksby J.,39,79,46,33,2022-10-01,Seoul,Korea Open,Hard,1.66,2.2,1
Shapovalov D.,29,298,166,132,Nishioka Y.,31,215,99,116,2022-10-02,Seoul,Korea Open,Hard,1.53,2.5,0
Rune H.,6,131,83,48,Huesler M.A.,88,58,21,37,2022-10-02,Sofia,Sofia Open,Hard,1.5,2.62,0
Cilic M.,100,853,543,310,Djokovic N.,2,1207,1012,195,2022-10-02,Tel Aviv,Tel Aviv Open,Hard,4.0,1.25,0
Zapata Miralles B.,54,80,32,48,Daniel T.,111,178,67,111,2022-10-03,Tokyo,Rakuten Japan Open Tennis Championships,Hard,2.5,1.53,1
Tiafoe F.,10,303,158,145,Uchiyama Y.,314,33,9,24,2022-10-03,Tokyo,Rakuten Japan Open Tennis Championships,Hard,1.1,7.0,1
Mochizuki S.,200,8,0,8,Nakashima B.,70,106,57,49,2022-10-03,Tokyo,Rakuten Japan Open Tennis Championships,Hard,6.5,1.11,0
Rublev A.,7,392,255,137,Djere L.,38,243,120,123,2022-10-03,Nur-Sultan,Astana Open,Hard,1.28,3.75,1
Martinez P.,135,118,50,68,Popyrin A.,90,140,59,81,2022-10-03,Tokyo,Rakuten Japan Open Tennis Championships,Hard,2.1,1.72,1
Hurkacz H.,17,238,137,101,Cerundolo F.,21,104,58,46,2022-10-03,Nur-Sultan,Astana Open,Hard,1.22,4.33,1
Van De Zandschulp B.,44,117,63,54,Zhukayev B.,258,2,0,2,2022-10-03,Nur-Sultan,Astana Open,Hard,1.08,8.0,1
Wawrinka S.,72,854,535,319,Mannarino A.,27,567,264,303,2022-10-03,Nur-Sultan,Astana Open,Hard,1.72,2.1,0
Zhang Zh.,53,44,20,24,Karatsev A.,75,136,66,70,2022-10-03,Nur-Sultan,Astana Open,Hard,2.0,1.8,1
Bautista Agut R.,25,379,234,145,Auger-Aliassime F.,12,268,163,105,2022-10-03,Nur-Sultan,Astana Open,Hard,2.75,1.44,1
Uchida K.,155,4,1,3,Mcdonald M.,60,190,87,103,2022-10-04,Tokyo,Rakuten Japan Open Tennis Championships,Hard,5.0,1.16,0
Kwon S.W.,68,108,53,55,De Minaur A.,19,272,161,111,2022-10-04,Tokyo,Rakuten Japan Open Tennis Championships,Hard,4.33,1.22,1
Kokkinakis T.,86,124,55,69,Coric B.,15,343,185,158,2022-10-04,Tokyo,Rakuten Japan Open Tennis Championships,Hard,2.75,1.44,0
Albot R.,97,215,86,129,Evans D.,30,251,124,127,2022-10-04,Tokyo,Rakuten Japan Open Tennis Championships,Hard,3.5,1.3,0
Ruud C.,4,275,176,99,Munar J.,104,178,75,103,2022-10-04,Tokyo,Rakuten Japan Open Tennis Championships,Hard,1.2,4.5,0
Noguchi R.,291,2,1,1,Ramanathan R.,435,40,14,26,2022-10-04,Tokyo,Rakuten Japan Open Tennis Championships,Hard,1.9,1.9,1
Tseng C. H.,108,8,2,6,Kyrgios N.,25,303,195,108,2022-10-04,Tokyo,Rakuten Japan Open Tennis Championships,Hard,8.0,1.08,0
Moriya H.,253,14,3,11,Shimizu Y.,451,1,0,1,2022-10-04,Tokyo,Rakuten Japan Open Tennis Championships,Hard,2.2,1.66,1
Ramos-Vinolas A.,82,437,204,233,Medvedev D.,3,406,289,117,2022-10-04,Nur-Sultan,Astana Open,Hard,10.0,1.06,0
Griekspoor T.,37,97,47,50,Bublik A.,25,219,110,109,2022-10-04,Nur-Sultan,Astana Open,Hard,3.0,1.4,0
Nardi L.,151,11,2,9,Shevchenko A.,93,20,8,12,2022-10-04,Nur-Sultan,Astana Open,Hard,1.57,2.37,1
Kukushkin M.,221,352,141,211,Tsitsipas S.,5,390,264,126,2022-10-04,Nur-Sultan,Astana Open,Hard,7.0,1.1,0
Kotov P.,89,25,10,15,Davidovich Fokina A.,39,168,84,84,2022-10-04,Nur-Sultan,Astana Open,Hard,3.4,1.33,1
Khachanov K.,11,378,217,161,Cressy M.,96,96,42,54,2022-10-04,Nur-Sultan,Astana Open,Hard,1.66,2.2,1
Shimabukuro S.,161,4,1,3,Majchrzak K.,121,50,19,31,2022-10-04,Tokyo,Rakuten Japan Open Tennis Championships,Hard,2.75,1.44,0
Goffin D.,123,522,296,226,Alcaraz C.,1,164,130,34,2022-10-04,Nur-Sultan,Astana Open,Hard,6.0,1.12,1
Kecmanovic M.,40,210,107,103,Nishioka Y.,31,215,99,116,2022-10-05,Tokyo,Rakuten Japan Open Tennis Championships,Hard,2.1,1.72,1
Shapovalov D.,29,298,166,132,Johnson S.,197,395,196,199,2022-10-05,Tokyo,Rakuten Japan Open Tennis Championships,Hard,1.22,4.33,1
Fritz T.,9,356,205,151,Duckworth J.,123,143,55,88,2022-10-05,Tokyo,Rakuten Japan Open Tennis Championships,Hard,1.25,4.0,1
Martinez P.,135,118,50,68,Munar J.,104,178,75,103,2022-10-05,Tokyo,Rakuten Japan Open Tennis Championships,Hard,2.75,1.44,1
Mcdonald M.,60,190,87,103,Kwon S.W.,68,108,53,55,2022-10-05,Tokyo,Rakuten Japan Open Tennis Championships,Hard,2.3,1.61,0
Otte O.,233,78,33,45,Cilic M.,100,853,543,310,2022-10-05,Nur-Sultan,Astana Open,Hard,3.5,1.3,0
Huesler M.A.,88,58,21,37,Ruusuvuori E.,55,158,79,79,2022-10-05,Nur-Sultan,Astana Open,Hard,2.5,1.53,0
Djokovic N.,2,1207,1012,195,Garin C.,101,190,103,87,2022-10-05,Nur-Sultan,Astana Open,Hard,1.05,11.0,1
Zhang Zh.,53,44,20,24,Rublev A.,7,392,255,137,2022-10-05,Nur-Sultan,Astana Open,Hard,5.0,1.16,0
Goffin D.,123,522,296,226,Mannarino A.,27,567,264,303,2022-10-05,Nur-Sultan,Astana Open,Hard,1.66,2.2,0
Bautista Agut R.,25,379,234,145,Kotov P.,89,25,10,15,2022-10-05,Nur-Sultan,Astana Open,Hard,1.22,4.33,1
Tsitsipas S.,5,390,264,126,Nardi L.,151,11,2,9,2022-10-05,Nur-Sultan,Astana Open,Hard,1.16,5.0,1
Evans D.,30,251,124,127,Kecmanovic M.,40,210,107,103,2022-10-06,Tokyo,Rakuten Japan Open Tennis Championships,Hard,1.8,2.0,0
Zapata Miralles B.,54,80,32,48,Tiafoe F.,10,303,158,145,2022-10-06,Tokyo,Rakuten Japan Open Tennis Championships,Hard,4.0,1.25,0
Van De Zandschulp B.,44,117,63,54,Djokovic N.,2,1207,1012,195,2022-10-06,Nur-Sultan,Astana Open,Hard,8.0,1.08,0
Ruusuvuori E.,55,158,79,79,Medvedev D.,3,406,289,117,2022-10-06,Nur-Sultan,Astana Open,Hard,5.0,1.16,0
Moriya H.,253,14,3,11,Fritz T.,9,356,205,151,2022-10-06,Tokyo,Rakuten Japan Open Tennis Championships,Hard,9.0,1.07,0
Noguchi R.,291,2,1,1,Shapovalov D.,29,298,166,132,2022-10-06,Tokyo,Rakuten Japan Open Tennis Championships,Hard,8.0,1.08,0
Coric B.,15,343,185,158,Nakashima B.,70,106,57,49,2022-10-06,Tokyo,Rakuten Japan Open Tennis Championships,Hard,1.9,1.9,1
Majchrzak K.,121,50,19,31,Kyrgios N.,25,303,195,108,2022-10-06,Tokyo,Rakuten Japan Open Tennis Championships,Hard,9.0,1.07,0
Bublik A.,25,219,110,109,Hurkacz H.,17,238,137,101,2022-10-06,Nur-Sultan,Astana Open,Hard,2.37,1.57,0
Khachanov K.,11,378,217,161,Cilic M.,100,853,543,310,2022-10-06,Nur-Sultan,Astana Open,Hard,1.8,2.0,1
Tiafoe F.,10,303,158,145,Kecmanovic M.,40,210,107,103,2022-10-07,Tokyo,Rakuten Japan Open Tennis Championships,Hard,1.5,2.62,1
Tsitsipas S.,5,390,264,126,Hurkacz H.,17,238,137,101,2022-10-07,Nur-Sultan,Astana Open,Hard,1.72,2.1,1
Medvedev D.,3,406,289,117,Bautista Agut R.,25,379,234,145,2022-10-07,Nur-Sultan,Astana Open,Hard,1.4,3.0,1
Djokovic N.,2,1207,1012,195,Khachanov K.,11,378,217,161,2022-10-07,Nur-Sultan,Astana Open,Hard,1.12,6.0,1
Martinez P.,135,118,50,68,Kwon S.W.,68,108,53,55,2022-10-07,Tokyo,Rakuten Japan Open Tennis Championships,Hard,3.0,1.4,0
Rublev A.,7,392,255,137,Mannarino A.,27,567,264,303,2022-10-07,Nur-Sultan,Astana Open,Hard,1.22,4.33,1
Coric B.,15,343,185,158,Shapovalov D.,29,298,166,132,2022-10-07,Tokyo,Rakuten Japan Open Tennis Championships,Hard,1.66,2.2,0
Fritz T.,9,356,205,151,Kyrgios N.,25,303,195,108,2022-10-07,Tokyo,Rakuten Japan Open Tennis Championships,Hard,2.62,1.5,1
Kwon S.W.,68,108,53,55,Tiafoe F.,10,303,158,145,2022-10-08,Tokyo,Rakuten Japan Open Tennis Championships,Hard,3.5,1.3,0
Shapovalov D.,29,298,166,132,Fritz T.,9,356,205,151,2022-10-08,Tokyo,Rakuten Japan Open Tennis Championships,Hard,1.72,2.1,0
Medvedev D.,3,406,289,117,Djokovic N.,2,1207,1012,195,2022-10-08,Nur-Sultan,Astana Open,Hard,2.62,1.5,0
Tsitsipas S.,5,390,264,126,Rublev A.,7,392,255,137,2022-10-08,Nur-Sultan,Astana Open,Hard,1.8,2.0,1
Tiafoe F.,10,303,158,145,Fritz T.,9,356,205,151,2022-10-09,Tokyo,Rakuten Japan Open Tennis Championships,Hard,2.1,1.72,0
Tsitsipas S.,5,390,264,126,Djokovic N.,2,1207,1012,195,2022-10-09,Nur-Sultan,Astana Open,Hard,4.0,1.25,0
Lestienne C.,109,40,13,27,Baez S.,72,95,47,48,2022-10-10,Gijon,Gijon Open,Hard,1.53,2.5,1
Paul T.,14,204,111,93,Landaluce M.,720,3,0,3,2022-10-10,Gijon,Gijon Open,Hard,1.05,11.0,1
Thiem D.,116,517,327,190,Sousa J.,147,436,189,247,2022-10-10,Gijon,Gijon Open,Hard,1.25,4.0,1
Taberner C.,181,37,13,24,Rinderknech A.,67,96,46,50,2022-10-10,Gijon,Gijon Open,Hard,4.0,1.25,0
Monteiro T.,121,171,69,102,Bonzi B.,107,83,37,46,2022-10-10,Gijon,Gijon Open,Hard,3.2,1.36,1
Carballes Baena R.,64,207,91,116,Galan D.E.,76,78,33,45,2022-10-10,Florence,Firenze Open,Hard,2.3,1.61,1
Cobolli F.,148,14,5,9,Moutet C.,80,118,50,68,2022-10-10,Florence,Firenze Open,Hard,2.75,1.44,0
Maestrelli F.,186,1,0,1,Wolf J.J.,45,75,39,36,2022-10-10,Florence,Firenze Open,Hard,3.2,1.36,0
Karatsev A.,75,136,66,70,Griekspoor T.,37,97,47,50,2022-10-10,Florence,Firenze Open,Hard,2.37,1.57,1
Zeppieri G.,129,13,4,9,Celikbilek A.,230,9,4,5,2022-10-10,Florence,Firenze Open,Hard,2.1,1.72,0
Guinard M.,148,9,4,5,Fognini F.,128,742,383,359,2022-10-11,Gijon,Gijon Open,Hard,2.75,1.44,1
Alvarez Varona N.,231,3,1,2,Trungelliti M.,240,33,13,20,2022-10-11,Gijon,Gijon Open,Hard,2.3,1.61,1
Giron M.,69,150,68,82,Ramos-Vinolas A.,82,437,204,233,2022-10-11,Gijon,Gijon Open,Hard,1.53,2.5,1
Murray A.,44,932,687,245,Davidovich Fokina A.,39,168,84,84,2022-10-11,Gijon,Gijon Open,Hard,1.72,2.1,1
Lopez F.,634,863,441,422,Ivashka I.,113,159,78,81,2022-10-11,Gijon,Gijon Open,Hard,6.5,1.11,0
Bublik A.,25,219,110,109,Garin C.,101,190,103,87,2022-10-11,Florence,Firenze Open,Hard,1.25,4.0,1
Zhang Zh.,53,44,20,24,Passaro F.,126,10,3,7,2022-10-11,Florence,Firenze Open,Hard,1.53,2.5,0
Nakashima B.,70,106,57,49,Gasquet R.,48,948,581,367,2022-10-11,Florence,Firenze Open,Hard,1.44,2.75,1
Zapata Miralles B.,54,80,32,48,Sonego L.,43,221,107,114,2022-10-11,Florence,Firenze Open,Hard,3.75,1.28,1
Fucsovics M.,67,249,121,128,Otte O.,233,78,33,45,2022-10-11,Florence,Firenze Open,Hard,2.1,1.72,0
Ymer M.,59,130,58,72,Van Rijthoven T.,110,19,10,9,2022-10-11,Florence,Firenze Open,Hard,1.72,2.1,1
Vatutin A.,295,8,2,6,Cachin P.,54,52,23,29,2022-10-12,Gijon,Gijon Open,Hard,2.5,1.53,0
Paul T.,14,204,111,93,Alvarez Varona N.,231,3,1,2,2022-10-12,Gijon,Gijon Open,Hard,1.08,8.0,1
Carreno Busta P.,16,352,214,138,Monteiro T.,121,171,69,102,2022-10-12,Gijon,Gijon Open,Hard,1.12,6.0,1
Giron M.,69,150,68,82,Thiem D.,116,517,327,190,2022-10-12,Gijon,Gijon Open,Hard,3.0,1.4,0
Lestienne C.,109,40,13,27,Rinderknech A.,67,96,46,50,2022-10-12,Gijon,Gijon Open,Hard,2.0,1.8,0
Munar J.,104,178,75,103,Korda S.,26,126,75,51,2022-10-12,Gijon,Gijon Open,Hard,2.75,1.44,0
Moutet C.,80,118,50,68,Bublik A.,25,219,110,109,2022-10-12,Florence,Firenze Open,Hard,3.0,1.4,0
Mcdonald M.,60,190,87,103,Brooksby J.,39,79,46,33,2022-10-12,Florence,Firenze Open,Hard,2.75,1.44,1
Karatsev A.,75,136,66,70,Ymer M.,59,130,58,72,2022-10-12,Florence,Firenze Open,Hard,2.5,1.53,0
Carballes Baena R.,64,207,91,116,Berrettini M.,38,217,142,75,2022-10-12,Florence,Firenze Open,Hard,8.0,1.08,1
Cressy M.,96,96,42,54,Wolf J.J.,45,75,39,36,2022-10-12,Florence,Firenze Open,Hard,1.61,2.3,0
Korda S.,26,126,75,51,Bautista Agut R.,25,379,234,145,2022-10-13,Gijon,Gijon Open,Hard,2.0,1.8,1
Ivashka I.,113,159,78,81,Rublev A.,7,392,255,137,2022-10-13,Gijon,Gijon Open,Hard,3.5,1.3,0
Murray A.,44,932,687,245,Cachin P.,54,52,23,29,2022-10-13,Gijon,Gijon Open,Hard,1.22,4.33,1
Guinard M.,148,9,4,5,Cerundolo F.,21,104,58,46,2022-10-13,Gijon,Gijon Open,Hard,2.75,1.44,0
Auger-Aliassime F.,12,268,163,105,Otte O.,233,78,33,45,2022-10-13,Florence,Firenze Open,Hard,1.2,4.5,1
Zapata Miralles B.,54,80,32,48,Musetti L.,18,143,79,64,2022-10-13,Florence,Firenze Open,Hard,2.75,1.44,0
Nakashima B.,70,106,57,49,Celikbilek A.,230,9,4,5,2022-10-13,Florence,Firenze Open,Hard,1.14,5.5,1
Passaro F.,126,10,3,7,Mcdonald M.,60,190,87,103,2022-10-13,Florence,Firenze Open,Hard,3.5,1.3,0
Thiem D.,116,517,327,190,Cerundolo F.,21,104,58,46,2022-10-14,Gijon,Gijon Open,Hard,1.4,3.0,1
Carreno Busta P.,16,352,214,138,Rinderknech A.,67,96,46,50,2022-10-14,Gijon,Gijon Open,Hard,1.33,3.4,0
Carballes Baena R.,64,207,91,116,Ymer M.,59,130,58,72,2022-10-14,Florence,Firenze Open,Hard,2.62,1.5,0
Bublik A.,25,219,110,109,Wolf J.J.,45,75,39,36,2022-10-14,Florence,Firenze Open,Hard,1.5,2.62,0
Mcdonald M.,60,190,87,103,Musetti L.,18,143,79,64,2022-10-14,Florence,Firenze Open,Hard,2.75,1.44,0
Auger-Aliassime F.,12,268,163,105,Nakashima B.,70,106,57,49,2022-10-14,Florence,Firenze Open,Hard,1.53,2.5,1
Paul T.,14,204,111,93,Rublev A.,7,392,255,137,2022-10-14,Gijon,Gijon Open,Hard,2.75,1.44,0
Korda S.,26,126,75,51,Murray A.,44,932,687,245,2022-10-14,Gijon,Gijon Open,Hard,1.53,2.5,1
Rublev A.,7,392,255,137,Thiem D.,116,517,327,190,2022-10-15,Gijon,Gijon Open,Hard,1.3,3.5,1
Rinderknech A.,67,96,46,50,Korda S.,26,126,75,51,2022-10-15,Gijon,Gijon Open,Hard,3.0,1.4,0
Musetti L.,18,143,79,64,Auger-Aliassime F.,12,268,163,105,2022-10-15,Florence,Firenze Open,Hard,2.75,1.44,0
Ymer M.,59,130,58,72,Wolf J.J.,45,75,39,36,2022-10-15,Florence,Firenze Open,Hard,1.57,2.37,0
Korda S.,26,126,75,51,Rublev A.,7,392,255,137,2022-10-16,Gijon,Gijon Open,Hard,3.0,1.4,0
Wolf J.J.,45,75,39,36,Auger-Aliassime F.,12,268,163,105,2022-10-16,Florence,Firenze Open,Hard,4.5,1.2,0
Draper J.,55,51,29,22,Brooksby J.,39,79,46,33,2022-10-17,Antwerp,European Open,Hard,2.0,1.8,1
Griekspoor T.,37,97,47,50,Evans D.,30,251,124,127,2022-10-17,Antwerp,European Open,Hard,3.2,1.36,0
Gasquet R.,48,948,581,367,Wawrinka S.,72,854,535,319,2022-10-17,Antwerp,European Open,Hard,2.5,1.53,1
Cressy M.,96,96,42,54,Ivashka I.,113,159,78,81,2022-10-17,Stockholm,Stockholm Open,Hard,2.5,1.53,1
Kubler J.,77,53,24,29,Garin C.,101,190,103,87,2022-10-17,Stockholm,Stockholm Open,Hard,1.57,2.37,0
Rosol L.,226,259,110,149,Karatsev A.,75,136,66,70,2022-10-17,Stockholm,Stockholm Open,Hard,2.75,1.44,0
Rune H.,6,131,83,48,Monteiro T.,121,171,69,102,2022-10-17,Stockholm,Stockholm Open,Hard,1.28,3.75,1
Cachin P.,54,52,23,29,Mannarino A.,27,567,264,303,2022-10-18,Napoli,Napoli Cup,Hard,3.0,1.4,1
Galan D.E.,76,78,33,45,Zapata Miralles B.,54,80,32,48,2022-10-18,Napoli,Napoli Cup,Hard,2.0,1.8,1
Ramos-Vinolas A.,82,437,204,233,Borges N.,69,28,10,18,2022-10-18,Napoli,Napoli Cup,Hard,1.8,2.0,0
Cobolli F.,148,14,5,9,Kecmanovic M.,40,210,107,103,2022-10-18,Napoli,Napoli Cup,Hard,4.0,1.25,0
De Minaur A.,19,272,161,111,Bonzi B.,107,83,37,46,2022-10-18,Stockholm,Stockholm Open,Hard,1.36,3.2,1
Ruusuvuori E.,55,158,79,79,Sousa J.,147,436,189,247,2022-10-18,Stockholm,Stockholm Open,Hard,1.2,4.5,1
Dimitrov G.,20,651,389,262,Lehecka J.,33,61,30,31,2022-10-18,Stockholm,Stockholm Open,Hard,1.28,3.75,0
Ymer M.,59,130,58,72,Halys Q.,79,72,23,49,2022-10-18,Stockholm,Stockholm Open,Hard,1.36,3.2,1
Paul T.,14,204,111,93,Borg L.,437,4,1,3,2022-10-18,Stockholm,Stockholm Open,Hard,1.005,29.0,1
Bellier A.,190,9,4,5,Shevchenko A.,93,20,8,12,2022-10-18,Stockholm,Stockholm Open,Hard,2.37,1.57,1
Martinez P.,135,118,50,68,Daniel T.,111,178,67,111,2022-10-18,Napoli,Napoli Cup,Hard,2.1,1.72,0
Munar J.,104,178,75,103,Van Rijthoven T.,110,19,10,9,2022-10-18,Antwerp,European Open,Hard,2.2,1.66,1
Van Assche L.,68,20,7,13,Nishioka Y.,31,215,99,116,2022-10-18,Antwerp,European Open,Hard,4.5,1.2,0
Huesler M.A.,88,58,21,37,Cerundolo F.,21,104,58,46,2022-10-18,Antwerp,European Open,Hard,1.66,2.2,0
Bailly G.,1185,1,0,1,Goffin D.,123,522,296,226,2022-10-18,Antwerp,European Open,Hard,11.0,1.05,0
Van De Zandschulp B.,44,117,63,54,Stricker D.,106,20,10,10,2022-10-18,Antwerp,European Open,Hard,1.3,3.5,0
Lestienne C.,109,40,13,27,De Jong J.,180,3,0,3,2022-10-18,Antwerp,European Open,Hard,1.4,3.0,1
Cressy M.,96,96,42,54,Tsitsipas S.,5,390,264,126,2022-10-19,Stockholm,Stockholm Open,Hard,3.75,1.28,0
Rune H.,6,131,83,48,Garin C.,101,190,103,87,2022-10-19,Stockholm,Stockholm Open,Hard,1.33,3.4,1
Shapovalov D.,29,298,166,132,Bellier A.,190,9,4,5,2022-10-19,Stockholm,Stockholm Open,Hard,1.11,6.5,1
Karatsev A.,75,136,66,70,Norrie C.,13,287,172,115,2022-10-19,Stockholm,Stockholm Open,Hard,3.2,1.36,0
Nardi L.,151,11,2,9,Moutet C.,80,118,50,68,2022-10-19,Napoli,Napoli Cup,Hard,2.1,1.72,0
Sonego L.,43,221,107,114,Baez S.,72,95,47,48,2022-10-19,Napoli,Napoli Cup,Hard,1.3,3.5,0
Carballes Baena R.,64,207,91,116,Jarry N.,28,141,73,68,2022-10-19,Napoli,Napoli Cup,Hard,1.8,2.0,1
Munar J.,104,178,75,103,Nishioka Y.,31,215,99,116,2022-10-19,Antwerp,European Open,Hard,2.37,1.57,0
Draper J.,55,51,29,22,Hurkacz H.,17,238,137,101,2022-10-19,Antwerp,European Open,Hard,2.2,1.66,0
Otte O.,233,78,33,45,Ymer E.,186,81,24,57,2022-10-19,Stockholm,Stockholm Open,Hard,1.53,2.5,0
Molcan A.,120,86,45,41,Wolf J.J.,45,75,39,36,2022-10-19,Stockholm,Stockholm Open,Hard,2.3,1.61,0
Evans D.,30,251,124,127,Lestienne C.,109,40,13,27,2022-10-19,Antwerp,European Open,Hard,1.36,3.2,1
Geerts M.,268,1,0,1,Thiem D.,116,517,327,190,2022-10-19,Antwerp,European Open,Hard,6.0,1.12,0
Giron M.,69,150,68,82,Korda S.,26,126,75,51,2022-10-19,Antwerp,European Open,Hard,2.75,1.44,0
Blancaneaux G.,152,6,0,6,Guinard M.,148,9,4,5,2022-10-19,Antwerp,European Open,Hard,1.9,1.9,0
Stricker D.,106,20,10,10,Gasquet R.,48,948,581,367,2022-10-19,Antwerp,European Open,Hard,1.9,1.9,0
Moutet C.,80,118,50,68,Kecmanovic M.,40,210,107,103,2022-10-20,Napoli,Napoli Cup,Hard,3.2,1.36,0
Wolf J.J.,45,75,39,36,De Minaur A.,19,272,161,111,2022-10-20,Stockholm,Stockholm Open,Hard,3.0,1.4,0
Musetti L.,18,143,79,64,Djere L.,38,243,120,123,2022-10-20,Napoli,Napoli Cup,Hard,1.5,2.62,1
Auger-Aliassime F.,12,268,163,105,Guinard M.,148,9,4,5,2022-10-20,Antwerp,European Open,Hard,1.11,6.5,1
Bautista Agut R.,25,379,234,145,Mcdonald M.,60,190,87,103,2022-10-20,Napoli,Napoli Cup,Hard,1.4,3.0,0
Schwartzman D.,95,428,233,195,Goffin D.,123,522,296,226,2022-10-20,Antwerp,European Open,Hard,1.9,1.9,0
Ymer E.,186,81,24,57,Tiafoe F.,10,303,158,145,2022-10-20,Stockholm,Stockholm Open,Hard,4.33,1.22,0
Paul T.,14,204,111,93,Ymer M.,59,130,58,72,2022-10-20,Stockholm,Stockholm Open,Hard,1.8,2.0,0
Ruusuvuori E.,55,158,79,79,Lehecka J.,33,61,30,31,2022-10-20,Stockholm,Stockholm Open,Hard,1.33,3.4,1
Borges N.,69,28,10,18,Galan D.E.,76,78,33,45,2022-10-20,Napoli,Napoli Cup,Hard,1.8,2.0,0
Khachanov K.,11,378,217,161,Korda S.,26,126,75,51,2022-10-20,Antwerp,European Open,Hard,1.72,2.1,0
Thiem D.,116,517,327,190,Cerundolo F.,21,104,58,46,2022-10-20,Antwerp,European Open,Hard,1.36,3.2,1
Fucsovics M.,67,249,121,128,Zhang Zh.,53,44,20,24,2022-10-20,Napoli,Napoli Cup,Hard,1.8,2.0,0
Fognini F.,128,742,383,359,Grenier H.,122,16,5,11,2022-10-20,Napoli,Napoli Cup,Hard,1.9,1.9,1
Djere L.,38,243,120,123,Gojo B.,115,14,3,11,2022-10-20,Napoli,Napoli Cup,Hard,1.66,2.2,1
Daniel T.,111,178,67,111,Cachin P.,54,52,23,29,2022-10-20,Napoli,Napoli Cup,Hard,1.66,2.2,1
Berrettini M.,38,217,142,75,Carballes Baena R.,64,207,91,116,2022-10-20,Napoli,Napoli Cup,Hard,1.14,5.5,1
Mcdonald M.,60,190,87,103,Passaro F.,126,10,3,7,2022-10-20,Napoli,Napoli Cup,Hard,1.3,3.5,1
Baez S.,72,95,47,48,Zhang Zh.,53,44,20,24,2022-10-20,Napoli,Napoli Cup,Hard,1.72,2.1,0
Shapovalov D.,29,298,166,132,De Minaur A.,19,272,161,111,2022-10-21,Stockholm,Stockholm Open,Hard,1.9,1.9,0
Tsitsipas S.,5,390,264,126,Ymer M.,59,130,58,72,2022-10-21,Stockholm,Stockholm Open,Hard,1.25,4.0,1
Ruusuvuori E.,55,158,79,79,Tiafoe F.,10,303,158,145,2022-10-21,Stockholm,Stockholm Open,Hard,2.0,1.8,1
Norrie C.,13,287,172,115,Rune H.,6,131,83,48,2022-10-21,Stockholm,Stockholm Open,Hard,1.66,2.2,0
Kecmanovic M.,40,210,107,103,Carreno Busta P.,16,352,214,138,2022-10-21,Napoli,Napoli Cup,Hard,2.37,1.57,1
Mcdonald M.,60,190,87,103,Zhang Zh.,53,44,20,24,2022-10-21,Napoli,Napoli Cup,Hard,1.53,2.5,1
Galan D.E.,76,78,33,45,Musetti L.,18,143,79,64,2022-10-21,Napoli,Napoli Cup,Hard,3.5,1.3,0
Daniel T.,111,178,67,111,Berrettini M.,38,217,142,75,2022-10-21,Napoli,Napoli Cup,Hard,6.0,1.12,0
Fognini F.,128,742,383,359,Carreno Busta P.,16,352,214,138,2022-10-21,Napoli,Napoli Cup,Hard,3.5,1.3,0
Auger-Aliassime F.,12,268,163,105,Evans D.,30,251,124,127,2022-10-21,Antwerp,European Open,Hard,1.36,3.2,1
Gasquet R.,48,948,581,367,Goffin D.,123,522,296,226,2022-10-21,Antwerp,European Open,Hard,2.37,1.57,1
Hurkacz H.,17,238,137,101,Thiem D.,116,517,327,190,2022-10-21,Antwerp,European Open,Hard,1.44,2.75,0
Korda S.,26,126,75,51,Nishioka Y.,31,215,99,116,2022-10-21,Antwerp,European Open,Hard,1.44,2.75,1
Korda S.,26,126,75,51,Thiem D.,116,517,327,190,2022-10-22,Antwerp,European Open,Hard,1.61,2.3,1
Musetti L.,18,143,79,64,Kecmanovic M.,40,210,107,103,2022-10-22,Napoli,Napoli Cup,Hard,1.8,2.0,1
Berrettini M.,38,217,142,75,Mcdonald M.,60,190,87,103,2022-10-22,Napoli,Napoli Cup,Hard,1.16,5.0,1
Gasquet R.,48,948,581,367,Auger-Aliassime F.,12,268,163,105,2022-10-22,Antwerp,European Open,Hard,5.0,1.16,0
Tsitsipas S.,5,390,264,126,Ruusuvuori E.,55,158,79,79,2022-10-22,Stockholm,Stockholm Open,Hard,1.36,3.2,1
De Minaur A.,19,272,161,111,Rune H.,6,131,83,48,2022-10-22,Stockholm,Stockholm Open,Hard,1.66,2.2,0
Tsitsipas S.,5,390,264,126,Rune H.,6,131,83,48,2022-10-23,Stockholm,Stockholm Open,Hard,1.36,3.2,0
Berrettini M.,38,217,142,75,Musetti L.,18,143,79,64,2022-10-23,Napoli,Napoli Cup,Hard,1.9,1.9,0
Auger-Aliassime F.,12,268,163,105,Korda S.,26,126,75,51,2022-10-23,Antwerp,European Open,Hard,1.53,2.5,1
Fritz T.,9,356,205,151,Nishioka Y.,31,215,99,116,2022-10-24,Vienna,Vienna Open,Hard,1.33,3.4,1
Cerundolo F.,21,104,58,46,Misolic F.,158,11,6,5,2022-10-24,Vienna,Vienna Open,Hard,1.36,3.2,1
Rublev A.,7,392,255,137,Schwartzman D.,95,428,233,195,2022-10-24,Vienna,Vienna Open,Hard,1.12,6.0,1
Coric B.,15,343,185,158,Halys Q.,79,72,23,49,2022-10-24,Vienna,Vienna Open,Hard,1.44,2.75,1
Khachanov K.,11,378,217,161,Wolf J.J.,45,75,39,36,2022-10-24,Vienna,Vienna Open,Hard,1.44,2.75,1
Cilic M.,100,853,543,310,Rinderknech A.,67,96,46,50,2022-10-24,Basel,Swiss Indoors,Hard,1.33,3.4,0
Nakashima B.,70,106,57,49,Goffin D.,123,522,296,226,2022-10-24,Basel,Swiss Indoors,Hard,1.5,2.62,1
Bublik A.,25,219,110,109,Karatsev A.,75,136,66,70,2022-10-24,Basel,Swiss Indoors,Hard,1.44,2.75,1
Alcaraz C.,1,164,130,34,Draper J.,55,51,29,22,2022-10-24,Basel,Swiss Indoors,Hard,1.4,3.0,1
Evans D.,30,251,124,127,Otte O.,233,78,33,45,2022-10-25,Vienna,Vienna Open,Hard,1.44,2.75,1
Monteiro T.,121,171,69,102,Dimitrov G.,20,651,389,262,2022-10-25,Vienna,Vienna Open,Hard,3.2,1.36,0
Sonego L.,43,221,107,114,Ruusuvuori E.,55,158,79,79,2022-10-25,Vienna,Vienna Open,Hard,2.3,1.61,0
Shapovalov D.,29,298,166,132,Rodionov J.,118,26,9,17,2022-10-25,Vienna,Vienna Open,Hard,1.22,4.33,1
Thiem D.,116,517,327,190,Paul T.,14,204,111,93,2022-10-25,Vienna,Vienna Open,Hard,1.57,2.37,1
Norrie C.,13,287,172,115,Cachin P.,54,52,23,29,2022-10-25,Vienna,Vienna Open,Hard,1.14,5.5,1
Tiafoe F.,10,303,158,145,Hurkacz H.,17,238,137,101,2022-10-25,Vienna,Vienna Open,Hard,2.37,1.57,0
Baez S.,72,95,47,48,Carreno Busta P.,16,352,214,138,2022-10-25,Basel,Swiss Indoors,Hard,4.5,1.2,0
Molcan A.,120,86,45,41,Mcdonald M.,60,190,87,103,2022-10-25,Basel,Swiss Indoors,Hard,2.3,1.61,1
Davidovich Fokina A.,39,168,84,84,Kecmanovic M.,40,210,107,103,2022-10-25,Basel,Swiss Indoors,Hard,2.5,1.53,0
Bautista Agut R.,25,379,234,145,Djere L.,38,243,120,123,2022-10-25,Basel,Swiss Indoors,Hard,1.33,3.4,1
Ruud C.,4,275,176,99,Wawrinka S.,72,854,535,319,2022-10-25,Basel,Swiss Indoors,Hard,1.44,2.75,0
Stricker D.,106,20,10,10,Cressy M.,96,96,42,54,2022-10-25,Basel,Swiss Indoors,Hard,2.37,1.57,1
Mannarino A.,27,567,264,303,Van De Zandschulp B.,44,117,63,54,2022-10-25,Basel,Swiss Indoors,Hard,2.37,1.57,0
Safiullin R.,92,42,20,22,Murray A.,44,932,687,245,2022-10-25,Basel,Swiss Indoors,Hard,2.2,1.66,0
Tsitsipas S.,5,390,264,126,Novak D.,166,58,15,43,2022-10-26,Vienna,Vienna Open,Hard,1.08,8.0,1
Basilashvili N.,118,301,138,163,Medvedev D.,3,406,289,117,2022-10-26,Vienna,Vienna Open,Hard,15.0,1.03,0
Evans D.,30,251,124,127,Khachanov K.,11,378,217,161,2022-10-26,Vienna,Vienna Open,Hard,2.1,1.72,1
Fritz T.,9,356,205,151,Shapovalov D.,29,298,166,132,2022-10-26,Vienna,Vienna Open,Hard,1.66,2.2,0
Garin C.,101,190,103,87,Sinner J.,8,224,153,71,2022-10-26,Vienna,Vienna Open,Hard,6.0,1.12,0
Griekspoor T.,37,97,47,50,Giron M.,69,150,68,82,2022-10-26,Vienna,Vienna Open,Hard,2.37,1.57,0
Rinderknech A.,67,96,46,50,Molcan A.,120,86,45,41,2022-10-26,Basel,Swiss Indoors,Hard,1.57,2.37,1
Brooksby J.,39,79,46,33,Humbert U.,36,170,80,90,2022-10-26,Basel,Swiss Indoors,Hard,2.0,1.8,0
Rune H.,6,131,83,48,De Minaur A.,19,272,161,111,2022-10-26,Basel,Swiss Indoors,Hard,2.2,1.66,1
Musetti L.,18,143,79,64,Ramos-Vinolas A.,82,437,204,233,2022-10-26,Basel,Swiss Indoors,Hard,1.22,4.33,0
Huesler M.A.,88,58,21,37,Auger-Aliassime F.,12,268,163,105,2022-10-26,Basel,Swiss Indoors,Hard,4.5,1.2,0
Van De Zandschulp B.,44,117,63,54,Alcaraz C.,1,164,130,34,2022-10-26,Basel,Swiss Indoors,Hard,4.5,1.2,0
Carreno Busta P.,16,352,214,138,Stricker D.,106,20,10,10,2022-10-26,Basel,Swiss Indoors,Hard,1.3,3.5,1
Sinner J.,8,224,153,71,Cerundolo F.,21,104,58,46,2022-10-27,Vienna,Vienna Open,Hard,1.14,5.5,1
Giron M.,69,150,68,82,Norrie C.,13,287,172,115,2022-10-27,Vienna,Vienna Open,Hard,3.0,1.4,1
Dimitrov G.,20,651,389,262,Rublev A.,7,392,255,137,2022-10-27,Vienna,Vienna Open,Hard,4.5,1.2,1
Medvedev D.,3,406,289,117,Thiem D.,116,517,327,190,2022-10-27,Vienna,Vienna Open,Hard,1.28,3.75,1
Bublik A.,25,219,110,109,Ramos-Vinolas A.,82,437,204,233,2022-10-27,Basel,Swiss Indoors,Hard,1.25,4.0,1
Kecmanovic M.,40,210,107,103,Auger-Aliassime F.,12,268,163,105,2022-10-27,Basel,Swiss Indoors,Hard,3.2,1.36,0
Nakashima B.,70,106,57,49,Wawrinka S.,72,854,535,319,2022-10-27,Basel,Swiss Indoors,Hard,1.72,2.1,0
Rune H.,6,131,83,48,Humbert U.,36,170,80,90,2022-10-27,Basel,Swiss Indoors,Hard,1.44,2.75,1
Coric B.,15,343,185,158,Tsitsipas S.,5,390,264,126,2022-10-27,Vienna,Vienna Open,Hard,2.75,1.44,1
Murray A.,44,932,687,245,Bautista Agut R.,25,379,234,145,2022-10-27,Basel,Swiss Indoors,Hard,2.5,1.53,0
Ruusuvuori E.,55,158,79,79,Hurkacz H.,17,238,137,101,2022-10-27,Vienna,Vienna Open,Hard,2.5,1.53,0
Coric B.,15,343,185,158,Hurkacz H.,17,238,137,101,2022-10-28,Vienna,Vienna Open,Hard,2.3,1.61,1
Sinner J.,8,224,153,71,Medvedev D.,3,406,289,117,2022-10-28,Vienna,Vienna Open,Hard,3.0,1.4,0
Dimitrov G.,20,651,389,262,Giron M.,69,150,68,82,2022-10-28,Vienna,Vienna Open,Hard,1.4,3.0,1
Evans D.,30,251,124,127,Shapovalov D.,29,298,166,132,2022-10-28,Vienna,Vienna Open,Hard,2.1,1.72,0
Rune H.,6,131,83,48,Rinderknech A.,67,96,46,50,2022-10-28,Basel,Swiss Indoors,Hard,1.3,3.5,1
Wawrinka S.,72,854,535,319,Bautista Agut R.,25,379,234,145,2022-10-28,Basel,Swiss Indoors,Hard,2.3,1.61,0
Alcaraz C.,1,164,130,34,Carreno Busta P.,16,352,214,138,2022-10-28,Basel,Swiss Indoors,Hard,1.25,4.0,1
Auger-Aliassime F.,12,268,163,105,Bublik A.,25,219,110,109,2022-10-28,Basel,Swiss Indoors,Hard,1.25,4.0,1
Bautista Agut R.,25,379,234,145,Rune H.,6,131,83,48,2022-10-29,Basel,Swiss Indoors,Hard,2.5,1.53,0
Auger-Aliassime F.,12,268,163,105,Alcaraz C.,1,164,130,34,2022-10-29,Basel,Swiss Indoors,Hard,2.1,1.72,1
Dimitrov G.,20,651,389,262,Medvedev D.,3,406,289,117,2022-10-29,Vienna,Vienna Open,Hard,5.0,1.16,0
Coric B.,15,343,185,158,Shapovalov D.,29,298,166,132,2022-10-29,Vienna,Vienna Open,Hard,2.1,1.72,0
Auger-Aliassime F.,12,268,163,105,Rune H.,6,131,83,48,2022-10-30,Basel,Swiss Indoors,Hard,1.33,3.4,1
Shapovalov D.,29,298,166,132,Medvedev D.,3,406,289,117,2022-10-30,Vienna,Vienna Open,Hard,4.33,1.22,0
Korda S.,26,126,75,51,De Minaur A.,19,272,161,111,2022-10-31,Paris,BNP Paribas Masters,Hard,1.66,2.2,0
Simon G.,188,869,491,378,Murray A.,44,932,687,245,2022-10-31,Paris,BNP Paribas Masters,Hard,4.0,1.25,1
Ymer M.,59,130,58,72,Bublik A.,25,219,110,109,2022-10-31,Paris,BNP Paribas Masters,Hard,2.1,1.72,1
Sonego L.,43,221,107,114,Tiafoe F.,10,303,158,145,2022-10-31,Paris,BNP Paribas Masters,Hard,2.75,1.44,0
Sinner J.,8,224,153,71,Huesler M.A.,88,58,21,37,2022-10-31,Paris,BNP Paribas Masters,Hard,1.2,4.5,0
Schwartzman D.,95,428,233,195,Cressy M.,96,96,42,54,2022-10-31,Paris,BNP Paribas Masters,Hard,2.3,1.61,0
Gasquet R.,48,948,581,367,Molcan A.,120,86,45,41,2022-10-31,Paris,BNP Paribas Masters,Hard,1.5,2.62,1
Baez S.,72,95,47,48,Khachanov K.,11,378,217,161,2022-10-31,Paris,BNP Paribas Masters,Hard,6.0,1.12,0
Halys Q.,79,72,23,49,Basilashvili N.,118,301,138,163,2022-10-31,Paris,BNP Paribas Masters,Hard,1.22,4.33,0
Fritz T.,9,356,205,151,Davidovich Fokina A.,39,168,84,84,2022-10-31,Paris,BNP Paribas Masters,Hard,1.22,4.33,1
Karatsev A.,75,136,66,70,Nishioka Y.,31,215,99,116,2022-10-31,Paris,BNP Paribas Masters,Hard,3.0,1.4,0
Norrie C.,13,287,172,115,Kecmanovic M.,40,210,107,103,2022-10-31,Paris,BNP Paribas Masters,Hard,1.61,2.3,1
Otte O.,233,78,33,45,Isner J.,114,755,465,290,2022-10-31,Paris,BNP Paribas Masters,Hard,1.8,2.0,0
Cilic M.,100,853,543,310,Musetti L.,18,143,79,64,2022-10-31,Paris,BNP Paribas Masters,Hard,1.53,2.5,0
Wawrinka S.,72,854,535,319,Rune H.,6,131,83,48,2022-11-01,Paris,BNP Paribas Masters,Hard,2.75,1.44,0
Khachanov K.,11,378,217,161,Huesler M.A.,88,58,21,37,2022-11-01,Paris,BNP Paribas Masters,Hard,1.5,2.62,1
Gasquet R.,48,948,581,367,Ruud C.,4,275,176,99,2022-11-01,Paris,BNP Paribas Masters,Hard,2.62,1.5,0
Djokovic N.,2,1207,1012,195,Cressy M.,96,96,42,54,2022-11-01,Paris,BNP Paribas Masters,Hard,1.06,10.0,1
Isner J.,114,755,465,290,Rublev A.,7,392,255,137,2022-11-01,Paris,BNP Paribas Masters,Hard,3.4,1.33,0
Shapovalov D.,29,298,166,132,Cerundolo F.,21,104,58,46,2022-11-01,Paris,BNP Paribas Masters,Hard,1.22,4.33,1
Dimitrov G.,20,651,389,262,Van De Zandschulp B.,44,117,63,54,2022-11-01,Paris,BNP Paribas Masters,Hard,1.61,2.3,1
Mannarino A.,27,567,264,303,Hurkacz H.,17,238,137,101,2022-11-01,Paris,BNP Paribas Masters,Hard,4.33,1.22,0
Fognini F.,128,742,383,359,Fils A.,71,24,15,9,2022-11-01,Paris,BNP Paribas Masters,Hard,1.72,2.1,1
Carreno Busta P.,16,352,214,138,Ramos-Vinolas A.,82,437,204,233,2022-11-01,Paris,BNP Paribas Masters,Hard,1.2,4.5,1
Rinderknech A.,67,96,46,50,Draper J.,55,51,29,22,2022-11-01,Paris,BNP Paribas Masters,Hard,2.37,1.57,0
Coric B.,15,343,185,158,Moutet C.,80,118,50,68,2022-11-01,Paris,BNP Paribas Masters,Hard,1.4,3.0,0
Nakashima B.,70,106,57,49,Evans D.,30,251,124,127,2022-11-01,Paris,BNP Paribas Masters,Hard,2.0,1.8,0
Bautista Agut R.,25,379,234,145,Paul T.,14,204,111,93,2022-11-01,Paris,BNP Paribas Masters,Hard,1.66,2.2,0
Rune H.,6,131,83,48,Hurkacz H.,17,238,137,101,2022-11-02,Paris,BNP Paribas Masters,Hard,2.5,1.53,1
Moutet C.,80,118,50,68,Norrie C.,13,287,172,115,2022-11-02,Paris,BNP Paribas Masters,Hard,3.0,1.4,1
Paul T.,14,204,111,93,Nadal R.,2,1223,1017,206,2022-11-02,Paris,BNP Paribas Masters,Hard,2.75,1.44,1
Shapovalov D.,29,298,166,132,Carreno Busta P.,16,352,214,138,2022-11-02,Paris,BNP Paribas Masters,Hard,1.8,2.0,0
Fritz T.,9,356,205,151,Simon G.,188,869,491,378,2022-11-02,Paris,BNP Paribas Masters,Hard,1.12,6.0,0
Dimitrov G.,20,651,389,262,Fognini F.,128,742,383,359,2022-11-02,Paris,BNP Paribas Masters,Hard,1.22,4.33,1
Ymer M.,59,130,58,72,Auger-Aliassime F.,12,268,163,105,2022-11-02,Paris,BNP Paribas Masters,Hard,4.5,1.2,0
De Minaur A.,19,272,161,111,Medvedev D.,3,406,289,117,2022-11-02,Paris,BNP Paribas Masters,Hard,4.5,1.2,1
Draper J.,55,51,29,22,Tiafoe F.,10,303,158,145,2022-11-02,Paris,BNP Paribas Masters,Hard,1.9,1.9,0
Evans D.,30,251,124,127,Tsitsipas S.,5,390,264,126,2022-11-02,Paris,BNP Paribas Masters,Hard,3.5,1.3,0
Basilashvili N.,118,301,138,163,Musetti L.,18,143,79,64,2022-11-02,Paris,BNP Paribas Masters,Hard,4.5,1.2,0
Nishioka Y.,31,215,99,116,Alcaraz C.,1,164,130,34,2022-11-02,Paris,BNP Paribas Masters,Hard,4.5,1.2,0
Paul T.,14,204,111,93,Carreno Busta P.,16,352,214,138,2022-11-03,Paris,BNP Paribas Masters,Hard,2.1,1.72,1
Ruud C.,4,275,176,99,Musetti L.,18,143,79,64,2022-11-03,Paris,BNP Paribas Masters,Hard,1.66,2.2,0
Tiafoe F.,10,303,158,145,De Minaur A.,19,272,161,111,2022-11-03,Paris,BNP Paribas Masters,Hard,2.1,1.72,1
Alcaraz C.,1,164,130,34,Dimitrov G.,20,651,389,262,2022-11-03,Paris,BNP Paribas Masters,Hard,1.3,3.5,1
Rublev A.,7,392,255,137,Rune H.,6,131,83,48,2022-11-03,Paris,BNP Paribas Masters,Hard,1.61,2.3,0
Auger-Aliassime F.,12,268,163,105,Simon G.,188,869,491,378,2022-11-03,Paris,BNP Paribas Masters,Hard,1.1,7.0,1
Khachanov K.,11,378,217,161,Djokovic N.,2,1207,1012,195,2022-11-03,Paris,BNP Paribas Masters,Hard,8.0,1.08,0
Tsitsipas S.,5,390,264,126,Moutet C.,80,118,50,68,2022-11-03,Paris,BNP Paribas Masters,Hard,1.16,5.0,1
Djokovic N.,2,1207,1012,195,Musetti L.,18,143,79,64,2022-11-04,Paris,BNP Paribas Masters,Hard,1.11,6.5,1
Tsitsipas S.,5,390,264,126,Paul T.,14,204,111,93,2022-11-04,Paris,BNP Paribas Masters,Hard,1.4,3.0,1
Tiafoe F.,10,303,158,145,Auger-Aliassime F.,12,268,163,105,2022-11-04,Paris,BNP Paribas Masters,Hard,2.75,1.44,0
Alcaraz C.,1,164,130,34,Rune H.,6,131,83,48,2022-11-04,Paris,BNP Paribas Masters,Hard,1.44,2.75,0
Djokovic N.,2,1207,1012,195,Tsitsipas S.,5,390,264,126,2022-11-05,Paris,BNP Paribas Masters,Hard,1.2,4.5,1
Auger-Aliassime F.,12,268,163,105,Rune H.,6,131,83,48,2022-11-05,Paris,BNP Paribas Masters,Hard,1.44,2.75,0
Rune H.,6,131,83,48,Djokovic N.,2,1207,1012,195,2022-11-06,Paris,BNP Paribas Masters,Hard,4.0,1.25,1
Ruud C.,4,275,176,99,Auger-Aliassime F.,12,268,163,105,2022-11-13,Turin,Masters Cup,Hard,3.2,1.36,1
Fritz T.,9,356,205,151,Nadal R.,2,1223,1017,206,2022-11-13,Turin,Masters Cup,Hard,2.37,1.57,1
Medvedev D.,3,406,289,117,Rublev A.,7,392,255,137,2022-11-14,Turin,Masters Cup,Hard,1.33,3.4,0
Tsitsipas S.,5,390,264,126,Djokovic N.,2,1207,1012,195,2022-11-14,Turin,Masters Cup,Hard,3.4,1.33,0
Auger-Aliassime F.,12,268,163,105,Nadal R.,2,1223,1017,206,2022-11-15,Turin,Masters Cup,Hard,1.61,2.3,1
Fritz T.,9,356,205,151,Ruud C.,4,275,176,99,2022-11-15,Turin,Masters Cup,Hard,1.8,2.0,0
Rublev A.,7,392,255,137,Djokovic N.,2,1207,1012,195,2022-11-16,Turin,Masters Cup,Hard,3.5,1.3,0
Medvedev D.,3,406,289,117,Tsitsipas S.,5,390,264,126,2022-11-16,Turin,Masters Cup,Hard,1.5,2.62,0
Ruud C.,4,275,176,99,Nadal R.,2,1223,1017,206,2022-11-17,Turin,Masters Cup,Hard,1.53,2.5,0
Auger-Aliassime F.,12,268,163,105,Fritz T.,9,356,205,151,2022-11-17,Turin,Masters Cup,Hard,1.53,2.5,0
Medvedev D.,3,406,289,117,Djokovic N.,2,1207,1012,195,2022-11-18,Turin,Masters Cup,Hard,3.4,1.33,0
Rublev A.,7,392,255,137,Tsitsipas S.,5,390,264,126,2022-11-18,Turin,Masters Cup,Hard,2.37,1.57,1
Djokovic N.,2,1207,1012,195,Fritz T.,9,356,205,151,2022-11-19,Turin,Masters Cup,Hard,1.22,4.33,1
Rublev A.,7,392,255,137,Ruud C.,4,275,176,99,2022-11-19,Turin,Masters Cup,Hard,1.66,2.2,0
Djokovic N.,2,1207,1012,195,Ruud C.,4,275,176,99,2022-11-20,Turin,Masters Cup,Hard,1.22,4.33,1
Galan D.E.,76,78,33,45,Mcdonald M.,60,190,87,103,2023-01-01,Adelaide,Adelaide International 1,Hard,3.2,1.36,0
Giron M.,69,150,68,82,Gasquet R.,48,948,581,367,2023-01-01,Adelaide,Adelaide International 1,Hard,1.91,1.91,1
Carballes Baena R.,64,207,91,116,Zapata Miralles B.,54,80,32,48,2023-01-02,Pune,Maharashtra Open,Hard,2.0,1.8,1
Mmoh M.,112,55,20,35,Dhamne M.,0,1,0,1,2023-01-02,Pune,Maharashtra Open,Hard,1.002,41.0,1
Munar J.,104,178,75,103,Griekspoor T.,37,97,47,50,2023-01-02,Pune,Maharashtra Open,Hard,2.0,1.8,0
Djere L.,38,243,120,123,Molcan A.,120,86,45,41,2023-01-02,Pune,Maharashtra Open,Hard,1.91,1.91,1
Cecchinato M.,108,204,79,125,Basilashvili N.,118,301,138,163,2023-01-02,Pune,Maharashtra Open,Hard,2.75,1.44,1
Nagal S.,503,17,3,14,Krajinovic F.,93,240,115,125,2023-01-02,Pune,Maharashtra Open,Hard,4.0,1.25,0
Tseng C.H.,145,9,1,8,Bonzi B.,107,83,37,46,2023-01-02,Pune,Maharashtra Open,Hard,3.0,1.4,0
Kwon S.W.,68,108,53,55,Draper J.,55,51,29,22,2023-01-02,Adelaide,Adelaide International 1,Hard,2.2,1.67,0
Ymer M.,59,130,58,72,Safiullin R.,92,42,20,22,2023-01-02,Adelaide,Adelaide International 1,Hard,1.67,2.2,0
Halys Q.,79,72,23,49,Thompson J.,71,221,96,125,2023-01-02,Adelaide,Adelaide International 1,Hard,2.1,1.73,1
Popyrin A.,90,140,59,81,Auger-Aliassime F.,12,268,163,105,2023-01-02,Adelaide,Adelaide International 1,Hard,6.5,1.11,1
Nishioka Y.,31,215,99,116,Rune H.,6,131,83,48,2023-01-02,Adelaide,Adelaide International 1,Hard,3.75,1.29,1
O Connell C.,74,65,26,39,Kecmanovic M.,40,210,107,103,2023-01-02,Adelaide,Adelaide International 1,Hard,2.38,1.57,0
Kokkinakis T.,86,124,55,69,Cressy M.,96,96,42,54,2023-01-02,Adelaide,Adelaide International 1,Hard,1.91,1.91,1
Karatsev A.,75,136,66,70,Andujar P.,323,404,164,240,2023-01-03,Pune,Maharashtra Open,Hard,1.3,3.5,1
Ymer E.,186,81,24,57,Marterer M.,144,91,31,60,2023-01-03,Pune,Maharashtra Open,Hard,1.73,2.1,0
Van Rijthoven T.,110,19,10,9,Albot R.,97,215,86,129,2023-01-03,Pune,Maharashtra Open,Hard,1.8,2.0,1
Martinez P.,135,118,50,68,Ramanathan R.,435,40,14,26,2023-01-03,Pune,Maharashtra Open,Hard,1.57,2.38,1
Hijikata R.,110,16,7,9,Shapovalov D.,29,298,166,132,2023-01-03,Adelaide,Adelaide International 1,Hard,4.0,1.25,0
Sonego L.,43,221,107,114,Medvedev D.,3,406,289,117,2023-01-03,Adelaide,Adelaide International 1,Hard,6.5,1.11,0
Cachin P.,54,52,23,29,Khachanov K.,11,378,217,161,2023-01-03,Adelaide,Adelaide International 1,Hard,5.0,1.17,0
Lestienne C.,109,40,13,27,Djokovic N.,2,1207,1012,195,2023-01-03,Adelaide,Adelaide International 1,Hard,17.0,1.03,0
Sinner J.,8,224,153,71,Edmund K.,473,233,113,120,2023-01-03,Adelaide,Adelaide International 1,Hard,1.13,6.0,1
Cobolli F.,148,14,5,9,Mukund S.,356,3,0,3,2023-01-03,Pune,Maharashtra Open,Hard,1.33,3.4,1
Rublev A.,7,392,255,137,Bautista Agut R.,25,379,234,145,2023-01-03,Adelaide,Adelaide International 1,Hard,1.4,3.0,0
Murray A.,44,932,687,245,Korda S.,26,126,75,51,2023-01-03,Adelaide,Adelaide International 1,Hard,2.38,1.57,0
Medvedev D.,3,406,289,117,Kecmanovic M.,40,210,107,103,2023-01-04,Adelaide,Adelaide International 1,Hard,1.14,5.5,1
Draper J.,55,51,29,22,Khachanov K.,11,378,217,161,2023-01-04,Adelaide,Adelaide International 1,Hard,1.62,2.3,0
Mcdonald M.,60,190,87,103,Nishioka Y.,31,215,99,116,2023-01-04,Adelaide,Adelaide International 1,Hard,2.3,1.62,0
Marterer M.,144,91,31,60,Djere L.,38,243,120,123,2023-01-04,Pune,Maharashtra Open,Hard,2.38,1.57,1
Karatsev A.,75,136,66,70,Van Rijthoven T.,110,19,10,9,2023-01-04,Pune,Maharashtra Open,Hard,1.57,2.38,1
Martinez P.,135,118,50,68,Baez S.,72,95,47,48,2023-01-04,Pune,Maharashtra Open,Hard,1.91,1.91,1
Griekspoor T.,37,97,47,50,Cecchinato M.,108,204,79,125,2023-01-04,Pune,Maharashtra Open,Hard,1.33,3.4,1
Van De Zandschulp B.,44,117,63,54,Cobolli F.,148,14,5,9,2023-01-04,Pune,Maharashtra Open,Hard,1.29,3.75,1
Bonzi B.,107,83,37,46,Ruusuvuori E.,55,158,79,79,2023-01-04,Pune,Maharashtra Open,Hard,2.3,1.62,1
Mmoh M.,112,55,20,35,Krajinovic F.,93,240,115,125,2023-01-04,Pune,Maharashtra Open,Hard,2.0,1.8,0
Carballes Baena R.,64,207,91,116,Cilic M.,100,853,543,310,2023-01-04,Pune,Maharashtra Open,Hard,4.33,1.22,0
Popyrin A.,90,140,59,81,Giron M.,69,150,68,82,2023-01-04,Adelaide,Adelaide International 1,Hard,1.73,2.1,1
Marterer M.,144,91,31,60,Van De Zandschulp B.,44,117,63,54,2023-01-05,Pune,Maharashtra Open,Hard,3.0,1.4,0
Krajinovic F.,93,240,115,125,Bonzi B.,107,83,37,46,2023-01-05,Pune,Maharashtra Open,Hard,2.63,1.5,0
Martinez P.,135,118,50,68,Karatsev A.,75,136,66,70,2023-01-05,Pune,Maharashtra Open,Hard,2.63,1.5,0
Cilic M.,100,853,543,310,Griekspoor T.,37,97,47,50,2023-01-05,Pune,Maharashtra Open,Hard,1.44,2.75,0
Sinner J.,8,224,153,71,Kokkinakis T.,86,124,55,69,2023-01-05,Adelaide,Adelaide International 1,Hard,1.25,4.0,1
Korda S.,26,126,75,51,Bautista Agut R.,25,379,234,145,2023-01-05,Adelaide,Adelaide International 1,Hard,1.8,2.0,1
Djokovic N.,2,1207,1012,195,Halys Q.,79,72,23,49,2023-01-05,Adelaide,Adelaide International 1,Hard,1.03,15.0,1
Safiullin R.,92,42,20,22,Shapovalov D.,29,298,166,132,2023-01-05,Adelaide,Adelaide International 1,Hard,3.0,1.4,0
Djokovic N.,2,1207,1012,195,Shapovalov D.,29,298,166,132,2023-01-06,Adelaide,Adelaide International 1,Hard,1.14,5.5,1
Medvedev D.,3,406,289,117,Khachanov K.,11,378,217,161,2023-01-06,Adelaide,Adelaide International 1,Hard,1.25,4.0,1
Korda S.,26,126,75,51,Sinner J.,8,224,153,71,2023-01-06,Adelaide,Adelaide International 1,Hard,2.5,1.53,1
Popyrin A.,90,140,59,81,Nishioka Y.,31,215,99,116,2023-01-06,Adelaide,Adelaide International 1,Hard,2.1,1.73,0
Karatsev A.,75,136,66,70,Griekspoor T.,37,97,47,50,2023-01-06,Pune,Maharashtra Open,Hard,1.5,2.63,0
Van De Zandschulp B.,44,117,63,54,Bonzi B.,107,83,37,46,2023-01-06,Pune,Maharashtra Open,Hard,1.62,2.3,0
Medvedev D.,3,406,289,117,Djokovic N.,2,1207,1012,195,2023-01-07,Adelaide,Adelaide International 1,Hard,2.5,1.53,0
Korda S.,26,126,75,51,Nishioka Y.,31,215,99,116,2023-01-07,Adelaide,Adelaide International 1,Hard,1.33,3.4,1
Bonzi B.,107,83,37,46,Griekspoor T.,37,97,47,50,2023-01-07,Pune,Maharashtra Open,Hard,1.62,2.3,0
Djokovic N.,2,1207,1012,195,Korda S.,26,126,75,51,2023-01-08,Adelaide,Adelaide International 1,Hard,1.14,5.5,1
Lestienne C.,109,40,13,27,Cachin P.,54,52,23,29,2023-01-08,Auckland,ASB Classic,Hard,1.62,2.3,1
Sonego L.,43,221,107,114,Draper J.,55,51,29,22,2023-01-09,Adelaide,Adelaide International 2,Hard,2.75,1.44,0
Pannu K.,717,2,0,2,Gasquet R.,48,948,581,367,2023-01-09,Auckland,ASB Classic,Hard,10.0,1.06,0
Wolf J.J.,45,75,39,36,Mannarino A.,27,567,264,303,2023-01-09,Auckland,ASB Classic,Hard,2.0,1.8,1
Isner J.,114,755,465,290,Barrere G.,59,79,31,48,2023-01-09,Auckland,ASB Classic,Hard,1.53,2.5,0
Giron M.,69,150,68,82,Coria F.,108,99,43,56,2023-01-09,Auckland,ASB Classic,Hard,1.14,5.5,1
Evans D.,30,251,124,127,Mcdonald M.,60,190,87,103,2023-01-09,Adelaide,Adelaide International 2,Hard,1.53,2.5,0
Fognini F.,128,742,383,359,Brooksby J.,39,79,46,33,2023-01-09,Auckland,ASB Classic,Hard,3.0,1.4,0
Bublik A.,25,219,110,109,Goffin D.,123,522,296,226,2023-01-09,Auckland,ASB Classic,Hard,1.73,2.1,0
Kokkinakis T.,86,124,55,69,Popyrin A.,90,140,59,81,2023-01-09,Adelaide,Adelaide International 2,Hard,1.73,2.1,1
Davidovich Fokina A.,39,168,84,84,Nakashima B.,70,106,57,49,2023-01-09,Adelaide,Adelaide International 2,Hard,2.75,1.44,1
Kecmanovic M.,40,210,107,103,Edmund K.,473,233,113,120,2023-01-09,Adelaide,Adelaide International 2,Hard,1.17,5.0,1
Djere L.,38,243,120,123,Munar J.,104,178,75,103,2023-01-10,Auckland,ASB Classic,Hard,1.73,2.1,1
Molcan A.,120,86,45,41,Halys Q.,79,72,23,49,2023-01-10,Auckland,ASB Classic,Hard,3.2,1.36,0
Wolf J.J.,45,75,39,36,Giron M.,69,150,68,82,2023-01-10,Auckland,ASB Classic,Hard,1.67,2.2,0
Brooksby J.,39,79,46,33,Schwartzman D.,95,428,233,195,2023-01-10,Auckland,ASB Classic,Hard,1.53,2.5,1
Shelton B.,43,34,13,21,Baez S.,72,95,47,48,2023-01-10,Auckland,ASB Classic,Hard,1.4,3.0,1
Monteiro T.,121,171,69,102,Lehecka J.,33,61,30,31,2023-01-10,Auckland,ASB Classic,Hard,2.38,1.57,0
Humbert U.,36,170,80,90,Eubanks C.,29,64,28,36,2023-01-10,Auckland,ASB Classic,Hard,1.73,2.1,0
Paul T.,14,204,111,93,O Connell C.,74,65,26,39,2023-01-10,Adelaide,Adelaide International 2,Hard,1.44,2.75,1
Millman J.,140,256,113,143,Ramos-Vinolas A.,82,437,204,233,2023-01-10,Adelaide,Adelaide International 2,Hard,1.57,2.38,1
Haase R.,257,458,202,256,Bonzi B.,107,83,37,46,2023-01-10,Adelaide,Adelaide International 2,Hard,,,1
Huesler M.A.,88,58,21,37,Rinderknech A.,67,96,46,50,2023-01-10,Adelaide,Adelaide International 2,Hard,2.3,1.62,1
Machac T.,108,18,6,12,Kwon S.W.,68,108,53,55,2023-01-10,Adelaide,Adelaide International 2,Hard,2.0,1.8,0
Ymer M.,59,130,58,72,Ruusuvuori E.,55,158,79,79,2023-01-10,Adelaide,Adelaide International 2,Hard,1.8,2.0,1
Etcheverry T.,34,60,26,34,Kubler J.,77,53,24,29,2023-01-10,Adelaide,Adelaide International 2,Hard,2.75,1.44,0
Rublev A.,7,392,255,137,Kokkinakis T.,86,124,55,69,2023-01-11,Adelaide,Adelaide International 2,Hard,1.33,3.4,0
Ruud C.,4,275,176,99,Djere L.,38,243,120,123,2023-01-11,Auckland,ASB Classic,Hard,1.17,5.0,0
Lestienne C.,109,40,13,27,Barrere G.,59,79,31,48,2023-01-11,Auckland,ASB Classic,Hard,1.91,1.91,1
Eubanks C.,29,64,28,36,Goffin D.,123,522,296,226,2023-01-11,Auckland,ASB Classic,Hard,2.38,1.57,0
Kecmanovic M.,40,210,107,103,Kubler J.,77,53,24,29,2023-01-11,Adelaide,Adelaide International 2,Hard,1.53,2.5,1
Gasquet R.,48,948,581,367,Sousa J.,147,436,189,247,2023-01-11,Auckland,ASB Classic,Hard,1.36,3.2,1
Norrie C.,13,287,172,115,Lehecka J.,33,61,30,31,2023-01-11,Auckland,ASB Classic,Hard,1.25,4.0,1
Shelton B.,43,34,13,21,Halys Q.,79,72,23,49,2023-01-11,Auckland,ASB Classic,Hard,2.0,1.8,0
Draper J.,55,51,29,22,Paul T.,14,204,111,93,2023-01-11,Adelaide,Adelaide International 2,Hard,1.8,2.0,1
Khachanov K.,11,378,217,161,Huesler M.A.,88,58,21,37,2023-01-11,Adelaide,Adelaide International 2,Hard,1.33,3.4,1
Ymer M.,59,130,58,72,Mcdonald M.,60,190,87,103,2023-01-11,Adelaide,Adelaide International 2,Hard,1.73,2.1,1
Kwon S.W.,68,108,53,55,Carreno Busta P.,16,352,214,138,2023-01-11,Adelaide,Adelaide International 2,Hard,2.63,1.5,1
Bautista Agut R.,25,379,234,145,Haase R.,257,458,202,256,2023-01-11,Adelaide,Adelaide International 2,Hard,1.11,6.5,1
Davidovich Fokina A.,39,168,84,84,Millman J.,140,256,113,143,2023-01-11,Adelaide,Adelaide International 2,Hard,1.4,3.0,1
Lestienne C.,109,40,13,27,Djere L.,38,243,120,123,2023-01-12,Auckland,ASB Classic,Hard,2.2,1.67,1
Goffin D.,123,522,296,226,Gasquet R.,48,948,581,367,2023-01-12,Auckland,ASB Classic,Hard,1.62,2.3,0
Kecmanovic M.,40,210,107,103,Kokkinakis T.,86,124,55,69,2023-01-12,Adelaide,Adelaide International 2,Hard,2.3,1.62,0
Bautista Agut R.,25,379,234,145,Davidovich Fokina A.,39,168,84,84,2023-01-12,Adelaide,Adelaide International 2,Hard,1.62,2.3,1
Kwon S.W.,68,108,53,55,Ymer M.,59,130,58,72,2023-01-12,Adelaide,Adelaide International 2,Hard,2.2,1.67,1
Khachanov K.,11,378,217,161,Draper J.,55,51,29,22,2023-01-12,Adelaide,Adelaide International 2,Hard,1.8,2.0,0
Giron M.,69,150,68,82,Norrie C.,13,287,172,115,2023-01-12,Auckland,ASB Classic,Hard,3.75,1.29,0
Brooksby J.,39,79,46,33,Halys Q.,79,72,23,49,2023-01-12,Auckland,ASB Classic,Hard,1.91,1.91,1
Gasquet R.,48,948,581,367,Lestienne C.,109,40,13,27,2023-01-13,Auckland,ASB Classic,Hard,1.5,2.63,1
Norrie C.,13,287,172,115,Brooksby J.,39,79,46,33,2023-01-13,Auckland,ASB Classic,Hard,1.36,3.2,1
Bautista Agut R.,25,379,234,145,Kokkinakis T.,86,124,55,69,2023-01-13,Adelaide,Adelaide International 2,Hard,1.8,2.0,1
Draper J.,55,51,29,22,Kwon S.W.,68,108,53,55,2023-01-13,Adelaide,Adelaide International 2,Hard,1.36,3.2,0
Bautista Agut R.,25,379,234,145,Kwon S.W.,68,108,53,55,2023-01-14,Adelaide,Adelaide International 2,Hard,1.44,2.75,0
Gasquet R.,48,948,581,367,Norrie C.,13,287,172,115,2023-01-14,Auckland,ASB Classic,Hard,3.75,1.29,1
Coric B.,15,343,185,158,Lehecka J.,33,61,30,31,2023-01-16,Melbourne,Australian Open,Hard,1.36,3.2,0
Kubler J.,77,53,24,29,Baez S.,72,95,47,48,2023-01-16,Melbourne,Australian Open,Hard,1.33,3.4,1
Svrcina D.,216,2,1,1,Munar J.,104,178,75,103,2023-01-16,Melbourne,Australian Open,Hard,2.75,1.44,1
Millman J.,140,256,113,143,Huesler M.A.,88,58,21,37,2023-01-16,Melbourne,Australian Open,Hard,2.2,1.67,1
Eubanks C.,29,64,28,36,Kwon S.W.,68,108,53,55,2023-01-16,Melbourne,Australian Open,Hard,2.38,1.57,1
Fucsovics M.,67,249,121,128,Coria F.,108,99,43,56,2023-01-16,Melbourne,Australian Open,Hard,1.14,5.5,1
Hanfmann Y.,50,99,50,49,Hijikata R.,110,16,7,9,2023-01-16,Melbourne,Australian Open,Hard,1.8,2.0,0
Van Assche L.,68,20,7,13,Norrie C.,13,287,172,115,2023-01-16,Melbourne,Australian Open,Hard,10.0,1.06,0
Giron M.,69,150,68,82,Medvedev D.,3,406,289,117,2023-01-16,Melbourne,Australian Open,Hard,17.0,1.03,0
Halys Q.,79,72,23,49,Tsitsipas S.,5,390,264,126,2023-01-16,Melbourne,Australian Open,Hard,5.5,1.14,0
Monteiro T.,121,171,69,102,Lestienne C.,109,40,13,27,2023-01-16,Melbourne,Australian Open,Hard,1.73,2.1,0
Harris L.,186,129,59,70,Musetti L.,18,143,79,64,2023-01-16,Melbourne,Australian Open,Hard,3.4,1.33,1
Borges N.,69,28,10,18,Sonego L.,43,221,107,114,2023-01-16,Melbourne,Australian Open,Hard,3.5,1.3,0
Molcan A.,120,86,45,41,Wawrinka S.,72,854,535,319,2023-01-16,Melbourne,Australian Open,Hard,3.75,1.29,1
Escobedo E.,377,57,20,37,Daniel T.,111,178,67,111,2023-01-16,Melbourne,Australian Open,Hard,2.38,1.57,0
Pospisil V.,99,280,122,158,Auger-Aliassime F.,12,268,163,105,2023-01-16,Melbourne,Australian Open,Hard,9.0,1.07,0
Altmaier D.,51,79,28,51,Tiafoe F.,10,303,158,145,2023-01-16,Melbourne,Australian Open,Hard,7.0,1.1,0
Nadal R.,2,1223,1017,206,Draper J.,55,51,29,22,2023-01-16,Melbourne,Australian Open,Hard,1.36,3.2,1
Moutet C.,80,118,50,68,Wu Y.,90,36,15,21,2023-01-16,Melbourne,Australian Open,Hard,2.38,1.57,1
Van De Zandschulp B.,44,117,63,54,Ivashka I.,113,159,78,81,2023-01-16,Melbourne,Australian Open,Hard,1.36,3.2,1
Etcheverry T.,34,60,26,34,Barrere G.,59,79,31,48,2023-01-16,Melbourne,Australian Open,Hard,2.3,1.62,1
Sinner J.,8,224,153,71,Edmund K.,473,233,113,120,2023-01-16,Melbourne,Australian Open,Hard,1.06,10.0,1
Cerundolo F.,21,104,58,46,Pella G.,199,260,118,142,2023-01-16,Melbourne,Australian Open,Hard,1.13,6.0,1
Shang J.,149,12,4,8,Otte O.,233,78,33,45,2023-01-16,Melbourne,Australian Open,Hard,2.75,1.44,1
Watanuki Y.,99,25,11,14,Rinderknech A.,67,96,46,50,2023-01-16,Melbourne,Australian Open,Hard,2.3,1.62,1
Garin C.,101,190,103,87,Korda S.,26,126,75,51,2023-01-16,Melbourne,Australian Open,Hard,8.0,1.08,0
Nishioka Y.,31,215,99,116,Ymer M.,59,130,58,72,2023-01-16,Melbourne,Australian Open,Hard,1.91,1.91,1
Shapovalov D.,29,298,166,132,Lajovic D.,66,378,163,215,2023-01-16,Melbourne,Australian Open,Hard,1.08,8.0,1
Kotov P.,89,25,10,15,Griekspoor T.,37,97,47,50,2023-01-16,Melbourne,Australian Open,Hard,3.2,1.36,0
Mcdonald M.,60,190,87,103,Nakashima B.,70,106,57,49,2023-01-16,Melbourne,Australian Open,Hard,2.5,1.53,1
Khachanov K.,11,378,217,161,Zapata Miralles B.,54,80,32,48,2023-01-16,Melbourne,Australian Open,Hard,1.07,9.0,1
Martinez P.,135,118,50,68,Hurkacz H.,17,238,137,101,2023-01-16,Melbourne,Australian Open,Hard,10.0,1.06,0
Zhang Zh.,53,44,20,24,Shelton B.,43,34,13,21,2023-01-17,Melbourne,Australian Open,Hard,3.0,1.4,0
Murray A.,44,932,687,245,Berrettini M.,38,217,142,75,2023-01-17,Melbourne,Australian Open,Hard,4.0,1.25,1
Zverev A.,19,500,346,154,Varillas J. P.,1345,20,9,11,2023-01-17,Melbourne,Australian Open,Hard,1.06,10.0,1
Paul T.,14,204,111,93,Struff J.L.,21,369,170,199,2023-01-17,Melbourne,Australian Open,Hard,1.4,3.0,1
Machac T.,108,18,6,12,Ruud C.,4,275,176,99,2023-01-17,Melbourne,Australian Open,Hard,5.0,1.17,0
De Minaur A.,19,272,161,111,Hsu Y.,209,1,0,1,2023-01-17,Melbourne,Australian Open,Hard,1.04,13.0,1
Tseng C. H.,108,8,2,6,Popyrin A.,90,140,59,81,2023-01-17,Melbourne,Australian Open,Hard,5.0,1.17,0
Djokovic N.,2,1207,1012,195,Carballes Baena R.,64,207,91,116,2023-01-17,Melbourne,Australian Open,Hard,1.01,29.0,1
Krajinovic F.,93,240,115,125,Rune H.,6,131,83,48,2023-01-17,Melbourne,Australian Open,Hard,5.5,1.14,0
O Connell C.,74,65,26,39,Brooksby J.,39,79,46,33,2023-01-17,Melbourne,Australian Open,Hard,2.75,1.44,0
Basilashvili N.,118,301,138,163,Fritz T.,9,356,205,151,2023-01-17,Melbourne,Australian Open,Hard,17.0,1.03,0
Bublik A.,25,219,110,109,Davidovich Fokina A.,39,168,84,84,2023-01-17,Melbourne,Australian Open,Hard,2.1,1.73,0
Cachin P.,54,52,23,29,Carreno Busta P.,16,352,214,138,2023-01-17,Melbourne,Australian Open,Hard,8.0,1.08,0
Jarry N.,28,141,73,68,Kecmanovic M.,40,210,107,103,2023-01-17,Melbourne,Australian Open,Hard,3.5,1.3,1
Krutykh O.,180,3,0,3,Schwartzman D.,95,428,233,195,2023-01-17,Melbourne,Australian Open,Hard,2.63,1.5,0
Bergs Z.,175,15,4,11,Djere L.,38,243,120,123,2023-01-17,Melbourne,Australian Open,Hard,2.75,1.44,0
Dimitrov G.,20,651,389,262,Karatsev A.,75,136,66,70,2023-01-17,Melbourne,Australian Open,Hard,1.4,3.0,1
Bellucci M.,152,1,0,1,Bonzi B.,107,83,37,46,2023-01-17,Melbourne,Australian Open,Hard,3.0,1.4,0
Bagnis F.,135,121,39,82,Evans D.,30,251,124,127,2023-01-17,Melbourne,Australian Open,Hard,6.5,1.11,0
Chardy J.,542,591,289,302,Galan D.E.,76,78,33,45,2023-01-17,Melbourne,Australian Open,Hard,3.2,1.36,1
Rublev A.,7,392,255,137,Thiem D.,116,517,327,190,2023-01-17,Melbourne,Australian Open,Hard,1.25,4.0,1
Wolf J.J.,45,75,39,36,Thompson J.,71,221,96,125,2023-01-17,Melbourne,Australian Open,Hard,1.57,2.38,1
Millman J.,140,256,113,143,Medvedev D.,3,406,289,117,2023-01-18,Melbourne,Australian Open,Hard,19.0,1.02,0
Nishioka Y.,31,215,99,116,Svrcina D.,216,2,1,1,2023-01-18,Melbourne,Australian Open,Hard,1.25,4.0,1
Cerundolo F.,21,104,58,46,Moutet C.,80,118,50,68,2023-01-18,Melbourne,Australian Open,Hard,1.91,1.91,1
Daniel T.,111,178,67,111,Shapovalov D.,29,298,166,132,2023-01-18,Melbourne,Australian Open,Hard,5.0,1.17,0
Hurkacz H.,17,238,137,101,Sonego L.,43,221,107,114,2023-01-18,Melbourne,Australian Open,Hard,1.25,4.0,1
Lestienne C.,109,40,13,27,Norrie C.,13,287,172,115,2023-01-18,Melbourne,Australian Open,Hard,7.0,1.1,0
Korda S.,26,126,75,51,Watanuki Y.,99,25,11,14,2023-01-18,Melbourne,Australian Open,Hard,1.22,4.33,1
Griekspoor T.,37,97,47,50,Van De Zandschulp B.,44,117,63,54,2023-01-18,Melbourne,Australian Open,Hard,2.1,1.73,1
Lehecka J.,33,61,30,31,Eubanks C.,29,64,28,36,2023-01-18,Melbourne,Australian Open,Hard,1.44,2.75,1
Khachanov K.,11,378,217,161,Kubler J.,77,53,24,29,2023-01-18,Melbourne,Australian Open,Hard,1.29,3.75,1
Tsitsipas S.,5,390,264,126,Hijikata R.,110,16,7,9,2023-01-18,Melbourne,Australian Open,Hard,1.05,11.0,1
Shang J.,149,12,4,8,Tiafoe F.,10,303,158,145,2023-01-18,Melbourne,Australian Open,Hard,5.5,1.14,0
Fucsovics M.,67,249,121,128,Harris L.,186,129,59,70,2023-01-18,Melbourne,Australian Open,Hard,1.8,2.0,1
Molcan A.,120,86,45,41,Auger-Aliassime F.,12,268,163,105,2023-01-18,Melbourne,Australian Open,Hard,11.0,1.05,0
Mcdonald M.,60,190,87,103,Nadal R.,2,1223,1017,206,2023-01-18,Melbourne,Australian Open,Hard,9.0,1.07,1
Ruusuvuori E.,55,158,79,79,Purcell M.,78,28,9,19,2023-01-18,Melbourne,Australian Open,Hard,1.36,3.2,1
Gasquet R.,48,948,581,367,Humbert U.,36,170,80,90,2023-01-18,Melbourne,Australian Open,Hard,1.73,2.1,0
Kudla D.,137,198,70,128,Safiullin R.,92,42,20,22,2023-01-18,Melbourne,Australian Open,Hard,3.2,1.36,1
Isner J.,114,755,465,290,Mannarino A.,27,567,264,303,2023-01-18,Melbourne,Australian Open,Hard,1.8,2.0,0
Vukic A.,62,36,15,21,Holt B.,193,7,2,5,2023-01-18,Melbourne,Australian Open,Hard,1.57,2.38,0
Mmoh M.,112,55,20,35,Lokoli L.,199,8,0,8,2023-01-18,Melbourne,Australian Open,Hard,1.53,2.5,1
Dellien H.,164,70,22,48,Couacaud E.,158,9,2,7,2023-01-18,Melbourne,Australian Open,Hard,6.5,1.11,0
Cressy M.,96,96,42,54,Ramos-Vinolas A.,82,437,204,233,2023-01-18,Melbourne,Australian Open,Hard,1.36,3.2,1
Kokkinakis T.,86,124,55,69,Fognini F.,128,742,383,359,2023-01-18,Melbourne,Australian Open,Hard,1.17,5.0,1
Etcheverry T.,34,60,26,34,Sinner J.,8,224,153,71,2023-01-18,Melbourne,Australian Open,Hard,11.0,1.05,0
Bautista Agut R.,25,379,234,145,Sousa J.,147,436,189,247,2023-01-18,Melbourne,Australian Open,Hard,1.08,8.0,1
Dimitrov G.,20,651,389,262,Djere L.,38,243,120,123,2023-01-19,Melbourne,Australian Open,Hard,1.29,3.75,1
Kokkinakis T.,86,124,55,69,Murray A.,44,932,687,245,2023-01-19,Melbourne,Australian Open,Hard,1.57,2.38,0
De Minaur A.,19,272,161,111,Mannarino A.,27,567,264,303,2023-01-19,Melbourne,Australian Open,Hard,1.17,5.0,1
Bonzi B.,107,83,37,46,Carreno Busta P.,16,352,214,138,2023-01-19,Melbourne,Australian Open,Hard,3.2,1.36,1
Bautista Agut R.,25,379,234,145,Holt B.,193,7,2,5,2023-01-19,Melbourne,Australian Open,Hard,1.1,7.0,1
Cressy M.,96,96,42,54,Rune H.,6,131,83,48,2023-01-19,Melbourne,Australian Open,Hard,5.0,1.17,0
Mmoh M.,112,55,20,35,Zverev A.,19,500,346,154,2023-01-19,Melbourne,Australian Open,Hard,4.5,1.2,1
Djokovic N.,2,1207,1012,195,Couacaud E.,158,9,2,7,2023-01-19,Melbourne,Australian Open,Hard,1.01,29.0,1
Popyrin A.,90,140,59,81,Fritz T.,9,356,205,151,2023-01-19,Melbourne,Australian Open,Hard,6.5,1.11,1
Schwartzman D.,95,428,233,195,Wolf J.J.,45,75,39,36,2023-01-19,Melbourne,Australian Open,Hard,2.5,1.53,0
Shelton B.,43,34,13,21,Jarry N.,28,141,73,68,2023-01-19,Melbourne,Australian Open,Hard,1.8,2.0,1
Ruusuvuori E.,55,158,79,79,Rublev A.,7,392,255,137,2023-01-19,Melbourne,Australian Open,Hard,4.33,1.22,0
Brooksby J.,39,79,46,33,Ruud C.,4,275,176,99,2023-01-19,Melbourne,Australian Open,Hard,3.4,1.33,1
Paul T.,14,204,111,93,Davidovich Fokina A.,39,168,84,84,2023-01-19,Melbourne,Australian Open,Hard,1.5,2.63,1
Chardy J.,542,591,289,302,Evans D.,30,251,124,127,2023-01-19,Melbourne,Australian Open,Hard,6.0,1.13,0
Humbert U.,36,170,80,90,Kudla D.,137,198,70,128,2023-01-19,Melbourne,Australian Open,Hard,1.44,2.75,1
Medvedev D.,3,406,289,117,Korda S.,26,126,75,51,2023-01-20,Melbourne,Australian Open,Hard,1.2,4.5,0
Khachanov K.,11,378,217,161,Tiafoe F.,10,303,158,145,2023-01-20,Melbourne,Australian Open,Hard,2.0,1.8,1
Hurkacz H.,17,238,137,101,Shapovalov D.,29,298,166,132,2023-01-20,Melbourne,Australian Open,Hard,1.91,1.91,1
Lehecka J.,33,61,30,31,Norrie C.,13,287,172,115,2023-01-20,Melbourne,Australian Open,Hard,3.4,1.33,1
Griekspoor T.,37,97,47,50,Tsitsipas S.,5,390,264,126,2023-01-20,Melbourne,Australian Open,Hard,7.0,1.1,0
Nishioka Y.,31,215,99,116,Mcdonald M.,60,190,87,103,2023-01-20,Melbourne,Australian Open,Hard,1.57,2.38,1
Fucsovics M.,67,249,121,128,Sinner J.,8,224,153,71,2023-01-20,Melbourne,Australian Open,Hard,7.0,1.1,0
Cerundolo F.,21,104,58,46,Auger-Aliassime F.,12,268,163,105,2023-01-20,Melbourne,Australian Open,Hard,6.5,1.11,0
Popyrin A.,90,140,59,81,Shelton B.,43,34,13,21,2023-01-21,Melbourne,Australian Open,Hard,1.62,2.3,0
Djokovic N.,2,1207,1012,195,Dimitrov G.,20,651,389,262,2023-01-21,Melbourne,Australian Open,Hard,1.2,4.5,1
Bautista Agut R.,25,379,234,145,Murray A.,44,932,687,245,2023-01-21,Melbourne,Australian Open,Hard,1.33,3.4,1
Wolf J.J.,45,75,39,36,Mmoh M.,112,55,20,35,2023-01-21,Melbourne,Australian Open,Hard,1.33,3.4,1
Rublev A.,7,392,255,137,Evans D.,30,251,124,127,2023-01-21,Melbourne,Australian Open,Hard,1.3,3.5,1
De Minaur A.,19,272,161,111,Bonzi B.,107,83,37,46,2023-01-21,Melbourne,Australian Open,Hard,1.22,4.33,1
Humbert U.,36,170,80,90,Rune H.,6,131,83,48,2023-01-21,Melbourne,Australian Open,Hard,5.0,1.17,0
Brooksby J.,39,79,46,33,Paul T.,14,204,111,93,2023-01-21,Melbourne,Australian Open,Hard,2.2,1.67,0
Korda S.,26,126,75,51,Hurkacz H.,17,238,137,101,2023-01-22,Melbourne,Australian Open,Hard,1.53,2.5,1
Nishioka Y.,31,215,99,116,Khachanov K.,11,378,217,161,2023-01-22,Melbourne,Australian Open,Hard,3.0,1.4,0
Lehecka J.,33,61,30,31,Auger-Aliassime F.,12,268,163,105,2023-01-22,Melbourne,Australian Open,Hard,4.5,1.2,1
Sinner J.,8,224,153,71,Tsitsipas S.,5,390,264,126,2023-01-22,Melbourne,Australian Open,Hard,2.75,1.44,0
Shelton B.,43,34,13,21,Wolf J.J.,45,75,39,36,2023-01-23,Melbourne,Australian Open,Hard,1.91,1.91,1
Rune H.,6,131,83,48,Rublev A.,7,392,255,137,2023-01-23,Melbourne,Australian Open,Hard,1.73,2.1,0
Bautista Agut R.,25,379,234,145,Paul T.,14,204,111,93,2023-01-23,Melbourne,Australian Open,Hard,2.1,1.73,0
De Minaur A.,19,272,161,111,Djokovic N.,2,1207,1012,195,2023-01-23,Melbourne,Australian Open,Hard,4.5,1.2,0
Korda S.,26,126,75,51,Khachanov K.,11,378,217,161,2023-01-24,Melbourne,Australian Open,Hard,1.8,2.0,0
Tsitsipas S.,5,390,264,126,Lehecka J.,33,61,30,31,2023-01-24,Melbourne,Australian Open,Hard,1.14,5.5,1
Rublev A.,7,392,255,137,Djokovic N.,2,1207,1012,195,2023-01-25,Melbourne,Australian Open,Hard,6.5,1.11,0
Shelton B.,43,34,13,21,Paul T.,14,204,111,93,2023-01-25,Melbourne,Australian Open,Hard,3.4,1.33,0
Khachanov K.,11,378,217,161,Tsitsipas S.,5,390,264,126,2023-01-27,Melbourne,Australian Open,Hard,3.5,1.3,0
Djokovic N.,2,1207,1012,195,Paul T.,14,204,111,93,2023-01-27,Melbourne,Australian Open,Hard,1.05,11.0,1
Djokovic N.,2,1207,1012,195,Tsitsipas S.,5,390,264,126,2023-01-29,Melbourne,Australian Open,Hard,1.2,4.8,1
Gasquet R.,48,948,581,367,Fils A.,71,24,15,9,2023-02-06,Montpellier,Open Sud de France,Hard,1.5,2.63,0
Basilashvili N.,118,301,138,163,Lestienne C.,109,40,13,27,2023-02-06,Montpellier,Open Sud de France,Hard,3.0,1.4,1
Zapata Miralles B.,54,80,32,48,Carballes Baena R.,64,207,91,116,2023-02-06,Cordoba,Cordoba Open,Clay,2.63,1.5,1
Varillas J. P.,1345,20,9,11,Lajovic D.,66,378,163,215,2023-02-06,Cordoba,Cordoba Open,Clay,1.67,2.2,0
Krajinovic F.,93,240,115,125,Karatsev A.,75,136,66,70,2023-02-07,Montpellier,Open Sud de France,Hard,1.8,2.0,1
Halys Q.,79,72,23,49,Chidekh C.,434,1,0,1,2023-02-07,Montpellier,Open Sud de France,Hard,1.33,3.4,1
Cressy M.,96,96,42,54,Bellier A.,190,9,4,5,2023-02-07,Montpellier,Open Sud de France,Hard,1.22,4.33,1
Wolf J.J.,45,75,39,36,Holt B.,193,7,2,5,2023-02-07,Dallas,Dallas Open,Hard,1.33,3.4,1
Huesler M.A.,88,58,21,37,Van Assche L.,68,20,7,13,2023-02-07,Montpellier,Open Sud de France,Hard,1.44,2.75,1
Sonego L.,43,221,107,114,Bonzi B.,107,83,37,46,2023-02-07,Montpellier,Open Sud de France,Hard,2.0,1.8,1
Rinderknech A.,67,96,46,50,Nardi L.,151,11,2,9,2023-02-07,Montpellier,Open Sud de France,Hard,1.57,2.38,1
Verdasco F.,244,962,537,425,Mcdonald M.,60,190,87,103,2023-02-07,Dallas,Dallas Open,Hard,4.0,1.25,0
Kudla D.,137,198,70,128,Thompson J.,71,221,96,125,2023-02-07,Dallas,Dallas Open,Hard,2.1,1.73,0
Mannarino A.,27,567,264,303,Johnson S.,197,395,196,199,2023-02-07,Dallas,Dallas Open,Hard,1.57,2.38,1
Blancaneaux G.,152,6,0,6,Fucsovics M.,67,249,121,128,2023-02-07,Montpellier,Open Sud de France,Hard,3.75,1.29,0
Giron M.,69,150,68,82,Rybakov A.,378,1,0,1,2023-02-07,Dallas,Dallas Open,Hard,1.14,5.5,1
Sock J.,166,324,177,147,Ivashka I.,113,159,78,81,2023-02-07,Dallas,Dallas Open,Hard,3.0,1.4,1
Tabilo A.,122,44,21,23,Delbonis F.,131,340,152,188,2023-02-07,Cordoba,Cordoba Open,Clay,1.8,2.0,0
Garin C.,101,190,103,87,Martinez P.,135,118,50,68,2023-02-07,Cordoba,Cordoba Open,Clay,1.8,2.0,1
Barrios M.,121,10,3,7,Galan D.E.,76,78,33,45,2023-02-07,Cordoba,Cordoba Open,Clay,1.8,2.0,1
Monteiro T.,121,171,69,102,Coria F.,108,99,43,56,2023-02-07,Cordoba,Cordoba Open,Clay,2.3,1.62,0
Darderi L.,184,3,1,2,Gaston H.,109,58,24,34,2023-02-07,Cordoba,Cordoba Open,Clay,1.73,2.1,1
Cerundolo J.M.,106,29,12,17,Andujar P.,323,404,164,240,2023-02-07,Cordoba,Cordoba Open,Clay,1.2,4.5,1
Tseng C. H.,108,8,2,6,Isner J.,114,755,465,290,2023-02-08,Dallas,Dallas Open,Hard,4.0,1.25,0
Svajda Z.,233,8,2,6,Altmaier D.,51,79,28,51,2023-02-08,Dallas,Dallas Open,Hard,1.91,1.91,0
Otte O.,233,78,33,45,Eubanks C.,29,64,28,36,2023-02-08,Dallas,Dallas Open,Hard,2.3,1.62,1
Albot R.,97,215,86,129,Wolf J.J.,45,75,39,36,2023-02-08,Dallas,Dallas Open,Hard,5.5,1.14,0
Wu Y.,90,36,15,21,Mmoh M.,112,55,20,35,2023-02-08,Dallas,Dallas Open,Hard,1.67,2.2,1
Diallo G.,140,3,0,3,Gomez E.,155,26,7,19,2023-02-08,Dallas,Dallas Open,Hard,2.1,1.73,0
Krall L.,0,1,0,1,Albot R.,97,215,86,129,2023-02-08,Dallas,Dallas Open,Hard,11.0,1.05,0
Humbert U.,36,170,80,90,Davidovich Fokina A.,39,168,84,84,2023-02-08,Montpellier,Open Sud de France,Hard,1.67,2.2,0
Barrere G.,59,79,31,48,Bublik A.,25,219,110,109,2023-02-08,Montpellier,Open Sud de France,Hard,1.8,2.0,1
Fucsovics M.,67,249,121,128,Sinner J.,8,224,153,71,2023-02-08,Montpellier,Open Sud de France,Hard,5.5,1.14,0
Fils A.,71,24,15,9,Bautista Agut R.,25,379,234,145,2023-02-08,Montpellier,Open Sud de France,Hard,3.75,1.29,1
Barrios M.,121,10,3,7,Zapata Miralles B.,54,80,32,48,2023-02-08,Cordoba,Cordoba Open,Clay,2.38,1.57,1
Dellien H.,164,70,22,48,Cachin P.,54,52,23,29,2023-02-08,Cordoba,Cordoba Open,Clay,1.62,2.3,1
Cecchinato M.,108,204,79,125,Bagnis F.,135,121,39,82,2023-02-08,Cordoba,Cordoba Open,Clay,2.1,1.73,1
Etcheverry T.,34,60,26,34,Sousa J.,147,436,189,247,2023-02-08,Cordoba,Cordoba Open,Clay,1.29,3.75,0
Pella G.,199,260,118,142,Vavassori A.,128,12,5,7,2023-02-08,Cordoba,Cordoba Open,Clay,2.5,1.53,1
Ruusuvuori E.,55,158,79,79,Ymer M.,59,130,58,72,2023-02-08,Montpellier,Open Sud de France,Hard,2.0,1.8,1
Cressy M.,96,96,42,54,Ruusuvuori E.,55,158,79,79,2023-02-09,Montpellier,Open Sud de France,Hard,2.75,1.44,1
Halys Q.,79,72,23,49,Davidovich Fokina A.,39,168,84,84,2023-02-09,Montpellier,Open Sud de France,Hard,2.1,1.73,1
Rune H.,6,131,83,48,Huesler M.A.,88,58,21,37,2023-02-09,Montpellier,Open Sud de France,Hard,1.3,3.5,1
Barrere G.,59,79,31,48,Basilashvili N.,118,301,138,163,2023-02-09,Montpellier,Open Sud de France,Hard,1.53,2.5,1
Shapovalov D.,29,298,166,132,Wu Y.,90,36,15,21,2023-02-09,Dallas,Dallas Open,Hard,1.36,3.2,0
Coric B.,15,343,185,158,Rinderknech A.,67,96,46,50,2023-02-09,Montpellier,Open Sud de France,Hard,1.4,3.0,1
Baez S.,72,95,47,48,Darderi L.,184,3,1,2,2023-02-09,Cordoba,Cordoba Open,Clay,1.44,2.75,1
Garin C.,101,190,103,87,Sousa J.,147,436,189,247,2023-02-09,Cordoba,Cordoba Open,Clay,1.25,4.0,0
Cecchinato M.,108,204,79,125,Coria F.,108,99,43,56,2023-02-09,Cordoba,Cordoba Open,Clay,2.38,1.57,0
Dellien H.,164,70,22,48,Pella G.,199,260,118,142,2023-02-09,Cordoba,Cordoba Open,Clay,1.44,2.75,1
Thompson J.,71,221,96,125,Mannarino A.,27,567,264,303,2023-02-09,Dallas,Dallas Open,Hard,2.5,1.53,0
Ramos-Vinolas A.,82,437,204,233,Lajovic D.,66,378,163,215,2023-02-09,Cordoba,Cordoba Open,Clay,1.73,2.1,1
Gomez E.,155,26,7,19,Kecmanovic M.,40,210,107,103,2023-02-09,Dallas,Dallas Open,Hard,3.75,1.29,1
Delbonis F.,131,340,152,188,Cerundolo F.,21,104,58,46,2023-02-09,Cordoba,Cordoba Open,Clay,2.5,1.53,0
Mcdonald M.,60,190,87,103,Tiafoe F.,10,303,158,145,2023-02-09,Dallas,Dallas Open,Hard,2.63,1.5,0
Krajinovic F.,93,240,115,125,Sonego L.,43,221,107,114,2023-02-09,Montpellier,Open Sud de France,Hard,2.5,1.53,0
Altmaier D.,51,79,28,51,Isner J.,114,755,465,290,2023-02-09,Dallas,Dallas Open,Hard,2.75,1.44,0
Schwartzman D.,95,428,233,195,Cerundolo J.M.,106,29,12,17,2023-02-10,Cordoba,Cordoba Open,Clay,1.73,2.1,0
Sousa J.,147,436,189,247,Ramos-Vinolas A.,82,437,204,233,2023-02-10,Cordoba,Cordoba Open,Clay,3.2,1.36,0
Coria F.,108,99,43,56,Cerundolo F.,21,104,58,46,2023-02-10,Cordoba,Cordoba Open,Clay,1.67,2.2,1
Fritz T.,9,356,205,151,Sock J.,166,324,177,147,2023-02-10,Dallas,Dallas Open,Hard,1.11,6.5,1
Dellien H.,164,70,22,48,Cerundolo J.M.,106,29,12,17,2023-02-10,Cordoba,Cordoba Open,Clay,2.3,1.62,1
Coric B.,15,343,185,158,Cressy M.,96,96,42,54,2023-02-10,Montpellier,Open Sud de France,Hard,1.36,3.2,0
Barrere G.,59,79,31,48,Rune H.,6,131,83,48,2023-02-10,Montpellier,Open Sud de France,Hard,4.5,1.2,0
Halys Q.,79,72,23,49,Fils A.,71,24,15,9,2023-02-10,Montpellier,Open Sud de France,Hard,1.8,2.0,0
Sinner J.,8,224,153,71,Sonego L.,43,221,107,114,2023-02-10,Montpellier,Open Sud de France,Hard,1.3,3.5,1
Isner J.,114,755,465,290,Gomez E.,155,26,7,19,2023-02-10,Dallas,Dallas Open,Hard,1.25,4.0,1
Wolf J.J.,45,75,39,36,Tiafoe F.,10,303,158,145,2023-02-10,Dallas,Dallas Open,Hard,2.75,1.44,1
Otte O.,233,78,33,45,Giron M.,69,150,68,82,2023-02-10,Dallas,Dallas Open,Hard,2.63,1.5,0
Baez S.,72,95,47,48,Barrios M.,121,10,3,7,2023-02-10,Cordoba,Cordoba Open,Clay,1.36,3.2,1
Fils A.,71,24,15,9,Sinner J.,8,224,153,71,2023-02-11,Montpellier,Open Sud de France,Hard,4.0,1.25,0
Cressy M.,96,96,42,54,Rune H.,6,131,83,48,2023-02-11,Montpellier,Open Sud de France,Hard,4.0,1.25,1
Mannarino A.,27,567,264,303,Wu Y.,90,36,15,21,2023-02-11,Dallas,Dallas Open,Hard,1.8,2.0,0
Wu Y.,90,36,15,21,Fritz T.,9,356,205,151,2023-02-11,Dallas,Dallas Open,Hard,3.75,1.29,1
Wolf J.J.,45,75,39,36,Isner J.,114,755,465,290,2023-02-11,Dallas,Dallas Open,Hard,1.73,2.1,0
Giron M.,69,150,68,82,Fritz T.,9,356,205,151,2023-02-11,Dallas,Dallas Open,Hard,4.33,1.22,0
Baez S.,72,95,47,48,Dellien H.,164,70,22,48,2023-02-11,Cordoba,Cordoba Open,Clay,1.44,2.75,1
Ramos-Vinolas A.,82,437,204,233,Coria F.,108,99,43,56,2023-02-11,Cordoba,Cordoba Open,Clay,2.1,1.73,0
Coria F.,108,99,43,56,Baez S.,72,95,47,48,2023-02-12,Cordoba,Cordoba Open,Clay,2.5,1.53,0
Sinner J.,8,224,153,71,Cressy M.,96,96,42,54,2023-02-12,Montpellier,Open Sud de France,Hard,1.3,3.5,1
Wu Y.,90,36,15,21,Isner J.,114,755,465,290,2023-02-12,Dallas,Dallas Open,Hard,1.8,2.0,1
Bublik A.,25,219,110,109,Wawrinka S.,72,854,535,319,2023-02-13,Rotterdam,ABN AMRO World Tennis Tournament,Hard,2.0,1.8,0
Borges N.,69,28,10,18,Johnson S.,197,395,196,199,2023-02-13,Delray Beach,Delray Beach Open,Hard,1.36,3.2,1
Nishioka Y.,31,215,99,116,Otte O.,233,78,33,45,2023-02-13,Delray Beach,Delray Beach Open,Hard,1.3,3.5,1
Gasquet R.,48,948,581,367,Carreno Busta P.,16,352,214,138,2023-02-13,Rotterdam,ABN AMRO World Tennis Tournament,Hard,2.75,1.44,1
Karatsev A.,75,136,66,70,Dimitrov G.,20,651,389,262,2023-02-13,Rotterdam,ABN AMRO World Tennis Tournament,Hard,3.0,1.4,0
Barrere G.,59,79,31,48,Goffin D.,123,522,296,226,2023-02-13,Rotterdam,ABN AMRO World Tennis Tournament,Hard,2.2,1.67,1
Gomez E.,155,26,7,19,Wu T.L.,175,6,1,5,2023-02-13,Delray Beach,Delray Beach Open,Hard,1.91,1.91,1
Kudla D.,137,198,70,128,Thompson J.,71,221,96,125,2023-02-13,Delray Beach,Delray Beach Open,Hard,1.62,2.3,1
Zapata Miralles B.,54,80,32,48,Martinez P.,135,118,50,68,2023-02-13,Buenos Aires,Argentina Open,Clay,1.91,1.91,1
Cachin P.,54,52,23,29,Monteiro T.,121,171,69,102,2023-02-13,Buenos Aires,Argentina Open,Clay,2.2,1.67,1
Djere L.,38,243,120,123,Fognini F.,128,742,383,359,2023-02-13,Buenos Aires,Argentina Open,Clay,1.36,3.2,1
Kovacevic A.,129,14,6,8,Mmoh M.,112,55,20,35,2023-02-14,Delray Beach,Delray Beach Open,Hard,2.1,1.73,0
Ivashka I.,113,159,78,81,Wolf J.J.,45,75,39,36,2023-02-14,Delray Beach,Delray Beach Open,Hard,3.2,1.36,0
Daniel T.,111,178,67,111,Mcdonald M.,60,190,87,103,2023-02-14,Delray Beach,Delray Beach Open,Hard,3.2,1.36,0
Vukic A.,62,36,15,21,Eubanks C.,29,64,28,36,2023-02-14,Delray Beach,Delray Beach Open,Hard,2.38,1.57,1
Ymer M.,59,130,58,72,Griekspoor T.,37,97,47,50,2023-02-14,Rotterdam,ABN AMRO World Tennis Tournament,Hard,2.0,1.8,0
Pecotic M.,784,2,1,1,Sock J.,166,324,177,147,2023-02-14,Delray Beach,Delray Beach Open,Hard,4.0,1.25,1
Davidovich Fokina A.,39,168,84,84,Medvedev D.,3,406,289,117,2023-02-14,Rotterdam,ABN AMRO World Tennis Tournament,Hard,5.0,1.17,0
Tsitsipas S.,5,390,264,126,Ruusuvuori E.,55,158,79,79,2023-02-14,Rotterdam,ABN AMRO World Tennis Tournament,Hard,1.14,5.5,1
Sonego L.,43,221,107,114,Auger-Aliassime F.,12,268,163,105,2023-02-14,Rotterdam,ABN AMRO World Tennis Tournament,Hard,3.75,1.29,0
Huesler M.A.,88,58,21,37,Brouwer G.,144,21,11,10,2023-02-14,Rotterdam,ABN AMRO World Tennis Tournament,Hard,1.29,3.75,0
Hurkacz H.,17,238,137,101,Bautista Agut R.,25,379,234,145,2023-02-14,Rotterdam,ABN AMRO World Tennis Tournament,Hard,1.62,2.3,1
Kwon S.W.,68,108,53,55,Zverev A.,19,500,346,154,2023-02-14,Rotterdam,ABN AMRO World Tennis Tournament,Hard,2.5,1.53,0
Albot R.,97,215,86,129,Verdasco F.,244,962,537,425,2023-02-14,Delray Beach,Delray Beach Open,Hard,1.57,2.38,1
Altmaier D.,51,79,28,51,Mannarino A.,27,567,264,303,2023-02-14,Delray Beach,Delray Beach Open,Hard,3.0,1.4,0
Lajovic D.,66,378,163,215,Baez S.,72,95,47,48,2023-02-14,Buenos Aires,Argentina Open,Clay,2.75,1.44,1
Varillas J. P.,1345,20,9,11,Sousa J.,147,436,189,247,2023-02-14,Buenos Aires,Argentina Open,Clay,1.44,2.75,1
Coria F.,108,99,43,56,Diaz Acosta F.,137,5,1,4,2023-02-14,Buenos Aires,Argentina Open,Clay,1.57,2.38,0
Hanfmann Y.,50,99,50,49,Cerundolo F.,21,104,58,46,2023-02-14,Buenos Aires,Argentina Open,Clay,2.38,1.57,0
Ugo Carabelli C.,122,5,2,3,Galan D.E.,76,78,33,45,2023-02-14,Buenos Aires,Argentina Open,Clay,1.57,2.38,1
Dellien H.,164,70,22,48,Etcheverry T.,34,60,26,34,2023-02-14,Buenos Aires,Argentina Open,Clay,1.73,2.1,0
Pella G.,199,260,118,142,Munar J.,104,178,75,103,2023-02-14,Buenos Aires,Argentina Open,Clay,2.75,1.44,0
Carballes Baena R.,64,207,91,116,Ramos-Vinolas A.,82,437,204,233,2023-02-14,Buenos Aires,Argentina Open,Clay,2.2,1.67,1
Carballes Baena R.,64,207,91,116,Etcheverry T.,34,60,26,34,2023-02-15,Buenos Aires,Argentina Open,Clay,1.91,1.91,0
Molcan A.,120,86,45,41,Thiem D.,116,517,327,190,2023-02-15,Buenos Aires,Argentina Open,Clay,2.2,1.67,0
Pecotic M.,784,2,1,1,Giron M.,69,150,68,82,2023-02-15,Delray Beach,Delray Beach Open,Hard,6.0,1.13,0
Nishioka Y.,31,215,99,116,Mcdonald M.,60,190,87,103,2023-02-15,Delray Beach,Delray Beach Open,Hard,1.73,2.1,0
Borges N.,69,28,10,18,Kecmanovic M.,40,210,107,103,2023-02-15,Delray Beach,Delray Beach Open,Hard,2.75,1.44,0
Giron M.,69,150,68,82,Shelton B.,43,34,13,21,2023-02-15,Delray Beach,Delray Beach Open,Hard,2.2,1.67,1
Ugo Carabelli C.,122,5,2,3,Lajovic D.,66,378,163,215,2023-02-15,Buenos Aires,Argentina Open,Clay,2.5,1.53,0
Van Rijthoven T.,110,19,10,9,Cressy M.,96,96,42,54,2023-02-15,Rotterdam,ABN AMRO World Tennis Tournament,Hard,2.63,1.5,0
Bonzi B.,107,83,37,46,Sinner J.,8,224,153,71,2023-02-15,Rotterdam,ABN AMRO World Tennis Tournament,Hard,5.0,1.17,0
Lestienne C.,109,40,13,27,Rune H.,6,131,83,48,2023-02-15,Rotterdam,ABN AMRO World Tennis Tournament,Hard,5.5,1.14,0
Van De Zandschulp B.,44,117,63,54,Halys Q.,79,72,23,49,2023-02-15,Rotterdam,ABN AMRO World Tennis Tournament,Hard,1.67,2.2,1
De Minaur A.,19,272,161,111,Rublev A.,7,392,255,137,2023-02-15,Rotterdam,ABN AMRO World Tennis Tournament,Hard,2.63,1.5,1
Gasquet R.,48,948,581,367,Wawrinka S.,72,854,535,319,2023-02-15,Rotterdam,ABN AMRO World Tennis Tournament,Hard,2.2,1.67,0
Hurkacz H.,17,238,137,101,Dimitrov G.,20,651,389,262,2023-02-15,Rotterdam,ABN AMRO World Tennis Tournament,Hard,1.8,2.0,0
Griekspoor T.,37,97,47,50,Zverev A.,19,500,346,154,2023-02-15,Rotterdam,ABN AMRO World Tennis Tournament,Hard,3.0,1.4,1
Norrie C.,13,287,172,115,Diaz Acosta F.,137,5,1,4,2023-02-15,Buenos Aires,Argentina Open,Clay,1.29,3.75,1
Tsitsipas S.,5,390,264,126,Sinner J.,8,224,153,71,2023-02-16,Rotterdam,ABN AMRO World Tennis Tournament,Hard,1.67,2.2,0
Barrere G.,59,79,31,48,Auger-Aliassime F.,12,268,163,105,2023-02-16,Rotterdam,ABN AMRO World Tennis Tournament,Hard,4.5,1.2,0
Brouwer G.,144,21,11,10,Rune H.,6,131,83,48,2023-02-16,Rotterdam,ABN AMRO World Tennis Tournament,Hard,8.0,1.08,1
De Minaur A.,19,272,161,111,Cressy M.,96,96,42,54,2023-02-16,Rotterdam,ABN AMRO World Tennis Tournament,Hard,1.4,3.0,1
Varillas J. P.,1345,20,9,11,Thiem D.,116,517,327,190,2023-02-16,Buenos Aires,Argentina Open,Clay,3.2,1.36,1
Van De Zandschulp B.,44,117,63,54,Medvedev D.,3,406,289,117,2023-02-16,Rotterdam,ABN AMRO World Tennis Tournament,Hard,6.0,1.13,0
Zapata Miralles B.,54,80,32,48,Schwartzman D.,95,428,233,195,2023-02-16,Buenos Aires,Argentina Open,Clay,2.38,1.57,1
Mannarino A.,27,567,264,303,Wolf J.J.,45,75,39,36,2023-02-16,Delray Beach,Delray Beach Open,Hard,2.38,1.57,1
Kudla D.,137,198,70,128,Paul T.,14,204,111,93,2023-02-16,Delray Beach,Delray Beach Open,Hard,5.0,1.17,0
Albot R.,97,215,86,129,Vukic A.,62,36,15,21,2023-02-16,Delray Beach,Delray Beach Open,Hard,2.1,1.73,1
Mmoh M.,112,55,20,35,Shapovalov D.,29,298,166,132,2023-02-16,Delray Beach,Delray Beach Open,Hard,3.75,1.29,1
Alcaraz C.,1,164,130,34,Djere L.,38,243,120,123,2023-02-16,Buenos Aires,Argentina Open,Clay,1.25,4.0,1
Musetti L.,18,143,79,64,Cachin P.,54,52,23,29,2023-02-16,Buenos Aires,Argentina Open,Clay,1.33,3.4,1
Cerundolo F.,21,104,58,46,Munar J.,104,178,75,103,2023-02-16,Buenos Aires,Argentina Open,Clay,1.62,2.3,1
Lajovic D.,66,378,163,215,Alcaraz C.,1,164,130,34,2023-02-17,Buenos Aires,Argentina Open,Clay,5.5,1.14,0
Varillas J. P.,1345,20,9,11,Musetti L.,18,143,79,64,2023-02-17,Buenos Aires,Argentina Open,Clay,3.5,1.3,1
Etcheverry T.,34,60,26,34,Norrie C.,13,287,172,115,2023-02-17,Buenos Aires,Argentina Open,Clay,2.38,1.57,0
Auger-Aliassime F.,12,268,163,105,Medvedev D.,3,406,289,117,2023-02-17,Rotterdam,ABN AMRO World Tennis Tournament,Hard,2.2,1.67,0
Gomez E.,155,26,7,19,Fritz T.,9,356,205,151,2023-02-17,Delray Beach,Delray Beach Open,Hard,9.0,1.07,0
Kecmanovic M.,40,210,107,103,Giron M.,69,150,68,82,2023-02-17,Delray Beach,Delray Beach Open,Hard,1.91,1.91,1
Paul T.,14,204,111,93,Albot R.,97,215,86,129,2023-02-17,Delray Beach,Delray Beach Open,Hard,1.14,5.5,0
Brouwer G.,144,21,11,10,Griekspoor T.,37,97,47,50,2023-02-17,Rotterdam,ABN AMRO World Tennis Tournament,Hard,3.4,1.33,0
Dimitrov G.,20,651,389,262,De Minaur A.,19,272,161,111,2023-02-17,Rotterdam,ABN AMRO World Tennis Tournament,Hard,2.0,1.8,1
Sinner J.,8,224,153,71,Wawrinka S.,72,854,535,319,2023-02-17,Rotterdam,ABN AMRO World Tennis Tournament,Hard,1.22,4.33,1
Medvedev D.,3,406,289,117,Dimitrov G.,20,651,389,262,2023-02-18,Rotterdam,ABN AMRO World Tennis Tournament,Hard,1.2,4.5,1
Sinner J.,8,224,153,71,Griekspoor T.,37,97,47,50,2023-02-18,Rotterdam,ABN AMRO World Tennis Tournament,Hard,1.14,5.5,1
Norrie C.,13,287,172,115,Varillas J. P.,1345,20,9,11,2023-02-18,Buenos Aires,Argentina Open,Clay,1.53,2.5,1
Zapata Miralles B.,54,80,32,48,Alcaraz C.,1,164,130,34,2023-02-18,Buenos Aires,Argentina Open,Clay,6.5,1.11,0
Albot R.,97,215,86,129,Kecmanovic M.,40,210,107,103,2023-02-18,Delray Beach,Delray Beach Open,Hard,3.4,1.33,0
Mannarino A.,27,567,264,303,Fritz T.,9,356,205,151,2023-02-18,Delray Beach,Delray Beach Open,Hard,4.33,1.22,0
Mcdonald M.,60,190,87,103,Mmoh M.,112,55,20,35,2023-02-18,Delray Beach,Delray Beach Open,Hard,1.53,2.5,1
Cerundolo F.,21,104,58,46,Zapata Miralles B.,54,80,32,48,2023-02-18,Buenos Aires,Argentina Open,Clay,1.5,2.63,0
Kecmanovic M.,40,210,107,103,Fritz T.,9,356,205,151,2023-02-19,Delray Beach,Delray Beach Open,Hard,3.75,1.29,0
Mcdonald M.,60,190,87,103,Fritz T.,9,356,205,151,2023-02-19,Delray Beach,Delray Beach Open,Hard,3.5,1.3,0
Medvedev D.,3,406,289,117,Sinner J.,8,224,153,71,2023-02-19,Rotterdam,ABN AMRO World Tennis Tournament,Hard,1.57,2.38,1
Alcaraz C.,1,164,130,34,Norrie C.,13,287,172,115,2023-02-19,Buenos Aires,Argentina Open,Clay,1.17,5.0,1
Djere L.,38,243,120,123,Bagnis F.,135,121,39,82,2023-02-20,Rio de Janeiro,Rio Open,Clay,1.44,2.75,1
Thiem D.,116,517,327,190,Monteiro T.,121,171,69,102,2023-02-20,Rio de Janeiro,Rio Open,Clay,1.4,3.0,0
Martinez P.,135,118,50,68,Garin C.,101,190,103,87,2023-02-20,Rio de Janeiro,Rio Open,Clay,2.2,1.67,1
Sousa J.,147,436,189,247,Dellien H.,164,70,22,48,2023-02-20,Rio de Janeiro,Rio Open,Clay,3.0,1.4,0
Bergs Z.,175,15,4,11,Wawrinka S.,72,854,535,319,2023-02-20,Marseille,Open 13,Hard,3.5,1.3,0
Bonzi B.,107,83,37,46,Van Assche L.,68,20,7,13,2023-02-20,Marseille,Open 13,Hard,1.5,2.63,1
Krajinovic F.,93,240,115,125,Bublik A.,25,219,110,109,2023-02-20,Marseille,Open 13,Hard,2.38,1.57,0
Fonseca J.,827,1,0,1,Molcan A.,120,86,45,41,2023-02-20,Rio de Janeiro,Rio Open,Clay,9.0,1.07,0
Murray A.,44,932,687,245,Sonego L.,43,221,107,114,2023-02-20,Doha,Qatar Exxon Mobil Open,Hard,1.67,2.2,1
Kubler J.,77,53,24,29,Karatsev A.,75,136,66,70,2023-02-20,Doha,Qatar Exxon Mobil Open,Hard,1.73,2.1,1
Verdasco F.,244,962,537,425,O Connell C.,74,65,26,39,2023-02-20,Doha,Qatar Exxon Mobil Open,Hard,3.2,1.36,0
Krutykh O.,180,3,0,3,Broady L.,125,47,18,29,2023-02-20,Doha,Qatar Exxon Mobil Open,Hard,3.2,1.36,0
Lestienne C.,109,40,13,27,Davidovich Fokina A.,39,168,84,84,2023-02-20,Doha,Qatar Exxon Mobil Open,Hard,2.63,1.5,0
Brouwer G.,144,21,11,10,Ymer E.,186,81,24,57,2023-02-21,Marseille,Open 13,Hard,1.53,2.5,1
Huesler M.A.,88,58,21,37,Barrere G.,59,79,31,48,2023-02-21,Marseille,Open 13,Hard,2.2,1.67,0
Cressy M.,96,96,42,54,Blancaneaux G.,152,6,0,6,2023-02-21,Marseille,Open 13,Hard,1.2,4.5,1
Gasquet R.,48,948,581,367,Lokoli L.,199,8,0,8,2023-02-21,Marseille,Open 13,Hard,1.25,4.0,1
Klein L.,142,7,2,5,Goffin D.,123,522,296,226,2023-02-21,Marseille,Open 13,Hard,2.75,1.44,0
Andujar P.,323,404,164,240,Ritschard A.,163,9,3,6,2023-02-21,Marseille,Open 13,Hard,4.0,1.25,0
Basilashvili N.,118,301,138,163,Muller A.,81,22,9,13,2023-02-21,Doha,Qatar Exxon Mobil Open,Hard,1.67,2.2,0
Jarry N.,28,141,73,68,Musetti L.,18,143,79,64,2023-02-21,Rio de Janeiro,Rio Open,Clay,2.63,1.5,1
Cachin P.,54,52,23,29,Galan D.E.,76,78,33,45,2023-02-21,Rio de Janeiro,Rio Open,Clay,1.53,2.5,0
Gaston H.,109,58,24,34,Varillas J.P.,77,22,10,12,2023-02-21,Rio de Janeiro,Rio Open,Clay,2.5,1.53,0
Cerundolo J.M.,106,29,12,17,Norrie C.,13,287,172,115,2023-02-21,Rio de Janeiro,Rio Open,Clay,3.2,1.36,0
Ruusuvuori E.,55,158,79,79,Evans D.,30,251,124,127,2023-02-21,Doha,Qatar Exxon Mobil Open,Hard,1.8,2.0,1
Riedi L.,135,5,1,4,Rinderknech A.,67,96,46,50,2023-02-21,Marseille,Open 13,Hard,2.3,1.62,1
Halys Q.,79,72,23,49,Griekspoor T.,37,97,47,50,2023-02-21,Doha,Qatar Exxon Mobil Open,Hard,2.3,1.62,0
Cerundolo F.,21,104,58,46,Carballes Baena R.,64,207,91,116,2023-02-21,Rio de Janeiro,Rio Open,Clay,1.44,2.75,1
Lehecka J.,33,61,30,31,Dzumhur D.,202,234,107,127,2023-02-21,Doha,Qatar Exxon Mobil Open,Hard,1.17,5.0,1
Fucsovics M.,67,249,121,128,Bautista Agut R.,25,379,234,145,2023-02-21,Doha,Qatar Exxon Mobil Open,Hard,3.5,1.3,0
Ivashka I.,113,159,78,81,Van De Zandschulp B.,44,117,63,54,2023-02-21,Doha,Qatar Exxon Mobil Open,Hard,2.38,1.57,0
Shelbayh A.,240,6,1,5,Kwon S.W.,68,108,53,55,2023-02-21,Doha,Qatar Exxon Mobil Open,Hard,4.0,1.25,0
Molcan A.,120,86,45,41,Dellien H.,164,70,22,48,2023-02-22,Rio de Janeiro,Rio Open,Clay,2.1,1.73,0
Lajovic D.,66,378,163,215,Schwartzman D.,95,428,233,195,2023-02-22,Rio de Janeiro,Rio Open,Clay,1.62,2.3,1
Zapata Miralles B.,54,80,32,48,Munar J.,104,178,75,103,2023-02-22,Rio de Janeiro,Rio Open,Clay,1.73,2.1,1
Auger-Aliassime F.,12,268,163,105,Kubler J.,77,53,24,29,2023-02-22,Doha,Qatar Exxon Mobil Open,Hard,1.17,5.0,1
Alves M.,556,1,0,1,Alcaraz C.,1,164,130,34,2023-02-22,Rio de Janeiro,Rio Open,Clay,21.0,1.02,0
Ruusuvuori E.,55,158,79,79,Lehecka J.,33,61,30,31,2023-02-22,Doha,Qatar Exxon Mobil Open,Hard,2.0,1.8,0
Baez S.,72,95,47,48,Bellucci T.,915,380,179,201,2023-02-22,Rio de Janeiro,Rio Open,Clay,1.03,15.0,1
Muller A.,81,22,9,13,Van De Zandschulp B.,44,117,63,54,2023-02-22,Doha,Qatar Exxon Mobil Open,Hard,3.5,1.3,1
Rublev A.,7,392,255,137,Griekspoor T.,37,97,47,50,2023-02-22,Doha,Qatar Exxon Mobil Open,Hard,1.29,3.75,1
Davidovich Fokina A.,39,168,84,84,Kwon S.W.,68,108,53,55,2023-02-22,Doha,Qatar Exxon Mobil Open,Hard,1.73,2.1,1
Murray A.,44,932,687,245,Zverev A.,19,500,346,154,2023-02-22,Doha,Qatar Exxon Mobil Open,Hard,2.2,1.67,1
Etcheverry T.,34,60,26,34,Ramos-Vinolas A.,82,437,204,233,2023-02-22,Rio de Janeiro,Rio Open,Clay,2.1,1.73,0
Barrios M.,121,10,3,7,Fognini F.,128,742,383,359,2023-02-22,Rio de Janeiro,Rio Open,Clay,1.67,2.2,0
Safiullin R.,92,42,20,22,Fils A.,71,24,15,9,2023-02-22,Marseille,Open 13,Hard,2.38,1.57,0
Broady L.,125,47,18,29,Medvedev D.,3,406,289,117,2023-02-22,Doha,Qatar Exxon Mobil Open,Hard,10.0,1.06,0
O Connell C.,74,65,26,39,Bautista Agut R.,25,379,234,145,2023-02-22,Doha,Qatar Exxon Mobil Open,Hard,4.33,1.22,1
Wawrinka S.,72,854,535,319,Gasquet R.,48,948,581,367,2023-02-22,Marseille,Open 13,Hard,1.44,2.75,1
Barrere G.,59,79,31,48,Bublik A.,25,219,110,109,2023-02-22,Marseille,Open 13,Hard,1.8,2.0,0
Cressy M.,96,96,42,54,Bonzi B.,107,83,37,46,2023-02-22,Marseille,Open 13,Hard,1.62,2.3,0
Albot R.,97,215,86,129,Ymer M.,59,130,58,72,2023-02-22,Marseille,Open 13,Hard,3.5,1.3,0
Alcaraz C.,1,164,130,34,Fognini F.,128,742,383,359,2023-02-23,Rio de Janeiro,Rio Open,Clay,1.06,10.0,1
Auger-Aliassime F.,12,268,163,105,Davidovich Fokina A.,39,168,84,84,2023-02-23,Doha,Qatar Exxon Mobil Open,Hard,1.33,3.4,1
O Connell C.,74,65,26,39,Medvedev D.,3,406,289,117,2023-02-23,Doha,Qatar Exxon Mobil Open,Hard,11.0,1.05,0
Muller A.,81,22,9,13,Murray A.,44,932,687,245,2023-02-23,Doha,Qatar Exxon Mobil Open,Hard,3.2,1.36,0
Rublev A.,7,392,255,137,Lehecka J.,33,61,30,31,2023-02-23,Doha,Qatar Exxon Mobil Open,Hard,1.44,2.75,0
Fils A.,71,24,15,9,Sinner J.,8,224,153,71,2023-02-23,Marseille,Open 13,Hard,4.5,1.2,1
Norrie C.,13,287,172,115,Monteiro T.,121,171,69,102,2023-02-23,Rio de Janeiro,Rio Open,Clay,1.29,3.75,1
Goffin D.,123,522,296,226,Ymer M.,59,130,58,72,2023-02-23,Marseille,Open 13,Hard,1.8,2.0,0
Zapata Miralles B.,54,80,32,48,Cerundolo F.,21,104,58,46,2023-02-23,Rio de Janeiro,Rio Open,Clay,2.38,1.57,1
Ramos-Vinolas A.,82,437,204,233,Galan D.E.,76,78,33,45,2023-02-23,Rio de Janeiro,Rio Open,Clay,1.5,2.63,1
Martinez P.,135,118,50,68,Jarry N.,28,141,73,68,2023-02-23,Rio de Janeiro,Rio Open,Clay,3.2,1.36,0
Riedi L.,135,5,1,4,Hurkacz H.,17,238,137,101,2023-02-23,Marseille,Open 13,Hard,4.0,1.25,0
Ritschard A.,163,9,3,6,De Minaur A.,19,272,161,111,2023-02-23,Marseille,Open 13,Hard,9.0,1.07,0
Dimitrov G.,20,651,389,262,Brouwer G.,144,21,11,10,2023-02-23,Marseille,Open 13,Hard,1.2,4.5,1
Varillas J.P.,77,22,10,12,Baez S.,72,95,47,48,2023-02-23,Rio de Janeiro,Rio Open,Clay,2.5,1.53,0
Djere L.,38,243,120,123,Lajovic D.,66,378,163,215,2023-02-24,Rio de Janeiro,Rio Open,Clay,1.62,2.3,0
Dellien H.,164,70,22,48,Norrie C.,13,287,172,115,2023-02-24,Rio de Janeiro,Rio Open,Clay,3.0,1.4,0
Ramos-Vinolas A.,82,437,204,233,Zapata Miralles B.,54,80,32,48,2023-02-24,Rio de Janeiro,Rio Open,Clay,2.1,1.73,0
Bonzi B.,107,83,37,46,De Minaur A.,19,272,161,111,2023-02-24,Marseille,Open 13,Hard,3.4,1.33,1
Wawrinka S.,72,854,535,319,Fils A.,71,24,15,9,2023-02-24,Marseille,Open 13,Hard,2.2,1.67,0
Bublik A.,25,219,110,109,Dimitrov G.,20,651,389,262,2023-02-24,Marseille,Open 13,Hard,2.63,1.5,1
Hurkacz H.,17,238,137,101,Ymer M.,59,130,58,72,2023-02-24,Marseille,Open 13,Hard,1.33,3.4,1
Murray A.,44,932,687,245,Lehecka J.,33,61,30,31,2023-02-24,Doha,Qatar Exxon Mobil Open,Hard,2.63,1.5,1
Auger-Aliassime F.,12,268,163,105,Medvedev D.,3,406,289,117,2023-02-24,Doha,Qatar Exxon Mobil Open,Hard,3.0,1.4,0
Lajovic D.,66,378,163,215,Alcaraz C.,1,164,130,34,2023-02-24,Rio de Janeiro,Rio Open,Clay,6.0,1.13,0
Jarry N.,28,141,73,68,Baez S.,72,95,47,48,2023-02-25,Rio de Janeiro,Rio Open,Clay,1.73,2.1,1
Jarry N.,28,141,73,68,Alcaraz C.,1,164,130,34,2023-02-25,Rio de Janeiro,Rio Open,Clay,4.5,1.2,0
Norrie C.,13,287,172,115,Zapata Miralles B.,54,80,32,48,2023-02-25,Rio de Janeiro,Rio Open,Clay,1.44,2.75,1
Medvedev D.,3,406,289,117,Murray A.,44,932,687,245,2023-02-25,Doha,Qatar Exxon Mobil Open,Hard,1.14,5.5,1
Bonzi B.,107,83,37,46,Fils A.,71,24,15,9,2023-02-25,Marseille,Open 13,Hard,2.2,1.67,1
Bublik A.,25,219,110,109,Hurkacz H.,17,238,137,101,2023-02-25,Marseille,Open 13,Hard,2.3,1.62,0
Hurkacz H.,17,238,137,101,Bonzi B.,107,83,37,46,2023-02-26,Marseille,Open 13,Hard,1.5,2.63,1
Alcaraz C.,1,164,130,34,Norrie C.,13,287,172,115,2023-02-26,Rio de Janeiro,Rio Open,Clay,1.22,4.33,0
Hanfmann Y.,50,99,50,49,Martinez P.,135,118,50,68,2023-02-27,Santiago,Chile Open,Clay,1.73,2.1,1
Lestienne C.,109,40,13,27,Griekspoor T.,37,97,47,50,2023-02-27,Dubai ,Dubai Tennis Championships,Hard,3.4,1.33,0
Davidovich Fokina A.,39,168,84,84,Jaziri M.,444,217,83,134,2023-02-27,Dubai ,Dubai Tennis Championships,Hard,1.02,21.0,1
Kotov P.,89,25,10,15,Popyrin A.,90,140,59,81,2023-02-27,Dubai ,Dubai Tennis Championships,Hard,2.38,1.57,1
Krajinovic F.,93,240,115,125,Rublev A.,7,392,255,137,2023-02-27,Dubai ,Dubai Tennis Championships,Hard,5.0,1.17,0
Zverev A.,19,500,346,154,Lehecka J.,33,61,30,31,2023-02-27,Dubai ,Dubai Tennis Championships,Hard,1.8,2.0,1
Sonego L.,43,221,107,114,Huesler M.A.,88,58,21,37,2023-02-27,Dubai ,Dubai Tennis Championships,Hard,1.5,2.63,1
Cerundolo J.M.,106,29,12,17,Cachin P.,54,52,23,29,2023-02-27,Santiago,Chile Open,Clay,1.5,2.63,1
Galan D.E.,76,78,33,45,Bonadio R.,181,3,1,2,2023-02-27,Santiago,Chile Open,Clay,1.44,2.75,0
Halys Q.,79,72,23,49,Kokkinakis T.,86,124,55,69,2023-02-27,Dubai ,Dubai Tennis Championships,Hard,2.38,1.57,0
Tabilo A.,122,44,21,23,Munar J.,104,178,75,103,2023-02-27,Santiago,Chile Open,Clay,1.62,2.3,0
Fognini F.,128,742,383,359,Etcheverry T.,34,60,26,34,2023-02-28,Santiago,Chile Open,Clay,2.3,1.62,0
Jarry N.,28,141,73,68,Varillas J.P.,77,22,10,12,2023-02-28,Santiago,Chile Open,Clay,1.57,2.38,1
Cecchinato M.,108,204,79,125,Bagnis F.,135,121,39,82,2023-02-28,Santiago,Chile Open,Clay,2.2,1.67,1
Sousa J.,147,436,189,247,Djere L.,38,243,120,123,2023-02-28,Santiago,Chile Open,Clay,4.33,1.22,0
Carballes Baena R.,64,207,91,116,Taberner C.,181,37,13,24,2023-02-28,Santiago,Chile Open,Clay,1.36,3.2,1
Ugo Carabelli C.,122,5,2,3,Lajovic D.,66,378,163,215,2023-02-28,Santiago,Chile Open,Clay,3.2,1.36,0
O Connell C.,74,65,26,39,Ruusuvuori E.,55,158,79,79,2023-02-28,Dubai ,Dubai Tennis Championships,Hard,2.63,1.5,1
Cressy M.,96,96,42,54,Auger-Aliassime F.,12,268,163,105,2023-02-28,Dubai ,Dubai Tennis Championships,Hard,3.5,1.3,0
Van De Zandschulp B.,44,117,63,54,Khachanov K.,11,378,217,161,2023-02-28,Dubai ,Dubai Tennis Championships,Hard,3.0,1.4,1
Passaro F.,126,10,3,7,Ymer M.,59,130,58,72,2023-02-28,Dubai ,Dubai Tennis Championships,Hard,4.0,1.25,0
Bublik A.,25,219,110,109,Lazarov A.,301,6,1,5,2023-02-28,Dubai ,Dubai Tennis Championships,Hard,1.2,4.5,1
Arnaldi M.,76,18,9,9,Medvedev D.,3,406,289,117,2023-02-28,Dubai ,Dubai Tennis Championships,Hard,19.0,1.02,0
Djokovic N.,2,1207,1012,195,Machac T.,108,18,6,12,2023-02-28,Dubai ,Dubai Tennis Championships,Hard,1.05,11.0,1
Shevchenko A.,93,20,8,12,Hurkacz H.,17,238,137,101,2023-02-28,Dubai ,Dubai Tennis Championships,Hard,7.0,1.1,0
Monteiro T.,121,171,69,102,Ramos-Vinolas A.,82,437,204,233,2023-02-28,Santiago,Chile Open,Clay,2.2,1.67,1
Evans D.,30,251,124,127,Coric B.,15,343,185,158,2023-02-28,Dubai ,Dubai Tennis Championships,Hard,2.5,1.53,0
Garin C.,101,190,103,87,Thiem D.,116,517,327,190,2023-02-28,Santiago,Chile Open,Clay,2.2,1.67,1
Lopez F.,634,863,441,422,Eubanks C.,29,64,28,36,2023-02-28,Acapulco,Abierto Mexicano,Hard,5.5,1.14,1
Fritz T.,9,356,205,151,Isner J.,114,755,465,290,2023-02-28,Acapulco,Abierto Mexicano,Hard,1.29,3.75,1
Andreozzi G.,240,39,12,27,Ruud C.,4,275,176,99,2023-02-28,Acapulco,Abierto Mexicano,Hard,9.0,1.07,0
Gomez E.,155,26,7,19,Paul T.,14,204,111,93,2023-02-28,Acapulco,Abierto Mexicano,Hard,5.5,1.14,0
Wolf J.J.,45,75,39,36,Daniel T.,111,178,67,111,2023-02-28,Acapulco,Abierto Mexicano,Hard,1.44,2.75,0
Nishioka Y.,31,215,99,116,Tiafoe F.,10,303,158,145,2023-02-28,Acapulco,Abierto Mexicano,Hard,2.63,1.5,0
Shelton B.,43,34,13,21,Rune H.,6,131,83,48,2023-02-28,Acapulco,Abierto Mexicano,Hard,3.4,1.33,0
Mmoh M.,112,55,20,35,Giron M.,69,150,68,82,2023-02-28,Acapulco,Abierto Mexicano,Hard,2.5,1.53,1
Kecmanovic M.,40,210,107,103,Shapovalov D.,29,298,166,132,2023-02-28,Acapulco,Abierto Mexicano,Hard,2.2,1.67,0
Auger-Aliassime F.,12,268,163,105,Sonego L.,43,221,107,114,2023-03-01,Dubai ,Dubai Tennis Championships,Hard,1.25,4.0,0
Hurkacz H.,17,238,137,101,Kotov P.,89,25,10,15,2023-03-01,Dubai ,Dubai Tennis Championships,Hard,1.2,4.5,1
Zverev A.,19,500,346,154,O Connell C.,74,65,26,39,2023-03-01,Dubai ,Dubai Tennis Championships,Hard,1.29,3.75,1
Coric B.,15,343,185,158,Kokkinakis T.,86,124,55,69,2023-03-01,Dubai ,Dubai Tennis Championships,Hard,1.73,2.1,1
Griekspoor T.,37,97,47,50,Djokovic N.,2,1207,1012,195,2023-03-01,Dubai ,Dubai Tennis Championships,Hard,10.0,1.06,0
Bublik A.,25,219,110,109,Medvedev D.,3,406,289,117,2023-03-01,Dubai ,Dubai Tennis Championships,Hard,5.5,1.14,0
Molcan A.,120,86,45,41,Berrettini M.,38,217,142,75,2023-03-01,Acapulco,Abierto Mexicano,Hard,5.0,1.17,0
Ymer M.,59,130,58,72,Van De Zandschulp B.,44,117,63,54,2023-03-01,Dubai ,Dubai Tennis Championships,Hard,2.0,1.8,0
Davidovich Fokina A.,39,168,84,84,Rublev A.,7,392,255,137,2023-03-01,Dubai ,Dubai Tennis Championships,Hard,3.5,1.3,0
De Minaur A.,19,272,161,111,Pacheco Mendez R.,817,3,0,3,2023-03-01,Acapulco,Abierto Mexicano,Hard,1.02,19.0,1
Otte O.,233,78,33,45,Berrettini J.,842,2,1,1,2023-03-01,Acapulco,Abierto Mexicano,Hard,1.14,5.5,0
Darderi L.,184,3,1,2,Mcdonald M.,60,190,87,103,2023-03-01,Acapulco,Abierto Mexicano,Hard,5.5,1.14,0
Borges N.,69,28,10,18,Chappell N.,432,2,0,2,2023-03-01,Acapulco,Abierto Mexicano,Hard,1.11,6.5,1
Carballes Baena R.,64,207,91,116,Hanfmann Y.,50,99,50,49,2023-03-01,Santiago,Chile Open,Clay,2.5,1.53,0
Musetti L.,18,143,79,64,Munar J.,104,178,75,103,2023-03-01,Santiago,Chile Open,Clay,1.44,2.75,0
Monteiro T.,121,171,69,102,Cecchinato M.,108,204,79,125,2023-03-01,Santiago,Chile Open,Clay,1.57,2.38,1
Jarry N.,28,141,73,68,Schwartzman D.,95,428,233,195,2023-03-01,Santiago,Chile Open,Clay,1.36,3.2,1
Altmaier D.,51,79,28,51,Nakashima B.,70,106,57,49,2023-03-01,Acapulco,Abierto Mexicano,Hard,2.75,1.44,0
Ymer E.,186,81,24,57,Mannarino A.,27,567,264,303,2023-03-01,Acapulco,Abierto Mexicano,Hard,3.0,1.4,1
Baez S.,72,95,47,48,Garin C.,101,190,103,87,2023-03-02,Santiago,Chile Open,Clay,1.67,2.2,1
Cerundolo J.M.,106,29,12,17,Lajovic D.,66,378,163,215,2023-03-02,Santiago,Chile Open,Clay,2.63,1.5,0
Djokovic N.,2,1207,1012,195,Hurkacz H.,17,238,137,101,2023-03-02,Dubai ,Dubai Tennis Championships,Hard,1.1,7.0,1
Paul T.,14,204,111,93,Mmoh M.,112,55,20,35,2023-03-02,Acapulco,Abierto Mexicano,Hard,1.36,3.2,1
Mcdonald M.,60,190,87,103,Paul T.,14,204,111,93,2023-03-02,Acapulco,Abierto Mexicano,Hard,2.3,1.62,0
Rune H.,6,131,83,48,Borges N.,69,28,10,18,2023-03-02,Acapulco,Abierto Mexicano,Hard,1.2,4.5,1
Shapovalov D.,29,298,166,132,Fritz T.,9,356,205,151,2023-03-02,Acapulco,Abierto Mexicano,Hard,2.3,1.62,0
Ymer E.,186,81,24,57,Berrettini M.,38,217,142,75,2023-03-02,Acapulco,Abierto Mexicano,Hard,8.0,1.08,0
De Minaur A.,19,272,161,111,Berrettini J.,842,2,1,1,2023-03-02,Acapulco,Abierto Mexicano,Hard,1.03,15.0,1
Coric B.,15,343,185,158,Medvedev D.,3,406,289,117,2023-03-02,Dubai ,Dubai Tennis Championships,Hard,4.5,1.2,0
Daniel T.,111,178,67,111,Ruud C.,4,275,176,99,2023-03-02,Acapulco,Abierto Mexicano,Hard,3.5,1.3,1
Etcheverry T.,34,60,26,34,Cerundolo F.,21,104,58,46,2023-03-02,Santiago,Chile Open,Clay,2.3,1.62,1
Mcdonald M.,60,190,87,103,Nakashima B.,70,106,57,49,2023-03-02,Acapulco,Abierto Mexicano,Hard,1.91,1.91,1
Bonadio R.,181,3,1,2,Djere L.,38,243,120,123,2023-03-02,Santiago,Chile Open,Clay,5.0,1.17,0
Zverev A.,19,500,346,154,Sonego L.,43,221,107,114,2023-03-02,Dubai ,Dubai Tennis Championships,Hard,1.44,2.75,1
Rublev A.,7,392,255,137,Van De Zandschulp B.,44,117,63,54,2023-03-02,Dubai ,Dubai Tennis Championships,Hard,1.4,3.0,1
Tiafoe F.,10,303,158,145,Lopez F.,634,863,441,422,2023-03-02,Acapulco,Abierto Mexicano,Hard,1.06,10.0,1
Baez S.,72,95,47,48,Djere L.,38,243,120,123,2023-03-03,Santiago,Chile Open,Clay,1.53,2.5,1
Lajovic D.,66,378,163,215,Etcheverry T.,34,60,26,34,2023-03-03,Santiago,Chile Open,Clay,1.8,2.0,0
Medvedev D.,3,406,289,117,Djokovic N.,2,1207,1012,195,2023-03-03,Dubai ,Dubai Tennis Championships,Hard,2.75,1.44,1
De Minaur A.,19,272,161,111,Daniel T.,111,178,67,111,2023-03-03,Acapulco,Abierto Mexicano,Hard,1.25,4.0,1
Tiafoe F.,10,303,158,145,Fritz T.,9,356,205,151,2023-03-03,Acapulco,Abierto Mexicano,Hard,2.75,1.44,0
Berrettini M.,38,217,142,75,Rune H.,6,131,83,48,2023-03-03,Acapulco,Abierto Mexicano,Hard,2.0,1.8,0
Munar J.,104,178,75,103,Monteiro T.,121,171,69,102,2023-03-03,Santiago,Chile Open,Clay,1.67,2.2,1
Rublev A.,7,392,255,137,Zverev A.,19,500,346,154,2023-03-03,Dubai ,Dubai Tennis Championships,Hard,2.2,1.67,1
De Minaur A.,19,272,161,111,Rune H.,6,131,83,48,2023-03-04,Acapulco,Abierto Mexicano,Hard,2.75,1.44,1
Medvedev D.,3,406,289,117,Rublev A.,7,392,255,137,2023-03-04,Dubai ,Dubai Tennis Championships,Hard,1.22,4.33,1
Fritz T.,9,356,205,151,Paul T.,14,204,111,93,2023-03-04,Acapulco,Abierto Mexicano,Hard,1.53,2.5,0
Jarry N.,28,141,73,68,Munar J.,104,178,75,103,2023-03-04,Santiago,Chile Open,Clay,1.44,2.75,1
Jarry N.,28,141,73,68,Hanfmann Y.,50,99,50,49,2023-03-04,Santiago,Chile Open,Clay,1.57,2.38,1
Etcheverry T.,34,60,26,34,Baez S.,72,95,47,48,2023-03-04,Santiago,Chile Open,Clay,2.63,1.5,1
Etcheverry T.,34,60,26,34,Jarry N.,28,141,73,68,2023-03-05,Santiago,Chile Open,Clay,1.91,1.91,0
De Minaur A.,19,272,161,111,Paul T.,14,204,111,93,2023-03-05,Acapulco,Abierto Mexicano,Hard,1.67,2.2,1
Carballes Baena R.,64,207,91,116,Daniel T.,111,178,67,111,2023-03-08,Indian Wells,BNP Paribas Open,Hard,3.2,1.36,0
Humbert U.,36,170,80,90,Zapata Miralles B.,54,80,32,48,2023-03-08,Indian Wells,BNP Paribas Open,Hard,1.44,2.75,1
Kovacevic A.,129,14,6,8,Giron M.,69,150,68,82,2023-03-08,Indian Wells,BNP Paribas Open,Hard,2.3,1.62,0
Safiullin R.,92,42,20,22,Ivashka I.,113,159,78,81,2023-03-08,Indian Wells,BNP Paribas Open,Hard,1.8,2.0,0
Djere L.,38,243,120,123,Otte O.,233,78,33,45,2023-03-08,Indian Wells,BNP Paribas Open,Hard,1.57,2.38,0
Sonego L.,43,221,107,114,Kubler J.,77,53,24,29,2023-03-08,Indian Wells,BNP Paribas Open,Hard,1.44,2.75,0
Nakashima B.,70,106,57,49,Isner J.,114,755,465,290,2023-03-08,Indian Wells,BNP Paribas Open,Hard,1.91,1.91,1
Cachin P.,54,52,23,29,Basilashvili N.,118,301,138,163,2023-03-08,Indian Wells,BNP Paribas Open,Hard,2.1,1.73,1
Ruusuvuori E.,55,158,79,79,Lestienne C.,109,40,13,27,2023-03-08,Indian Wells,BNP Paribas Open,Hard,1.44,2.75,1
Galan D.E.,76,78,33,45,Garin C.,101,190,103,87,2023-03-08,Indian Wells,BNP Paribas Open,Hard,3.0,1.4,0
Wu Y.,90,36,15,21,Munar J.,104,178,75,103,2023-03-08,Indian Wells,BNP Paribas Open,Hard,1.36,3.2,1
Rinderknech A.,67,96,46,50,Lehecka J.,33,61,30,31,2023-03-08,Indian Wells,BNP Paribas Open,Hard,4.0,1.25,0
Kokkinakis T.,86,124,55,69,Holt B.,193,7,2,5,2023-03-09,Indian Wells,BNP Paribas Open,Hard,1.22,4.33,1
Fucsovics M.,67,249,121,128,Wolf J.J.,45,75,39,36,2023-03-09,Indian Wells,BNP Paribas Open,Hard,2.3,1.62,1
Etcheverry T.,34,60,26,34,Murray A.,44,932,687,245,2023-03-09,Indian Wells,BNP Paribas Open,Hard,3.75,1.29,0
Martinez P.,135,118,50,68,Huesler M.A.,88,58,21,37,2023-03-09,Indian Wells,BNP Paribas Open,Hard,2.75,1.44,1
Monteiro T.,121,171,69,102,Pella G.,199,260,118,142,2023-03-09,Indian Wells,BNP Paribas Open,Hard,1.5,2.63,0
Ramos-Vinolas A.,82,437,204,233,Molcan A.,120,86,45,41,2023-03-09,Indian Wells,BNP Paribas Open,Hard,1.67,2.2,0
Vukic A.,62,36,15,21,Wawrinka S.,72,854,535,319,2023-03-09,Indian Wells,BNP Paribas Open,Hard,2.75,1.44,0
Shelton B.,43,34,13,21,Fognini F.,128,742,383,359,2023-03-09,Indian Wells,BNP Paribas Open,Hard,1.25,4.0,1
Halys Q.,79,72,23,49,Struff J.L.,21,369,170,199,2023-03-09,Indian Wells,BNP Paribas Open,Hard,2.2,1.67,0
Krajinovic F.,93,240,115,125,Mcdonald M.,60,190,87,103,2023-03-09,Indian Wells,BNP Paribas Open,Hard,2.75,1.44,0
Bublik A.,25,219,110,109,Wu T.L.,175,6,1,5,2023-03-09,Indian Wells,BNP Paribas Open,Hard,1.25,4.0,0
Tabilo A.,122,44,21,23,Marterer M.,144,91,31,60,2023-03-09,Indian Wells,BNP Paribas Open,Hard,1.8,2.0,1
Monfils G.,323,816,510,306,Thompson J.,71,221,96,125,2023-03-09,Indian Wells,BNP Paribas Open,Hard,2.38,1.57,0
Schwartzman D.,95,428,233,195,Coria F.,108,99,43,56,2023-03-09,Indian Wells,BNP Paribas Open,Hard,1.5,2.63,1
Riedi L.,135,5,1,4,Draper J.,55,51,29,22,2023-03-09,Indian Wells,BNP Paribas Open,Hard,2.75,1.44,0
Humbert U.,36,170,80,90,Shapovalov D.,29,298,166,132,2023-03-10,Indian Wells,BNP Paribas Open,Hard,2.63,1.5,1
Cachin P.,54,52,23,29,Zverev A.,19,500,346,154,2023-03-10,Indian Wells,BNP Paribas Open,Hard,8.0,1.08,0
Wu Y.,90,36,15,21,Davidovich Fokina A.,39,168,84,84,2023-03-10,Indian Wells,BNP Paribas Open,Hard,2.0,1.8,0
Tabilo A.,122,44,21,23,Cressy M.,96,96,42,54,2023-03-10,Indian Wells,BNP Paribas Open,Hard,2.63,1.5,1
Dimitrov G.,20,651,389,262,Kubler J.,77,53,24,29,2023-03-10,Indian Wells,BNP Paribas Open,Hard,1.33,3.4,0
Thompson J.,71,221,96,125,Tsitsipas S.,5,390,264,126,2023-03-10,Indian Wells,BNP Paribas Open,Hard,5.5,1.14,1
Ruusuvuori E.,55,158,79,79,Bautista Agut R.,25,379,234,145,2023-03-10,Indian Wells,BNP Paribas Open,Hard,2.3,1.62,1
Van De Zandschulp B.,44,117,63,54,Ivashka I.,113,159,78,81,2023-03-10,Indian Wells,BNP Paribas Open,Hard,1.53,2.5,0
Norrie C.,13,287,172,115,Wu T.L.,175,6,1,5,2023-03-10,Indian Wells,BNP Paribas Open,Hard,1.1,7.0,1
Nishioka Y.,31,215,99,116,Garin C.,101,190,103,87,2023-03-10,Indian Wells,BNP Paribas Open,Hard,1.53,2.5,0
Zhang Zh.,53,44,20,24,Popyrin A.,90,140,59,81,2023-03-10,Indian Wells,BNP Paribas Open,Hard,2.5,1.53,0
Barrere G.,59,79,31,48,Sock J.,166,324,177,147,2023-03-10,Indian Wells,BNP Paribas Open,Hard,1.62,2.3,0
Mannarino A.,27,567,264,303,Thiem D.,116,517,327,190,2023-03-10,Indian Wells,BNP Paribas Open,Hard,1.8,2.0,1
Gojo B.,115,14,3,11,Gasquet R.,48,948,581,367,2023-03-10,Indian Wells,BNP Paribas Open,Hard,1.62,2.3,0
Ymer M.,59,130,58,72,Hijikata R.,110,16,7,9,2023-03-10,Indian Wells,BNP Paribas Open,Hard,1.29,3.75,0
Schwartzman D.,95,428,233,195,Ruud C.,4,275,176,99,2023-03-10,Indian Wells,BNP Paribas Open,Hard,4.0,1.25,0
De Minaur A.,19,272,161,111,Fucsovics M.,67,249,121,128,2023-03-11,Indian Wells,BNP Paribas Open,Hard,1.29,3.75,0
Albot R.,97,215,86,129,Murray A.,44,932,687,245,2023-03-11,Indian Wells,BNP Paribas Open,Hard,3.75,1.29,0
Cerundolo F.,21,104,58,46,Sock J.,166,324,177,147,2023-03-11,Indian Wells,BNP Paribas Open,Hard,1.91,1.91,1
Auger-Aliassime F.,12,268,163,105,Martinez P.,135,118,50,68,2023-03-11,Indian Wells,BNP Paribas Open,Hard,1.08,8.0,1
Shelton B.,43,34,13,21,Fritz T.,9,356,205,151,2023-03-11,Indian Wells,BNP Paribas Open,Hard,4.0,1.25,0
Mannarino A.,27,567,264,303,Musetti L.,18,143,79,64,2023-03-11,Indian Wells,BNP Paribas Open,Hard,1.91,1.91,1
Struff J.L.,21,369,170,199,Paul T.,14,204,111,93,2023-03-11,Indian Wells,BNP Paribas Open,Hard,3.5,1.3,0
Griekspoor T.,37,97,47,50,Pella G.,199,260,118,142,2023-03-11,Indian Wells,BNP Paribas Open,Hard,1.2,4.5,1
Molcan A.,120,86,45,41,Coric B.,15,343,185,158,2023-03-11,Indian Wells,BNP Paribas Open,Hard,3.5,1.3,1
Rublev A.,7,392,255,137,Lehecka J.,33,61,30,31,2023-03-11,Indian Wells,BNP Paribas Open,Hard,1.44,2.75,1
Wawrinka S.,72,854,535,319,Kecmanovic M.,40,210,107,103,2023-03-11,Indian Wells,BNP Paribas Open,Hard,2.2,1.67,1
Sinner J.,8,224,153,71,Gasquet R.,48,948,581,367,2023-03-11,Indian Wells,BNP Paribas Open,Hard,1.11,6.5,1
Draper J.,55,51,29,22,Evans D.,30,251,124,127,2023-03-11,Indian Wells,BNP Paribas Open,Hard,1.36,3.2,1
Tiafoe F.,10,303,158,145,Giron M.,69,150,68,82,2023-03-11,Indian Wells,BNP Paribas Open,Hard,1.36,3.2,1
Medvedev D.,3,406,289,117,Nakashima B.,70,106,57,49,2023-03-11,Indian Wells,BNP Paribas Open,Hard,1.1,7.0,1
Otte O.,233,78,33,45,Khachanov K.,11,378,217,161,2023-03-11,Indian Wells,BNP Paribas Open,Hard,3.75,1.29,0
Berrettini M.,38,217,142,75,Daniel T.,111,178,67,111,2023-03-11,Indian Wells,BNP Paribas Open,Hard,1.3,3.5,0
Humbert U.,36,170,80,90,Rublev A.,7,392,255,137,2023-03-12,Indian Wells,BNP Paribas Open,Hard,4.33,1.22,0
Kubler J.,77,53,24,29,Tiafoe F.,10,303,158,145,2023-03-12,Indian Wells,BNP Paribas Open,Hard,4.5,1.2,0
Khachanov K.,11,378,217,161,Davidovich Fokina A.,39,168,84,84,2023-03-12,Indian Wells,BNP Paribas Open,Hard,1.62,2.3,0
Ruusuvuori E.,55,158,79,79,Zverev A.,19,500,346,154,2023-03-12,Indian Wells,BNP Paribas Open,Hard,3.5,1.3,0
Daniel T.,111,178,67,111,Norrie C.,13,287,172,115,2023-03-12,Indian Wells,BNP Paribas Open,Hard,4.33,1.22,0
Kokkinakis T.,86,124,55,69,Alcaraz C.,1,164,130,34,2023-03-12,Indian Wells,BNP Paribas Open,Hard,3.4,1.33,0
Mcdonald M.,60,190,87,103,Rune H.,6,131,83,48,2023-03-12,Indian Wells,BNP Paribas Open,Hard,3.2,1.36,0
Hijikata R.,110,16,7,9,Baez S.,72,95,47,48,2023-03-12,Indian Wells,BNP Paribas Open,Hard,1.8,2.0,0
Popyrin A.,90,140,59,81,Hurkacz H.,17,238,137,101,2023-03-12,Indian Wells,BNP Paribas Open,Hard,4.33,1.22,0
Garin C.,101,190,103,87,Ruud C.,4,275,176,99,2023-03-12,Indian Wells,BNP Paribas Open,Hard,4.33,1.22,1
Fucsovics M.,67,249,121,128,Molcan A.,120,86,45,41,2023-03-13,Indian Wells,BNP Paribas Open,Hard,1.57,2.38,1
Mannarino A.,27,567,264,303,Sinner J.,8,224,153,71,2023-03-13,Indian Wells,BNP Paribas Open,Hard,7.0,1.1,0
Baez S.,72,95,47,48,Fritz T.,9,356,205,151,2023-03-13,Indian Wells,BNP Paribas Open,Hard,6.5,1.11,0
Wawrinka S.,72,854,535,319,Rune H.,6,131,83,48,2023-03-13,Indian Wells,BNP Paribas Open,Hard,4.33,1.22,1
Cerundolo F.,21,104,58,46,Auger-Aliassime F.,12,268,163,105,2023-03-13,Indian Wells,BNP Paribas Open,Hard,4.5,1.2,0
Hurkacz H.,17,238,137,101,Paul T.,14,204,111,93,2023-03-13,Indian Wells,BNP Paribas Open,Hard,1.73,2.1,0
Thompson J.,71,221,96,125,Tabilo A.,122,44,21,23,2023-03-13,Indian Wells,BNP Paribas Open,Hard,1.67,2.2,0
Ivashka I.,113,159,78,81,Medvedev D.,3,406,289,117,2023-03-13,Indian Wells,BNP Paribas Open,Hard,15.0,1.03,0
Fucsovics M.,67,249,121,128,Fritz T.,9,356,205,151,2023-03-14,Indian Wells,BNP Paribas Open,Hard,4.5,1.2,0
Norrie C.,13,287,172,115,Rublev A.,7,392,255,137,2023-03-14,Indian Wells,BNP Paribas Open,Hard,2.3,1.62,1
Zverev A.,19,500,346,154,Medvedev D.,3,406,289,117,2023-03-14,Indian Wells,BNP Paribas Open,Hard,4.0,1.25,0
Tabilo A.,122,44,21,23,Tiafoe F.,10,303,158,145,2023-03-14,Indian Wells,BNP Paribas Open,Hard,4.5,1.2,0
Alcaraz C.,1,164,130,34,Griekspoor T.,37,97,47,50,2023-03-14,Indian Wells,BNP Paribas Open,Hard,1.1,7.0,1
Draper J.,55,51,29,22,Murray A.,44,932,687,245,2023-03-14,Indian Wells,BNP Paribas Open,Hard,1.67,2.2,1
Garin C.,101,190,103,87,Davidovich Fokina A.,39,168,84,84,2023-03-14,Indian Wells,BNP Paribas Open,Hard,3.0,1.4,0
Alcaraz C.,1,164,130,34,Draper J.,55,51,29,22,2023-03-15,Indian Wells,BNP Paribas Open,Hard,1.3,3.5,1
Sinner J.,8,224,153,71,Wawrinka S.,72,854,535,319,2023-03-15,Indian Wells,BNP Paribas Open,Hard,1.17,5.0,1
Auger-Aliassime F.,12,268,163,105,Paul T.,14,204,111,93,2023-03-15,Indian Wells,BNP Paribas Open,Hard,1.8,2.0,1
Tiafoe F.,10,303,158,145,Norrie C.,13,287,172,115,2023-03-15,Indian Wells,BNP Paribas Open,Hard,2.38,1.57,1
Davidovich Fokina A.,39,168,84,84,Medvedev D.,3,406,289,117,2023-03-15,Indian Wells,BNP Paribas Open,Hard,4.33,1.22,0
Fritz T.,9,356,205,151,Sinner J.,8,224,153,71,2023-03-16,Indian Wells,BNP Paribas Open,Hard,2.2,1.67,0
Alcaraz C.,1,164,130,34,Auger-Aliassime F.,12,268,163,105,2023-03-17,Indian Wells,BNP Paribas Open,Hard,1.36,3.2,1
Alcaraz C.,1,164,130,34,Sinner J.,8,224,153,71,2023-03-18,Indian Wells,BNP Paribas Open,Hard,1.53,2.5,1
Medvedev D.,3,406,289,117,Tiafoe F.,10,303,158,145,2023-03-18,Indian Wells,BNP Paribas Open,Hard,1.25,4.0,1
Medvedev D.,3,406,289,117,Alcaraz C.,1,164,130,34,2023-03-19,Indian Wells,BNP Paribas Open,Hard,2.1,1.73,0
Murray A.,44,932,687,245,Lajovic D.,66,378,163,215,2023-03-22,Miami,Miami Open,Hard,1.2,4.5,0
Edmund K.,473,233,113,120,Wu Y.,90,36,15,21,2023-03-22,Miami,Miami Open,Hard,6.0,1.13,0
Borges N.,69,28,10,18,Ruusuvuori E.,55,158,79,79,2023-03-22,Miami,Miami Open,Hard,3.2,1.36,0
Monfils G.,323,816,510,306,Humbert U.,36,170,80,90,2023-03-22,Miami,Miami Open,Hard,3.75,1.29,0
Ivashka I.,113,159,78,81,Altmaier D.,51,79,28,51,2023-03-22,Miami,Miami Open,Hard,1.53,2.5,1
Struff J.L.,21,369,170,199,Fognini F.,128,742,383,359,2023-03-22,Miami,Miami Open,Hard,1.29,3.75,1
Bublik A.,25,219,110,109,Wolf J.J.,45,75,39,36,2023-03-22,Miami,Miami Open,Hard,2.1,1.73,0
Otte O.,233,78,33,45,Nakashima B.,70,106,57,49,2023-03-22,Miami,Miami Open,Hard,3.4,1.33,0
Djere L.,38,243,120,123,Vukic A.,62,36,15,21,2023-03-22,Miami,Miami Open,Hard,2.2,1.67,1
Ramos-Vinolas A.,82,437,204,233,Huesler M.A.,88,58,21,37,2023-03-22,Miami,Miami Open,Hard,2.2,1.67,0
Bagnis F.,135,121,39,82,Meligeni Alves F.,177,3,1,2,2023-03-22,Miami,Miami Open,Hard,1.62,2.3,1
Ymer M.,59,130,58,72,Popyrin A.,90,140,59,81,2023-03-22,Miami,Miami Open,Hard,2.0,1.8,0
Cachin P.,54,52,23,29,Fucsovics M.,67,249,121,128,2023-03-22,Miami,Miami Open,Hard,4.33,1.22,0
Varillas J.P.,77,22,10,12,Pella G.,199,260,118,142,2023-03-22,Miami,Miami Open,Hard,2.0,1.8,0
Rinderknech A.,67,96,46,50,Daniel T.,111,178,67,111,2023-03-22,Miami,Miami Open,Hard,2.75,1.44,0
Etcheverry T.,34,60,26,34,Kotov P.,89,25,10,15,2023-03-23,Miami,Miami Open,Hard,1.8,2.0,1
Safiullin R.,92,42,20,22,Barrere G.,59,79,31,48,2023-03-23,Miami,Miami Open,Hard,1.62,2.3,0
Kubler J.,77,53,24,29,Monteiro T.,121,171,69,102,2023-03-23,Miami,Miami Open,Hard,1.4,3.0,0
O Connell C.,74,65,26,39,Gasquet R.,48,948,581,367,2023-03-23,Miami,Miami Open,Hard,2.0,1.8,0
Watanuki Y.,99,25,11,14,Paire B.,149,527,237,290,2023-03-23,Miami,Miami Open,Hard,1.62,2.3,1
Galan D.E.,76,78,33,45,Mcdonald M.,60,190,87,103,2023-03-23,Miami,Miami Open,Hard,6.5,1.11,0
Eubanks C.,29,64,28,36,Kudla D.,137,198,70,128,2023-03-23,Miami,Miami Open,Hard,1.67,2.2,1
Sonego L.,43,221,107,114,Thiem D.,116,517,327,190,2023-03-23,Miami,Miami Open,Hard,1.62,2.3,1
Molcan A.,120,86,45,41,Thompson J.,71,221,96,125,2023-03-23,Miami,Miami Open,Hard,2.3,1.62,1
Mannarino A.,27,567,264,303,Shang J.,149,12,4,8,2023-03-23,Miami,Miami Open,Hard,1.36,3.2,1
Giron M.,69,150,68,82,Garin C.,101,190,103,87,2023-03-23,Miami,Miami Open,Hard,2.1,1.73,0
Martinez P.,135,118,50,68,Halys Q.,79,72,23,49,2023-03-23,Miami,Miami Open,Hard,3.4,1.33,0
Lehecka J.,33,61,30,31,Coria F.,108,99,43,56,2023-03-23,Miami,Miami Open,Hard,1.1,7.0,1
Munar J.,104,178,75,103,Kovacevic A.,129,14,6,8,2023-03-23,Miami,Miami Open,Hard,2.5,1.53,0
Nava E.,242,13,2,11,Isner J.,114,755,465,290,2023-03-23,Miami,Miami Open,Hard,4.0,1.25,1
Carballes Baena R.,64,207,91,116,Zapata Miralles B.,54,80,32,48,2023-03-23,Miami,Miami Open,Hard,2.1,1.73,1
Fucsovics M.,67,249,121,128,Rune H.,6,131,83,48,2023-03-24,Miami,Miami Open,Hard,3.4,1.33,0
Ivashka I.,113,159,78,81,Ruud C.,4,275,176,99,2023-03-24,Miami,Miami Open,Hard,3.0,1.4,0
Lajovic D.,66,378,163,215,Cressy M.,96,96,42,54,2023-03-24,Miami,Miami Open,Hard,2.38,1.57,1
Nakashima B.,70,106,57,49,Davidovich Fokina A.,39,168,84,84,2023-03-24,Miami,Miami Open,Hard,2.38,1.57,0
Alcaraz C.,1,164,130,34,Bagnis F.,135,121,39,82,2023-03-24,Miami,Miami Open,Hard,1.01,23.0,1
Dimitrov G.,20,651,389,262,Struff J.L.,21,369,170,199,2023-03-24,Miami,Miami Open,Hard,1.44,2.75,1
Kecmanovic M.,40,210,107,103,Humbert U.,36,170,80,90,2023-03-24,Miami,Miami Open,Hard,1.91,1.91,1
Nava E.,242,13,2,11,Fritz T.,9,356,205,151,2023-03-24,Miami,Miami Open,Hard,10.0,1.06,0
Paul T.,14,204,111,93,Huesler M.A.,88,58,21,37,2023-03-24,Miami,Miami Open,Hard,1.17,5.0,1
Schwartzman D.,95,428,233,195,Wu Y.,90,36,15,21,2023-03-24,Miami,Miami Open,Hard,2.75,1.44,1
Djere L.,38,243,120,123,Sinner J.,8,224,153,71,2023-03-24,Miami,Miami Open,Hard,9.0,1.07,0
Rublev A.,7,392,255,137,Wolf J.J.,45,75,39,36,2023-03-24,Miami,Miami Open,Hard,1.25,4.0,1
Pella G.,199,260,118,142,Shapovalov D.,29,298,166,132,2023-03-24,Miami,Miami Open,Hard,4.33,1.22,0
Bergs Z.,175,15,4,11,Kokkinakis T.,86,124,55,69,2023-03-24,Miami,Miami Open,Hard,5.0,1.17,0
Popyrin A.,90,140,59,81,Van De Zandschulp B.,44,117,63,54,2023-03-24,Miami,Miami Open,Hard,2.1,1.73,0
Ruusuvuori E.,55,158,79,79,Bautista Agut R.,25,379,234,145,2023-03-24,Miami,Miami Open,Hard,1.73,2.1,1
Carballes Baena R.,64,207,91,116,Medvedev D.,3,406,289,117,2023-03-25,Miami,Miami Open,Hard,19.0,1.02,0
Molcan A.,120,86,45,41,Nishioka Y.,31,215,99,116,2023-03-25,Miami,Miami Open,Hard,2.0,1.8,1
Etcheverry T.,34,60,26,34,Khachanov K.,11,378,217,161,2023-03-25,Miami,Miami Open,Hard,3.5,1.3,0
Kokkinakis T.,86,124,55,69,Hurkacz H.,17,238,137,101,2023-03-25,Miami,Miami Open,Hard,3.5,1.3,0
Evans D.,30,251,124,127,Sonego L.,43,221,107,114,2023-03-25,Miami,Miami Open,Hard,2.75,1.44,0
Auger-Aliassime F.,12,268,163,105,Monteiro T.,121,171,69,102,2023-03-25,Miami,Miami Open,Hard,1.07,9.0,1
Halys Q.,79,72,23,49,De Minaur A.,19,272,161,111,2023-03-25,Miami,Miami Open,Hard,3.5,1.3,1
Mcdonald M.,60,190,87,103,Berrettini M.,38,217,142,75,2023-03-25,Miami,Miami Open,Hard,2.75,1.44,1
Lehecka J.,33,61,30,31,Musetti L.,18,143,79,64,2023-03-25,Miami,Miami Open,Hard,1.4,3.0,1
Tsitsipas S.,5,390,264,126,Gasquet R.,48,948,581,367,2023-03-25,Miami,Miami Open,Hard,1.17,5.0,1
Eubanks C.,29,64,28,36,Coric B.,15,343,185,158,2023-03-25,Miami,Miami Open,Hard,3.2,1.36,1
Kovacevic A.,129,14,6,8,Cerundolo F.,21,104,58,46,2023-03-25,Miami,Miami Open,Hard,2.2,1.67,0
Zverev A.,19,500,346,154,Daniel T.,111,178,67,111,2023-03-25,Miami,Miami Open,Hard,1.2,4.5,0
Baez S.,72,95,47,48,Garin C.,101,190,103,87,2023-03-25,Miami,Miami Open,Hard,2.5,1.53,0
Alcaraz C.,1,164,130,34,Lajovic D.,66,378,163,215,2023-03-26,Miami,Miami Open,Hard,1.03,15.0,1
Daniel T.,111,178,67,111,Ruusuvuori E.,55,158,79,79,2023-03-26,Miami,Miami Open,Hard,2.38,1.57,0
Rublev A.,7,392,255,137,Kecmanovic M.,40,210,107,103,2023-03-26,Miami,Miami Open,Hard,1.22,4.33,1
Shapovalov D.,29,298,166,132,Fritz T.,9,356,205,151,2023-03-26,Miami,Miami Open,Hard,3.2,1.36,0
Davidovich Fokina A.,39,168,84,84,Paul T.,14,204,111,93,2023-03-26,Miami,Miami Open,Hard,2.3,1.62,0
Mannarino A.,27,567,264,303,Shelton B.,43,34,13,21,2023-03-26,Miami,Miami Open,Hard,2.2,1.67,1
Barrere G.,59,79,31,48,Norrie C.,13,287,172,115,2023-03-26,Miami,Miami Open,Hard,6.0,1.13,1
Watanuki Y.,99,25,11,14,Tiafoe F.,10,303,158,145,2023-03-26,Miami,Miami Open,Hard,5.0,1.17,0
Rune H.,6,131,83,48,Schwartzman D.,95,428,233,195,2023-03-26,Miami,Miami Open,Hard,1.17,5.0,1
Mcdonald M.,60,190,87,103,Halys Q.,79,72,23,49,2023-03-27,Miami,Miami Open,Hard,1.57,2.38,0
Eubanks C.,29,64,28,36,Barrere G.,59,79,31,48,2023-03-27,Miami,Miami Open,Hard,2.1,1.73,1
Cerundolo F.,21,104,58,46,Auger-Aliassime F.,12,268,163,105,2023-03-27,Miami,Miami Open,Hard,4.33,1.22,1
Tsitsipas S.,5,390,264,126,Garin C.,101,190,103,87,2023-03-27,Miami,Miami Open,Hard,1.3,3.5,1
Hurkacz H.,17,238,137,101,Mannarino A.,27,567,264,303,2023-03-27,Miami,Miami Open,Hard,1.25,4.0,0
Medvedev D.,3,406,289,117,Molcan A.,120,86,45,41,2023-03-27,Miami,Miami Open,Hard,1.05,11.0,1
Ruud C.,4,275,176,99,Van De Zandschulp B.,44,117,63,54,2023-03-27,Miami,Miami Open,Hard,1.3,3.5,0
Sinner J.,8,224,153,71,Dimitrov G.,20,651,389,262,2023-03-27,Miami,Miami Open,Hard,1.22,4.33,1
Lehecka J.,33,61,30,31,Khachanov K.,11,378,217,161,2023-03-27,Miami,Miami Open,Hard,2.1,1.73,0
Tiafoe F.,10,303,158,145,Sonego L.,43,221,107,114,2023-03-28,Miami,Miami Open,Hard,1.33,3.4,0
Sinner J.,8,224,153,71,Rublev A.,7,392,255,137,2023-03-28,Miami,Miami Open,Hard,1.5,2.63,1
Rune H.,6,131,83,48,Fritz T.,9,356,205,151,2023-03-28,Miami,Miami Open,Hard,2.3,1.62,0
Van De Zandschulp B.,44,117,63,54,Ruusuvuori E.,55,158,79,79,2023-03-28,Miami,Miami Open,Hard,2.2,1.67,0
Alcaraz C.,1,164,130,34,Paul T.,14,204,111,93,2023-03-28,Miami,Miami Open,Hard,1.13,6.0,1
Khachanov K.,11,378,217,161,Tsitsipas S.,5,390,264,126,2023-03-28,Miami,Miami Open,Hard,1.91,1.91,1
Eubanks C.,29,64,28,36,Mannarino A.,27,567,264,303,2023-03-28,Miami,Miami Open,Hard,2.5,1.53,1
Ruusuvuori E.,55,158,79,79,Sinner J.,8,224,153,71,2023-03-29,Miami,Miami Open,Hard,6.0,1.13,0
Medvedev D.,3,406,289,117,Halys Q.,79,72,23,49,2023-03-29,Miami,Miami Open,Hard,1.07,9.0,1
Cerundolo F.,21,104,58,46,Sonego L.,43,221,107,114,2023-03-29,Miami,Miami Open,Hard,2.3,1.62,1
Medvedev D.,3,406,289,117,Eubanks C.,29,64,28,36,2023-03-30,Miami,Miami Open,Hard,1.04,13.0,1
Khachanov K.,11,378,217,161,Cerundolo F.,21,104,58,46,2023-03-30,Miami,Miami Open,Hard,1.36,3.2,1
Alcaraz C.,1,164,130,34,Fritz T.,9,356,205,151,2023-03-31,Miami,Miami Open,Hard,1.22,4.33,1
Medvedev D.,3,406,289,117,Khachanov K.,11,378,217,161,2023-03-31,Miami,Miami Open,Hard,1.2,4.5,1
Alcaraz C.,1,164,130,34,Sinner J.,8,224,153,71,2023-04-01,Miami,Miami Open,Hard,1.4,3.0,0
Sinner J.,8,224,153,71,Medvedev D.,3,406,289,117,2023-04-02,Miami,Miami Open,Hard,1.91,1.91,0
Munar J.,104,178,75,103,Benchetrit E.,445,8,1,7,2023-04-03,Marrakech,Grand Prix Hassan II,Clay,1.1,7.0,1
Brouwer G.,144,21,11,10,Kovacevic A.,129,14,6,8,2023-04-03,Houston,U.S. Men's Clay Court Championships,Clay,1.91,1.91,1
Gaston H.,109,58,24,34,Struff J.L.,21,369,170,199,2023-04-03,Marrakech,Grand Prix Hassan II,Clay,2.5,1.53,1
Karatsev A.,75,136,66,70,Passaro F.,126,10,3,7,2023-04-03,Marrakech,Grand Prix Hassan II,Clay,1.73,2.1,0
Popyrin A.,90,140,59,81,Lalami Laaroussi Y.,937,1,0,1,2023-04-03,Marrakech,Grand Prix Hassan II,Clay,1.03,15.0,1
Zhang Zh.,53,44,20,24,Galan D.E.,76,78,33,45,2023-04-03,Houston,U.S. Men's Clay Court Championships,Clay,1.67,2.2,0
Albot R.,97,215,86,129,Baez S.,72,95,47,48,2023-04-03,Estoril,Estoril Open,Clay,5.5,1.14,0
Kudla D.,137,198,70,128,Vukic A.,62,36,15,21,2023-04-03,Houston,U.S. Men's Clay Court Championships,Clay,3.2,1.36,1
Cachin P.,54,52,23,29,Tseng C.H.,145,9,1,8,2023-04-03,Estoril,Estoril Open,Clay,1.62,2.3,1
Fognini F.,128,742,383,359,Giannessi A.,224,35,12,23,2023-04-03,Estoril,Estoril Open,Clay,1.5,2.63,1
Schwartzman D.,95,428,233,195,Cecchinato M.,108,204,79,125,2023-04-03,Estoril,Estoril Open,Clay,1.36,3.2,0
Verdasco F.,244,962,537,425,Kubler J.,77,53,24,29,2023-04-04,Houston,U.S. Men's Clay Court Championships,Clay,4.33,1.22,0
Watanuki Y.,99,25,11,14,Hanfmann Y.,50,99,50,49,2023-04-04,Houston,U.S. Men's Clay Court Championships,Clay,2.75,1.44,0
Wolf J.J.,45,75,39,36,Thompson J.,71,221,96,125,2023-04-04,Houston,U.S. Men's Clay Court Championships,Clay,1.73,2.1,1
Etcheverry T.,34,60,26,34,Cerundolo J.M.,106,29,12,17,2023-04-04,Houston,U.S. Men's Clay Court Championships,Clay,1.44,2.75,1
Ymer E.,186,81,24,57,Moundir A.,720,1,0,1,2023-04-04,Marrakech,Grand Prix Hassan II,Clay,1.13,6.0,1
Bonadio R.,181,3,1,2,O Connell C.,74,65,26,39,2023-04-04,Marrakech,Grand Prix Hassan II,Clay,2.1,1.73,0
Gasquet R.,48,948,581,367,Muller A.,81,22,9,13,2023-04-04,Marrakech,Grand Prix Hassan II,Clay,1.67,2.2,0
Jarry N.,28,141,73,68,Vavassori A.,128,12,5,7,2023-04-04,Marrakech,Grand Prix Hassan II,Clay,1.36,3.2,0
Cressy M.,96,96,42,54,Carballes Baena R.,64,207,91,116,2023-04-04,Marrakech,Grand Prix Hassan II,Clay,2.5,1.53,0
Kotov P.,89,25,10,15,Martinez P.,135,118,50,68,2023-04-04,Marrakech,Grand Prix Hassan II,Clay,2.0,1.8,1
Kuzmanov D.,207,12,4,8,Grenier H.,122,16,5,11,2023-04-04,Marrakech,Grand Prix Hassan II,Clay,1.53,2.5,1
Giron M.,69,150,68,82,Gomez E.,155,26,7,19,2023-04-04,Houston,U.S. Men's Clay Court Championships,Clay,1.36,3.2,1
Garin C.,101,190,103,87,Dellien H.,164,70,22,48,2023-04-04,Houston,U.S. Men's Clay Court Championships,Clay,1.53,2.5,1
Bagnis F.,135,121,39,82,Johnson S.,197,395,196,199,2023-04-04,Houston,U.S. Men's Clay Court Championships,Clay,1.5,2.63,0
Rodionov J.,118,26,9,17,Ramos-Vinolas A.,82,437,204,233,2023-04-04,Estoril,Estoril Open,Clay,3.5,1.3,1
Nardi L.,151,11,2,9,Kecmanovic M.,40,210,107,103,2023-04-04,Estoril,Estoril Open,Clay,3.75,1.29,0
Lestienne C.,109,40,13,27,Shelton B.,43,34,13,21,2023-04-04,Estoril,Estoril Open,Clay,2.38,1.57,0
Sousa P.,475,36,9,27,Van Assche L.,68,20,7,13,2023-04-04,Estoril,Estoril Open,Clay,3.4,1.33,0
Ofner S.,61,34,16,18,Thiem D.,116,517,327,190,2023-04-04,Estoril,Estoril Open,Clay,2.3,1.62,0
Rocha H.,596,1,0,1,Zapata Miralles B.,54,80,32,48,2023-04-04,Estoril,Estoril Open,Clay,4.5,1.2,0
Halys Q.,79,72,23,49,Borges N.,69,28,10,18,2023-04-04,Estoril,Estoril Open,Clay,2.38,1.57,1
Sousa J.,147,436,189,247,Zeppieri G.,129,13,4,9,2023-04-04,Estoril,Estoril Open,Clay,2.5,1.53,1
Cachin P.,54,52,23,29,Baez S.,72,95,47,48,2023-04-05,Estoril,Estoril Open,Clay,3.2,1.36,0
Fognini F.,128,742,383,359,Cecchinato M.,108,204,79,125,2023-04-05,Estoril,Estoril Open,Clay,1.57,2.38,0
Vatutin A.,295,8,2,6,Bonzi B.,107,83,37,46,2023-04-05,Marrakech,Grand Prix Hassan II,Clay,3.2,1.36,0
Van Assche L.,68,20,7,13,Davidovich Fokina A.,39,168,84,84,2023-04-05,Estoril,Estoril Open,Clay,3.0,1.4,0
Machac T.,108,18,6,12,Sock J.,166,324,177,147,2023-04-05,Houston,U.S. Men's Clay Court Championships,Clay,1.4,3.0,1
Sousa J.,147,436,189,247,Ruud C.,4,275,176,99,2023-04-05,Estoril,Estoril Open,Clay,6.5,1.11,0
Munar J.,104,178,75,103,Vavassori A.,128,12,5,7,2023-04-06,Marrakech,Grand Prix Hassan II,Clay,1.5,2.63,0
Ymer E.,186,81,24,57,Griekspoor T.,37,97,47,50,2023-04-06,Marrakech,Grand Prix Hassan II,Clay,4.0,1.25,0
Van De Zandschulp B.,44,117,63,54,O Connell C.,74,65,26,39,2023-04-06,Marrakech,Grand Prix Hassan II,Clay,1.5,2.63,0
Kuzmanov D.,207,12,4,8,Carballes Baena R.,64,207,91,116,2023-04-06,Marrakech,Grand Prix Hassan II,Clay,3.0,1.4,1
Evans D.,30,251,124,127,Popyrin A.,90,140,59,81,2023-04-06,Marrakech,Grand Prix Hassan II,Clay,2.2,1.67,1
Bonzi B.,107,83,37,46,Kotov P.,89,25,10,15,2023-04-06,Marrakech,Grand Prix Hassan II,Clay,1.57,2.38,0
Muller A.,81,22,9,13,Passaro F.,126,10,3,7,2023-04-06,Marrakech,Grand Prix Hassan II,Clay,1.57,2.38,1
Rodionov J.,118,26,9,17,Kecmanovic M.,40,210,107,103,2023-04-06,Estoril,Estoril Open,Clay,3.2,1.36,0
Shelton B.,43,34,13,21,Thiem D.,116,517,327,190,2023-04-06,Estoril,Estoril Open,Clay,2.2,1.67,0
Zapata Miralles B.,54,80,32,48,Hurkacz H.,17,238,137,101,2023-04-06,Estoril,Estoril Open,Clay,3.0,1.4,1
Bautista Agut R.,25,379,234,145,Halys Q.,79,72,23,49,2023-04-06,Estoril,Estoril Open,Clay,1.57,2.38,0
Musetti L.,18,143,79,64,Gaston H.,109,58,24,34,2023-04-06,Marrakech,Grand Prix Hassan II,Clay,1.57,2.38,1
Purcell M.,78,28,9,19,Altmaier D.,51,79,28,51,2023-04-07,Houston,U.S. Men's Clay Court Championships,Clay,3.5,1.3,1
Musetti L.,18,143,79,64,Muller A.,81,22,9,13,2023-04-07,Marrakech,Grand Prix Hassan II,Clay,1.4,3.0,0
Vavassori A.,128,12,5,7,Evans D.,30,251,124,127,2023-04-07,Marrakech,Grand Prix Hassan II,Clay,2.3,1.62,0
Davidovich Fokina A.,39,168,84,84,Cecchinato M.,108,204,79,125,2023-04-07,Estoril,Estoril Open,Clay,1.22,4.33,0
Zapata Miralles B.,54,80,32,48,Kecmanovic M.,40,210,107,103,2023-04-07,Estoril,Estoril Open,Clay,2.3,1.62,0
Thiem D.,116,517,327,190,Halys Q.,79,72,23,49,2023-04-07,Estoril,Estoril Open,Clay,1.73,2.1,0
Baez S.,72,95,47,48,Ruud C.,4,275,176,99,2023-04-07,Estoril,Estoril Open,Clay,2.75,1.44,0
Griekspoor T.,37,97,47,50,Carballes Baena R.,64,207,91,116,2023-04-07,Marrakech,Grand Prix Hassan II,Clay,1.57,2.38,0
Kotov P.,89,25,10,15,O Connell C.,74,65,26,39,2023-04-07,Marrakech,Grand Prix Hassan II,Clay,2.1,1.73,1
Ruud C.,4,275,176,99,Halys Q.,79,72,23,49,2023-04-08,Estoril,Estoril Open,Clay,1.22,4.33,1
Kotov P.,89,25,10,15,Muller A.,81,22,9,13,2023-04-08,Marrakech,Grand Prix Hassan II,Clay,2.5,1.53,0
Cecchinato M.,108,204,79,125,Kecmanovic M.,40,210,107,103,2023-04-08,Estoril,Estoril Open,Clay,3.5,1.3,0
Isner J.,114,755,465,290,Brouwer G.,144,21,11,10,2023-04-08,Houston,U.S. Men's Clay Court Championships,Clay,1.53,2.5,0
Kudla D.,137,198,70,128,Wolf J.J.,45,75,39,36,2023-04-08,Houston,U.S. Men's Clay Court Championships,Clay,3.2,1.36,0
Kubler J.,77,53,24,29,Galan D.E.,76,78,33,45,2023-04-08,Houston,U.S. Men's Clay Court Championships,Clay,1.8,2.0,1
Tiafoe F.,10,303,158,145,Johnson S.,197,395,196,199,2023-04-08,Houston,U.S. Men's Clay Court Championships,Clay,1.17,5.0,1
Carballes Baena R.,64,207,91,116,Evans D.,30,251,124,127,2023-04-08,Marrakech,Grand Prix Hassan II,Clay,1.8,2.0,1
Garin C.,101,190,103,87,Bergs Z.,175,15,4,11,2023-04-08,Houston,U.S. Men's Clay Court Championships,Clay,1.2,4.5,1
Paul T.,14,204,111,93,Hanfmann Y.,50,99,50,49,2023-04-08,Houston,U.S. Men's Clay Court Championships,Clay,1.53,2.5,0
Giron M.,69,150,68,82,Machac T.,108,18,6,12,2023-04-08,Houston,U.S. Men's Clay Court Championships,Clay,2.2,1.67,0
Tiafoe F.,10,303,158,145,Kubler J.,77,53,24,29,2023-04-08,Houston,U.S. Men's Clay Court Championships,Clay,1.4,3.0,1
Brouwer G.,144,21,11,10,Wolf J.J.,45,75,39,36,2023-04-08,Houston,U.S. Men's Clay Court Championships,Clay,2.63,1.5,1
Etcheverry T.,34,60,26,34,Garin C.,101,190,103,87,2023-04-08,Houston,U.S. Men's Clay Court Championships,Clay,2.2,1.67,1
Purcell M.,78,28,9,19,Etcheverry T.,34,60,26,34,2023-04-08,Houston,U.S. Men's Clay Court Championships,Clay,3.2,1.36,0
Munar J.,104,178,75,103,Huesler M.A.,88,58,21,37,2023-04-09,Monte Carlo,Monte Carlo Masters,Clay,1.53,2.5,1
Jarry N.,28,141,73,68,Coric B.,15,343,185,158,2023-04-09,Monte Carlo,Monte Carlo Masters,Clay,2.0,1.8,1
Carballes Baena R.,64,207,91,116,Muller A.,81,22,9,13,2023-04-09,Marrakech,Grand Prix Hassan II,Clay,1.73,2.1,1
Hurkacz H.,17,238,137,101,Djere L.,38,243,120,123,2023-04-09,Monte Carlo,Monte Carlo Masters,Clay,1.5,2.63,1
Etcheverry T.,34,60,26,34,Hanfmann Y.,50,99,50,49,2023-04-09,Houston,U.S. Men's Clay Court Championships,Clay,1.8,2.0,1
Brouwer G.,144,21,11,10,Tiafoe F.,10,303,158,145,2023-04-09,Houston,U.S. Men's Clay Court Championships,Clay,3.75,1.29,0
Hanfmann Y.,50,99,50,49,Machac T.,108,18,6,12,2023-04-09,Houston,U.S. Men's Clay Court Championships,Clay,1.8,2.0,1
Kecmanovic M.,40,210,107,103,Ruud C.,4,275,176,99,2023-04-09,Estoril,Estoril Open,Clay,2.75,1.44,0
Tiafoe F.,10,303,158,145,Etcheverry T.,34,60,26,34,2023-04-09,Houston,U.S. Men's Clay Court Championships,Clay,1.4,3.0,1
Krajinovic F.,93,240,115,125,Bautista Agut R.,25,379,234,145,2023-04-10,Monte Carlo,Monte Carlo Masters,Clay,2.63,1.5,0
De Minaur A.,19,272,161,111,Murray A.,44,932,687,245,2023-04-10,Monte Carlo,Monte Carlo Masters,Clay,1.53,2.5,1
Goffin D.,123,522,296,226,Schwartzman D.,95,428,233,195,2023-04-10,Monte Carlo,Monte Carlo Masters,Clay,2.3,1.62,0
Mcdonald M.,60,190,87,103,Gakhov I.,198,3,1,2,2023-04-10,Monte Carlo,Monte Carlo Masters,Clay,1.57,2.38,0
Berrettini M.,38,217,142,75,Cressy M.,96,96,42,54,2023-04-10,Monte Carlo,Monte Carlo Masters,Clay,1.22,4.33,1
Ramos-Vinolas A.,82,437,204,233,Struff J.L.,21,369,170,199,2023-04-10,Monte Carlo,Monte Carlo Masters,Clay,2.38,1.57,0
Thiem D.,116,517,327,190,Gasquet R.,48,948,581,367,2023-04-10,Monte Carlo,Monte Carlo Masters,Clay,1.57,2.38,1
Draper J.,55,51,29,22,Baez S.,72,95,47,48,2023-04-10,Monte Carlo,Monte Carlo Masters,Clay,2.75,1.44,1
Norrie C.,13,287,172,115,Cerundolo F.,21,104,58,46,2023-04-10,Monte Carlo,Monte Carlo Masters,Clay,1.53,2.5,0
Bonzi B.,107,83,37,46,Zapata Miralles B.,54,80,32,48,2023-04-10,Monte Carlo,Monte Carlo Masters,Clay,2.75,1.44,1
Griekspoor T.,37,97,47,50,Wawrinka S.,72,854,535,319,2023-04-10,Monte Carlo,Monte Carlo Masters,Clay,1.8,2.0,0
Van De Zandschulp B.,44,117,63,54,Fucsovics M.,67,249,121,128,2023-04-10,Monte Carlo,Monte Carlo Masters,Clay,2.2,1.67,1
Lajovic D.,66,378,163,215,Popyrin A.,90,140,59,81,2023-04-10,Monte Carlo,Monte Carlo Masters,Clay,1.44,2.75,0
Tsitsipas S.,5,390,264,126,Bonzi B.,107,83,37,46,2023-04-11,Monte Carlo,Monte Carlo Masters,Clay,1.17,5.0,1
Draper J.,55,51,29,22,Hurkacz H.,17,238,137,101,2023-04-11,Monte Carlo,Monte Carlo Masters,Clay,2.38,1.57,0
Gakhov I.,198,3,1,2,Djokovic N.,2,1207,1012,195,2023-04-11,Monte Carlo,Monte Carlo Masters,Clay,19.0,1.02,0
Munar J.,104,178,75,103,Rublev A.,7,392,255,137,2023-04-11,Monte Carlo,Monte Carlo Masters,Clay,4.5,1.2,0
Evans D.,30,251,124,127,Ivashka I.,113,159,78,81,2023-04-11,Monte Carlo,Monte Carlo Masters,Clay,2.2,1.67,0
Musetti L.,18,143,79,64,Kecmanovic M.,40,210,107,103,2023-04-11,Monte Carlo,Monte Carlo Masters,Clay,1.8,2.0,1
Nardi L.,151,11,2,9,Vacherot V.,357,1,0,1,2023-04-11,Monte Carlo,Monte Carlo Masters,Clay,1.29,3.75,1
Zverev A.,19,500,346,154,Bublik A.,25,219,110,109,2023-04-11,Monte Carlo,Monte Carlo Masters,Clay,1.14,5.5,1
Sonego L.,43,221,107,114,Humbert U.,36,170,80,90,2023-04-11,Monte Carlo,Monte Carlo Masters,Clay,1.5,2.63,1
Shelton B.,43,34,13,21,Dimitrov G.,20,651,389,262,2023-04-11,Monte Carlo,Monte Carlo Masters,Clay,4.5,1.2,0
Ruusuvuori E.,55,158,79,79,Lehecka J.,33,61,30,31,2023-04-11,Monte Carlo,Monte Carlo Masters,Clay,2.38,1.57,0
Davidovich Fokina A.,39,168,84,84,Khachanov K.,11,378,217,161,2023-04-11,Monte Carlo,Monte Carlo Masters,Clay,1.91,1.91,0
Khachanov K.,11,378,217,161,Ivashka I.,113,159,78,81,2023-04-12,Monte Carlo,Monte Carlo Masters,Clay,1.22,4.33,1
Thiem D.,116,517,327,190,Rune H.,6,131,83,48,2023-04-12,Monte Carlo,Monte Carlo Masters,Clay,2.75,1.44,0
Berrettini M.,38,217,142,75,Cerundolo F.,21,104,58,46,2023-04-12,Monte Carlo,Monte Carlo Masters,Clay,1.8,2.0,1
Wawrinka S.,72,854,535,319,Fritz T.,9,356,205,151,2023-04-12,Monte Carlo,Monte Carlo Masters,Clay,2.63,1.5,0
Sonego L.,43,221,107,114,Medvedev D.,3,406,289,117,2023-04-12,Monte Carlo,Monte Carlo Masters,Clay,3.4,1.33,0
Sinner J.,8,224,153,71,Schwartzman D.,95,428,233,195,2023-04-12,Monte Carlo,Monte Carlo Masters,Clay,1.11,6.5,1
Jarry N.,28,141,73,68,Popyrin A.,90,140,59,81,2023-04-12,Monte Carlo,Monte Carlo Masters,Clay,1.33,3.4,1
Nardi L.,151,11,2,9,Musetti L.,18,143,79,64,2023-04-12,Monte Carlo,Monte Carlo Masters,Clay,4.5,1.2,0
Struff J.L.,21,369,170,199,De Minaur A.,19,272,161,111,2023-04-12,Monte Carlo,Monte Carlo Masters,Clay,2.38,1.57,1
Ruud C.,4,275,176,99,Van De Zandschulp B.,44,117,63,54,2023-04-12,Monte Carlo,Monte Carlo Masters,Clay,1.2,4.5,1
Bautista Agut R.,25,379,234,145,Zverev A.,19,500,346,154,2023-04-12,Monte Carlo,Monte Carlo Masters,Clay,3.0,1.4,0
Dimitrov G.,20,651,389,262,Lehecka J.,33,61,30,31,2023-04-12,Monte Carlo,Monte Carlo Masters,Clay,1.73,2.1,0
Sinner J.,8,224,153,71,Hurkacz H.,17,238,137,101,2023-04-13,Monte Carlo,Monte Carlo Masters,Clay,1.22,4.33,1
Struff J.L.,21,369,170,199,Ruud C.,4,275,176,99,2023-04-13,Monte Carlo,Monte Carlo Masters,Clay,3.5,1.3,1
Khachanov K.,11,378,217,161,Rublev A.,7,392,255,137,2023-04-13,Monte Carlo,Monte Carlo Masters,Clay,1.91,1.91,0
Tsitsipas S.,5,390,264,126,Jarry N.,28,141,73,68,2023-04-13,Monte Carlo,Monte Carlo Masters,Clay,1.25,4.0,1
Lehecka J.,33,61,30,31,Fritz T.,9,356,205,151,2023-04-13,Monte Carlo,Monte Carlo Masters,Clay,2.3,1.62,0
Musetti L.,18,143,79,64,Djokovic N.,2,1207,1012,195,2023-04-13,Monte Carlo,Monte Carlo Masters,Clay,5.0,1.17,1
Berrettini M.,38,217,142,75,Rune H.,6,131,83,48,2023-04-13,Monte Carlo,Monte Carlo Masters,Clay,2.75,1.44,0
Zverev A.,19,500,346,154,Medvedev D.,3,406,289,117,2023-04-13,Monte Carlo,Monte Carlo Masters,Clay,2.38,1.57,0
Musetti L.,18,143,79,64,Sinner J.,8,224,153,71,2023-04-14,Monte Carlo,Monte Carlo Masters,Clay,3.4,1.33,0
Rune H.,6,131,83,48,Medvedev D.,3,406,289,117,2023-04-14,Monte Carlo,Monte Carlo Masters,Clay,1.73,2.1,1
Struff J.L.,21,369,170,199,Rublev A.,7,392,255,137,2023-04-14,Monte Carlo,Monte Carlo Masters,Clay,3.0,1.4,0
Tsitsipas S.,5,390,264,126,Fritz T.,9,356,205,151,2023-04-14,Monte Carlo,Monte Carlo Masters,Clay,1.33,3.4,0
Fritz T.,9,356,205,151,Rublev A.,7,392,255,137,2023-04-15,Monte Carlo,Monte Carlo Masters,Clay,1.91,1.91,0
Rune H.,6,131,83,48,Sinner J.,8,224,153,71,2023-04-15,Monte Carlo,Monte Carlo Masters,Clay,2.5,1.53,1
Rune H.,6,131,83,48,Rublev A.,7,392,255,137,2023-04-16,Monte Carlo,Monte Carlo Masters,Clay,1.53,2.5,0
Popyrin A.,90,140,59,81,Griekspoor T.,37,97,47,50,2023-04-17,Banja Luka,Srpska Open,Clay,2.5,1.53,1
Thompson J.,71,221,96,125,Cobolli F.,148,14,5,9,2023-04-17,Munich,BMW Open,Clay,2.3,1.62,0
Giron M.,69,150,68,82,Carballes Baena R.,64,207,91,116,2023-04-17,Munich,BMW Open,Clay,2.75,1.44,1
Daniel T.,111,178,67,111,Molcan A.,120,86,45,41,2023-04-17,Banja Luka,Srpska Open,Clay,1.73,2.1,0
Monteiro T.,121,171,69,102,Hanfmann Y.,50,99,50,49,2023-04-17,Munich,BMW Open,Clay,2.5,1.53,0
Van Assche L.,68,20,7,13,Wawrinka S.,72,854,535,319,2023-04-17,Banja Luka,Srpska Open,Clay,2.2,1.67,1
Martinez P.,135,118,50,68,Kovalik J.,172,68,24,44,2023-04-17,Barcelona,Barcelona Open,Clay,1.53,2.5,0
Ivashka I.,113,159,78,81,Borges N.,69,28,10,18,2023-04-17,Barcelona,Barcelona Open,Clay,1.57,2.38,0
Zapata Miralles B.,54,80,32,48,Balazs A.,745,33,16,17,2023-04-17,Barcelona,Barcelona Open,Clay,1.02,19.0,1
Trungelliti M.,240,33,13,20,Jarry N.,28,141,73,68,2023-04-17,Barcelona,Barcelona Open,Clay,4.33,1.22,0
Bublik A.,25,219,110,109,Ruusuvuori E.,55,158,79,79,2023-04-17,Barcelona,Barcelona Open,Clay,2.75,1.44,0
Etcheverry T.,34,60,26,34,Andujar P.,323,404,164,240,2023-04-17,Barcelona,Barcelona Open,Clay,1.13,6.0,1
Krutykh O.,180,3,0,3,Kotov P.,89,25,10,15,2023-04-17,Barcelona,Barcelona Open,Clay,2.63,1.5,0
Shelton B.,43,34,13,21,Mcdonald M.,60,190,87,103,2023-04-17,Barcelona,Barcelona Open,Clay,2.1,1.73,1
Prizmic D.,287,5,2,3,Gasquet R.,48,948,581,367,2023-04-18,Banja Luka,Srpska Open,Clay,2.2,1.67,0
Coria F.,108,99,43,56,Albot R.,97,215,86,129,2023-04-18,Banja Luka,Srpska Open,Clay,1.73,2.1,0
Djere L.,38,243,120,123,Safiullin R.,92,42,20,22,2023-04-18,Banja Luka,Srpska Open,Clay,1.3,3.5,1
Shelbayh A.,240,6,1,5,Ymer E.,186,81,24,57,2023-04-18,Banja Luka,Srpska Open,Clay,2.63,1.5,1
Otte O.,233,78,33,45,Baez S.,72,95,47,48,2023-04-18,Munich,BMW Open,Clay,2.75,1.44,1
Garin C.,101,190,103,87,Topo M.,478,4,0,4,2023-04-18,Munich,BMW Open,Clay,1.13,6.0,1
Fucsovics M.,67,249,121,128,Rehberg M.,412,3,0,3,2023-04-18,Munich,BMW Open,Clay,1.07,9.0,1
Huesler M.A.,88,58,21,37,Edmund K.,473,233,113,120,2023-04-18,Munich,BMW Open,Clay,1.36,3.2,1
Humbert U.,36,170,80,90,O Connell C.,74,65,26,39,2023-04-18,Munich,BMW Open,Clay,1.91,1.91,0
Ritschard A.,163,9,3,6,Struff J.L.,21,369,170,199,2023-04-18,Munich,BMW Open,Clay,6.0,1.13,1
Halys Q.,79,72,23,49,Sonego L.,43,221,107,114,2023-04-18,Munich,BMW Open,Clay,2.1,1.73,0
Thiem D.,116,517,327,190,Lestienne C.,109,40,13,27,2023-04-18,Munich,BMW Open,Clay,1.22,4.33,1
Lajovic D.,66,378,163,215,Krajinovic F.,93,240,115,125,2023-04-18,Banja Luka,Srpska Open,Clay,1.67,2.2,1
Giustino L.,223,8,1,7,Shevchenko A.,93,20,8,12,2023-04-18,Barcelona,Barcelona Open,Clay,3.4,1.33,0
Borges N.,69,28,10,18,Alcaraz C.,1,164,130,34,2023-04-18,Barcelona,Barcelona Open,Clay,11.0,1.05,0
Etcheverry T.,34,60,26,34,Davidovich Fokina A.,39,168,84,84,2023-04-18,Barcelona,Barcelona Open,Clay,2.38,1.57,0
Ruud C.,4,275,176,99,Shelton B.,43,34,13,21,2023-04-18,Barcelona,Barcelona Open,Clay,1.14,5.5,1
Kubler J.,77,53,24,29,Rincon D.,841,2,0,2,2023-04-18,Barcelona,Barcelona Open,Clay,1.3,3.5,1
Brouwer G.,144,21,11,10,Cachin P.,54,52,23,29,2023-04-18,Barcelona,Barcelona Open,Clay,2.5,1.53,0
Goffin D.,123,522,296,226,Lopez F.,634,863,441,422,2023-04-18,Barcelona,Barcelona Open,Clay,1.14,5.5,1
Gomez E.,155,26,7,19,Ramos-Vinolas A.,82,437,204,233,2023-04-18,Barcelona,Barcelona Open,Clay,5.5,1.14,1
Munar J.,104,178,75,103,Arnaldi M.,76,18,9,9,2023-04-18,Barcelona,Barcelona Open,Clay,1.44,2.75,0
Zapata Miralles B.,54,80,32,48,Bautista Agut R.,25,379,234,145,2023-04-18,Barcelona,Barcelona Open,Clay,2.2,1.67,0
Tiafoe F.,10,303,158,145,Ruusuvuori E.,55,158,79,79,2023-04-18,Barcelona,Barcelona Open,Clay,1.53,2.5,0
Wu Y.,90,36,15,21,Schwartzman D.,95,428,233,195,2023-04-18,Barcelona,Barcelona Open,Clay,2.75,1.44,0
Passaro F.,126,10,3,7,Verdasco F.,244,962,537,425,2023-04-18,Barcelona,Barcelona Open,Clay,1.33,3.4,1
Varillas J. P.,1345,20,9,11,Gaston H.,109,58,24,34,2023-04-19,Banja Luka,Srpska Open,Clay,1.62,2.3,1
Monfils G.,323,816,510,306,Lehecka J.,33,61,30,31,2023-04-19,Banja Luka,Srpska Open,Clay,5.0,1.17,0
Coric B.,15,343,185,158,Djere L.,38,243,120,123,2023-04-19,Banja Luka,Srpska Open,Clay,2.2,1.67,0
Djokovic N.,2,1207,1012,195,Van Assche L.,68,20,7,13,2023-04-19,Banja Luka,Srpska Open,Clay,1.06,10.0,1
Popyrin A.,90,140,59,81,Molcan A.,120,86,45,41,2023-04-19,Banja Luka,Srpska Open,Clay,2.0,1.8,0
Barrere G.,59,79,31,48,Medjedovic H.,147,11,3,8,2023-04-19,Banja Luka,Srpska Open,Clay,2.2,1.67,1
Dzumhur D.,202,234,107,127,Broady L.,125,47,18,29,2023-04-19,Banja Luka,Srpska Open,Clay,2.2,1.67,1
Khachanov K.,11,378,217,161,Jarry N.,28,141,73,68,2023-04-19,Barcelona,Barcelona Open,Clay,1.5,2.63,1
Kovalik J.,172,68,24,44,Shapovalov D.,29,298,166,132,2023-04-19,Barcelona,Barcelona Open,Clay,3.75,1.29,0
Tsitsipas S.,5,390,264,126,Cachin P.,54,52,23,29,2023-04-19,Barcelona,Barcelona Open,Clay,1.08,8.0,1
Arnaldi M.,76,18,9,9,Evans D.,30,251,124,127,2023-04-19,Barcelona,Barcelona Open,Clay,1.73,2.1,0
Musetti L.,18,143,79,64,Kubler J.,77,53,24,29,2023-04-19,Barcelona,Barcelona Open,Clay,1.22,4.33,1
Passaro F.,126,10,3,7,Cerundolo F.,21,104,58,46,2023-04-19,Barcelona,Barcelona Open,Clay,3.5,1.3,0
Norrie C.,13,287,172,115,Kotov P.,89,25,10,15,2023-04-19,Barcelona,Barcelona Open,Clay,1.25,4.0,1
De Minaur A.,19,272,161,111,Shevchenko A.,93,20,8,12,2023-04-19,Barcelona,Barcelona Open,Clay,1.44,2.75,1
Nishioka Y.,31,215,99,116,Goffin D.,123,522,296,226,2023-04-19,Barcelona,Barcelona Open,Clay,2.3,1.62,1
Sinner J.,8,224,153,71,Schwartzman D.,95,428,233,195,2023-04-19,Barcelona,Barcelona Open,Clay,1.08,8.0,1
Gomez E.,155,26,7,19,Dimitrov G.,20,651,389,262,2023-04-19,Barcelona,Barcelona Open,Clay,9.0,1.07,0
Cobolli F.,148,14,5,9,Otte O.,233,78,33,45,2023-04-20,Munich,BMW Open,Clay,2.75,1.44,1
Giron M.,69,150,68,82,Ritschard A.,163,9,3,6,2023-04-20,Munich,BMW Open,Clay,1.44,2.75,1
Garin C.,101,190,103,87,Sonego L.,43,221,107,114,2023-04-20,Munich,BMW Open,Clay,1.8,2.0,1
Zverev A.,19,500,346,154,O Connell C.,74,65,26,39,2023-04-20,Munich,BMW Open,Clay,1.14,5.5,0
Karatsev A.,75,136,66,70,Van De Zandschulp B.,44,117,63,54,2023-04-20,Munich,BMW Open,Clay,2.75,1.44,0
Fucsovics M.,67,249,121,128,Fritz T.,9,356,205,151,2023-04-20,Munich,BMW Open,Clay,3.5,1.3,0
Karatsev A.,75,136,66,70,Altmaier D.,51,79,28,51,2023-04-20,Munich,BMW Open,Clay,2.0,1.8,1
Rune H.,6,131,83,48,Hanfmann Y.,50,99,50,49,2023-04-20,Munich,BMW Open,Clay,1.29,3.75,1
Shelbayh A.,240,6,1,5,Kecmanovic M.,40,210,107,103,2023-04-20,Banja Luka,Srpska Open,Clay,4.5,1.2,0
Dimitrov G.,20,651,389,262,De Minaur A.,19,272,161,111,2023-04-20,Barcelona,Barcelona Open,Clay,1.8,2.0,0
Alcaraz C.,1,164,130,34,Bautista Agut R.,25,379,234,145,2023-04-20,Barcelona,Barcelona Open,Clay,1.06,10.0,1
Norrie C.,13,287,172,115,Musetti L.,18,143,79,64,2023-04-20,Barcelona,Barcelona Open,Clay,1.91,1.91,0
Tsitsipas S.,5,390,264,126,Shapovalov D.,29,298,166,132,2023-04-20,Barcelona,Barcelona Open,Clay,1.2,4.5,1
Ruusuvuori E.,55,158,79,79,Davidovich Fokina A.,39,168,84,84,2023-04-20,Barcelona,Barcelona Open,Clay,3.0,1.4,0
Lajovic D.,66,378,163,215,Barrere G.,59,79,31,48,2023-04-20,Banja Luka,Srpska Open,Clay,1.36,3.2,1
Sinner J.,8,224,153,71,Nishioka Y.,31,215,99,116,2023-04-20,Barcelona,Barcelona Open,Clay,1.05,11.0,1
Evans D.,30,251,124,127,Khachanov K.,11,378,217,161,2023-04-20,Barcelona,Barcelona Open,Clay,4.0,1.25,1
Gasquet R.,48,948,581,367,Dzumhur D.,202,234,107,127,2023-04-20,Banja Luka,Srpska Open,Clay,1.44,2.75,0
Lehecka J.,33,61,30,31,Albot R.,97,215,86,129,2023-04-20,Banja Luka,Srpska Open,Clay,1.22,4.33,1
Varillas J. P.,1345,20,9,11,Rublev A.,7,392,255,137,2023-04-20,Banja Luka,Srpska Open,Clay,5.0,1.17,0
Cerundolo F.,21,104,58,46,Ruud C.,4,275,176,99,2023-04-20,Barcelona,Barcelona Open,Clay,2.75,1.44,1
Huesler M.A.,88,58,21,37,Thiem D.,116,517,327,190,2023-04-21,Munich,BMW Open,Clay,3.4,1.33,0
Cobolli F.,148,14,5,9,O Connell C.,74,65,26,39,2023-04-21,Munich,BMW Open,Clay,2.75,1.44,0
Rune H.,6,131,83,48,Garin C.,101,190,103,87,2023-04-21,Munich,BMW Open,Clay,1.25,4.0,1
Thiem D.,116,517,327,190,Fritz T.,9,356,205,151,2023-04-21,Munich,BMW Open,Clay,2.5,1.53,0
Van De Zandschulp B.,44,117,63,54,Giron M.,69,150,68,82,2023-04-21,Munich,BMW Open,Clay,1.4,3.0,1
Djere L.,38,243,120,123,Molcan A.,120,86,45,41,2023-04-21,Banja Luka,Srpska Open,Clay,1.53,2.5,0
Tsitsipas S.,5,390,264,126,De Minaur A.,19,272,161,111,2023-04-21,Barcelona,Barcelona Open,Clay,1.22,4.33,1
Sinner J.,8,224,153,71,Musetti L.,18,143,79,64,2023-04-21,Barcelona,Barcelona Open,Clay,1.36,3.2,0
Rublev A.,7,392,255,137,Dzumhur D.,202,234,107,127,2023-04-21,Banja Luka,Srpska Open,Clay,1.06,10.0,1
Kecmanovic M.,40,210,107,103,Lehecka J.,33,61,30,31,2023-04-21,Banja Luka,Srpska Open,Clay,3.0,1.4,1
Lajovic D.,66,378,163,215,Djokovic N.,2,1207,1012,195,2023-04-21,Banja Luka,Srpska Open,Clay,8.0,1.08,1
Alcaraz C.,1,164,130,34,Davidovich Fokina A.,39,168,84,84,2023-04-21,Barcelona,Barcelona Open,Clay,1.08,8.0,1
Evans D.,30,251,124,127,Cerundolo F.,21,104,58,46,2023-04-21,Barcelona,Barcelona Open,Clay,3.4,1.33,1
Fritz T.,9,356,205,151,Van De Zandschulp B.,44,117,63,54,2023-04-22,Munich,BMW Open,Clay,1.44,2.75,0
Kecmanovic M.,40,210,107,103,Lajovic D.,66,378,163,215,2023-04-22,Banja Luka,Srpska Open,Clay,1.67,2.2,0
Rublev A.,7,392,255,137,Molcan A.,120,86,45,41,2023-04-22,Banja Luka,Srpska Open,Clay,1.17,5.0,1
Musetti L.,18,143,79,64,Tsitsipas S.,5,390,264,126,2023-04-22,Barcelona,Barcelona Open,Clay,3.4,1.33,0
Evans D.,30,251,124,127,Alcaraz C.,1,164,130,34,2023-04-22,Barcelona,Barcelona Open,Clay,11.0,1.05,0
O Connell C.,74,65,26,39,Rune H.,6,131,83,48,2023-04-22,Munich,BMW Open,Clay,4.5,1.2,0
Van De Zandschulp B.,44,117,63,54,Rune H.,6,131,83,48,2023-04-23,Munich,BMW Open,Clay,4.0,1.25,0
Tsitsipas S.,5,390,264,126,Alcaraz C.,1,164,130,34,2023-04-23,Barcelona,Barcelona Open,Clay,4.0,1.25,0
Lajovic D.,66,378,163,215,Rublev A.,7,392,255,137,2023-04-23,Banja Luka,Srpska Open,Clay,4.0,1.25,1
Landaluce M.,720,3,0,3,Gasquet R.,48,948,581,367,2023-04-26,Madrid,Mutua Madrid Open,Clay,5.5,1.14,0
Gojo B.,115,14,3,11,Monteiro T.,121,171,69,102,2023-04-26,Madrid,Mutua Madrid Open,Clay,1.91,1.91,0
Munar J.,104,178,75,103,Kokkinakis T.,86,124,55,69,2023-04-26,Madrid,Mutua Madrid Open,Clay,1.8,2.0,1
Humbert U.,36,170,80,90,Ruusuvuori E.,55,158,79,79,2023-04-26,Madrid,Mutua Madrid Open,Clay,2.63,1.5,0
Paire B.,149,527,237,290,Arnaldi M.,76,18,9,9,2023-04-26,Madrid,Mutua Madrid Open,Clay,2.5,1.53,0
Kotov P.,89,25,10,15,Otte O.,233,78,33,45,2023-04-26,Madrid,Mutua Madrid Open,Clay,2.1,1.73,0
Schwartzman D.,95,428,233,195,Grenier H.,122,16,5,11,2023-04-26,Madrid,Mutua Madrid Open,Clay,1.25,4.0,0
Cressy M.,96,96,42,54,Wawrinka S.,72,854,535,319,2023-04-26,Madrid,Mutua Madrid Open,Clay,2.75,1.44,0
Ramos-Vinolas A.,82,437,204,233,Ivashka I.,113,159,78,81,2023-04-26,Madrid,Mutua Madrid Open,Clay,2.2,1.67,1
Goffin D.,123,522,296,226,Carballes Baena R.,64,207,91,116,2023-04-26,Madrid,Mutua Madrid Open,Clay,2.63,1.5,0
Bublik A.,25,219,110,109,Galan D.E.,76,78,33,45,2023-04-26,Madrid,Mutua Madrid Open,Clay,1.8,2.0,1
Halys Q.,79,72,23,49,Popyrin A.,90,140,59,81,2023-04-26,Madrid,Mutua Madrid Open,Clay,1.67,2.2,1
Wu Y.,90,36,15,21,Molcan A.,120,86,45,41,2023-04-26,Madrid,Mutua Madrid Open,Clay,3.0,1.4,0
Barrere G.,59,79,31,48,Nava E.,242,13,2,11,2023-04-26,Madrid,Mutua Madrid Open,Clay,1.53,2.5,1
Chardy J.,542,591,289,302,Gaston H.,109,58,24,34,2023-04-26,Madrid,Mutua Madrid Open,Clay,3.5,1.3,0
Hanfmann Y.,50,99,50,49,Varillas J. P.,1345,20,9,11,2023-04-26,Madrid,Mutua Madrid Open,Clay,1.44,2.75,1
Fucsovics M.,67,249,121,128,Cecchinato M.,108,204,79,125,2023-04-27,Madrid,Mutua Madrid Open,Clay,1.57,2.38,0
Krajinovic F.,93,240,115,125,O Connell C.,74,65,26,39,2023-04-27,Madrid,Mutua Madrid Open,Clay,2.2,1.67,0
Borges N.,69,28,10,18,Giron M.,69,150,68,82,2023-04-27,Madrid,Mutua Madrid Open,Clay,1.73,2.1,0
Lajovic D.,66,378,163,215,Kubler J.,77,53,24,29,2023-04-27,Madrid,Mutua Madrid Open,Clay,1.53,2.5,1
Mcdonald M.,60,190,87,103,Zapata Miralles B.,54,80,32,48,2023-04-27,Madrid,Mutua Madrid Open,Clay,2.38,1.57,0
Djere L.,38,243,120,123,Karatsev A.,75,136,66,70,2023-04-27,Madrid,Mutua Madrid Open,Clay,1.62,2.3,0
Struff J.L.,21,369,170,199,Sonego L.,43,221,107,114,2023-04-27,Madrid,Mutua Madrid Open,Clay,2.1,1.73,1
Vavassori A.,128,12,5,7,Murray A.,44,932,687,245,2023-04-27,Madrid,Mutua Madrid Open,Clay,2.3,1.62,1
Huesler M.A.,88,58,21,37,Garin C.,101,190,103,87,2023-04-27,Madrid,Mutua Madrid Open,Clay,3.75,1.29,0
Watanuki Y.,99,25,11,14,Moutet C.,80,118,50,68,2023-04-27,Madrid,Mutua Madrid Open,Clay,1.5,2.63,1
Rodionov J.,118,26,9,17,Zhang Zh.,53,44,20,24,2023-04-27,Madrid,Mutua Madrid Open,Clay,1.73,2.1,0
Edmund K.,473,233,113,120,Thiem D.,116,517,327,190,2023-04-27,Madrid,Mutua Madrid Open,Clay,5.5,1.14,0
Safiullin R.,92,42,20,22,Jarry N.,28,141,73,68,2023-04-27,Madrid,Mutua Madrid Open,Clay,3.2,1.36,1
Wolf J.J.,45,75,39,36,Shevchenko A.,93,20,8,12,2023-04-27,Madrid,Mutua Madrid Open,Clay,2.5,1.53,0
Mannarino A.,27,567,264,303,Etcheverry T.,34,60,26,34,2023-04-27,Madrid,Mutua Madrid Open,Clay,4.5,1.2,0
Shelbayh A.,240,6,1,5,Cachin P.,54,52,23,29,2023-04-27,Madrid,Mutua Madrid Open,Clay,3.0,1.4,0
Zverev A.,19,500,346,154,Carballes Baena R.,64,207,91,116,2023-04-28,Madrid,Mutua Madrid Open,Clay,1.22,4.33,1
Davidovich Fokina A.,39,168,84,84,Ramos-Vinolas A.,82,437,204,233,2023-04-28,Madrid,Mutua Madrid Open,Clay,1.2,4.5,1
Rune H.,6,131,83,48,Bublik A.,25,219,110,109,2023-04-28,Madrid,Mutua Madrid Open,Clay,1.13,6.0,1
Hurkacz H.,17,238,137,101,Gasquet R.,48,948,581,367,2023-04-28,Madrid,Mutua Madrid Open,Clay,1.25,4.0,1
Korda S.,26,126,75,51,Grenier H.,122,16,5,11,2023-04-28,Madrid,Mutua Madrid Open,Clay,1.33,3.4,0
Coric B.,15,343,185,158,Gaston H.,109,58,24,34,2023-04-28,Madrid,Mutua Madrid Open,Clay,1.44,2.75,1
Halys Q.,79,72,23,49,Bautista Agut R.,25,379,234,145,2023-04-28,Madrid,Mutua Madrid Open,Clay,2.2,1.67,0
Alcaraz C.,1,164,130,34,Ruusuvuori E.,55,158,79,79,2023-04-28,Madrid,Mutua Madrid Open,Clay,1.04,13.0,1
Khachanov K.,11,378,217,161,Monteiro T.,121,171,69,102,2023-04-28,Madrid,Mutua Madrid Open,Clay,1.25,4.0,1
Barrere G.,59,79,31,48,Dimitrov G.,20,651,389,262,2023-04-28,Madrid,Mutua Madrid Open,Clay,5.0,1.17,0
Wawrinka S.,72,854,535,319,Rublev A.,7,392,255,137,2023-04-28,Madrid,Mutua Madrid Open,Clay,3.75,1.29,0
Hanfmann Y.,50,99,50,49,Musetti L.,18,143,79,64,2023-04-28,Madrid,Mutua Madrid Open,Clay,3.0,1.4,1
Molcan A.,120,86,45,41,Nishioka Y.,31,215,99,116,2023-04-28,Madrid,Mutua Madrid Open,Clay,1.57,2.38,0
Otte O.,233,78,33,45,Altmaier D.,51,79,28,51,2023-04-28,Madrid,Mutua Madrid Open,Clay,1.8,2.0,0
Munar J.,104,178,75,103,Griekspoor T.,37,97,47,50,2023-04-28,Madrid,Mutua Madrid Open,Clay,2.0,1.8,1
Ruud C.,4,275,176,99,Arnaldi M.,76,18,9,9,2023-04-28,Madrid,Mutua Madrid Open,Clay,1.17,5.0,0
Tsitsipas S.,5,390,264,126,Thiem D.,116,517,327,190,2023-04-29,Madrid,Mutua Madrid Open,Clay,1.2,4.5,1
Zhang Zh.,53,44,20,24,Shapovalov D.,29,298,166,132,2023-04-29,Madrid,Mutua Madrid Open,Clay,2.75,1.44,1
Norrie C.,13,287,172,115,Watanuki Y.,99,25,11,14,2023-04-29,Madrid,Mutua Madrid Open,Clay,1.25,4.0,1
Cachin P.,54,52,23,29,Cerundolo F.,21,104,58,46,2023-04-29,Madrid,Mutua Madrid Open,Clay,3.5,1.3,1
Kecmanovic M.,40,210,107,103,Garin C.,101,190,103,87,2023-04-29,Madrid,Mutua Madrid Open,Clay,1.91,1.91,0
Etcheverry T.,34,60,26,34,Tiafoe F.,10,303,158,145,2023-04-29,Madrid,Mutua Madrid Open,Clay,2.3,1.62,0
Fritz T.,9,356,205,151,O Connell C.,74,65,26,39,2023-04-29,Madrid,Mutua Madrid Open,Clay,1.3,3.5,1
Giron M.,69,150,68,82,Baez S.,72,95,47,48,2023-04-29,Madrid,Mutua Madrid Open,Clay,2.5,1.53,0
Struff J.L.,21,369,170,199,Shelton B.,43,34,13,21,2023-04-29,Madrid,Mutua Madrid Open,Clay,1.44,2.75,1
Evans D.,30,251,124,127,Zapata Miralles B.,54,80,32,48,2023-04-29,Madrid,Mutua Madrid Open,Clay,1.73,2.1,0
Lajovic D.,66,378,163,215,Auger-Aliassime F.,12,268,163,105,2023-04-29,Madrid,Mutua Madrid Open,Clay,2.1,1.73,1
Van De Zandschulp B.,44,117,63,54,Karatsev A.,75,136,66,70,2023-04-29,Madrid,Mutua Madrid Open,Clay,1.44,2.75,0
Paul T.,14,204,111,93,Safiullin R.,92,42,20,22,2023-04-29,Madrid,Mutua Madrid Open,Clay,1.5,2.63,0
Vavassori A.,128,12,5,7,Medvedev D.,3,406,289,117,2023-04-29,Madrid,Mutua Madrid Open,Clay,6.5,1.11,0
Shevchenko A.,93,20,8,12,Lehecka J.,33,61,30,31,2023-04-29,Madrid,Mutua Madrid Open,Clay,3.2,1.36,1
De Minaur A.,19,272,161,111,Cecchinato M.,108,204,79,125,2023-04-29,Madrid,Mutua Madrid Open,Clay,1.44,2.75,1
Rune H.,6,131,83,48,Davidovich Fokina A.,39,168,84,84,2023-04-30,Madrid,Mutua Madrid Open,Clay,1.44,2.75,0
Altmaier D.,51,79,28,51,Hanfmann Y.,50,99,50,49,2023-04-30,Madrid,Mutua Madrid Open,Clay,2.75,1.44,1
Dimitrov G.,20,651,389,262,Alcaraz C.,1,164,130,34,2023-04-30,Madrid,Mutua Madrid Open,Clay,7.0,1.1,0
Coric B.,15,343,185,158,Hurkacz H.,17,238,137,101,2023-04-30,Madrid,Mutua Madrid Open,Clay,2.63,1.5,1
Arnaldi M.,76,18,9,9,Munar J.,104,178,75,103,2023-04-30,Madrid,Mutua Madrid Open,Clay,1.8,2.0,0
Rublev A.,7,392,255,137,Nishioka Y.,31,215,99,116,2023-04-30,Madrid,Mutua Madrid Open,Clay,1.14,5.5,1
Bautista Agut R.,25,379,234,145,Khachanov K.,11,378,217,161,2023-04-30,Madrid,Mutua Madrid Open,Clay,2.38,1.57,0
Grenier H.,122,16,5,11,Zverev A.,19,500,346,154,2023-04-30,Madrid,Mutua Madrid Open,Clay,7.0,1.1,0
Garin C.,101,190,103,87,Fritz T.,9,356,205,151,2023-05-01,Madrid,Mutua Madrid Open,Clay,2.75,1.44,0
Zhang Zh.,53,44,20,24,Norrie C.,13,287,172,115,2023-05-01,Madrid,Mutua Madrid Open,Clay,4.33,1.22,1
Safiullin R.,92,42,20,22,Zapata Miralles B.,54,80,32,48,2023-05-01,Madrid,Mutua Madrid Open,Clay,2.38,1.57,0
Tsitsipas S.,5,390,264,126,Baez S.,72,95,47,48,2023-05-01,Madrid,Mutua Madrid Open,Clay,1.14,5.5,1
De Minaur A.,19,272,161,111,Karatsev A.,75,136,66,70,2023-05-01,Madrid,Mutua Madrid Open,Clay,1.57,2.38,0
Struff J.L.,21,369,170,199,Lajovic D.,66,378,163,215,2023-05-01,Madrid,Mutua Madrid Open,Clay,2.2,1.67,1
Shevchenko A.,93,20,8,12,Medvedev D.,3,406,289,117,2023-05-01,Madrid,Mutua Madrid Open,Clay,6.0,1.13,0
Tiafoe F.,10,303,158,145,Cachin P.,54,52,23,29,2023-05-01,Madrid,Mutua Madrid Open,Clay,1.29,3.75,0
Altmaier D.,51,79,28,51,Munar J.,104,178,75,103,2023-05-02,Madrid,Mutua Madrid Open,Clay,2.38,1.57,1
Rublev A.,7,392,255,137,Khachanov K.,11,378,217,161,2023-05-02,Madrid,Mutua Madrid Open,Clay,1.5,2.63,0
Medvedev D.,3,406,289,117,Karatsev A.,75,136,66,70,2023-05-02,Madrid,Mutua Madrid Open,Clay,1.29,3.75,0
Davidovich Fokina A.,39,168,84,84,Coric B.,15,343,185,158,2023-05-02,Madrid,Mutua Madrid Open,Clay,1.53,2.5,0
Alcaraz C.,1,164,130,34,Zverev A.,19,500,346,154,2023-05-02,Madrid,Mutua Madrid Open,Clay,1.22,4.33,1
Fritz T.,9,356,205,151,Zhang Zh.,53,44,20,24,2023-05-02,Madrid,Mutua Madrid Open,Clay,1.17,5.0,0
Struff J.L.,21,369,170,199,Cachin P.,54,52,23,29,2023-05-02,Madrid,Mutua Madrid Open,Clay,1.62,2.3,1
Zapata Miralles B.,54,80,32,48,Tsitsipas S.,5,390,264,126,2023-05-02,Madrid,Mutua Madrid Open,Clay,5.5,1.14,0
Coric B.,15,343,185,158,Altmaier D.,51,79,28,51,2023-05-03,Madrid,Mutua Madrid Open,Clay,1.5,2.63,1
Khachanov K.,11,378,217,161,Alcaraz C.,1,164,130,34,2023-05-03,Madrid,Mutua Madrid Open,Clay,9.0,1.07,0
Karatsev A.,75,136,66,70,Zhang Zh.,53,44,20,24,2023-05-04,Madrid,Mutua Madrid Open,Clay,1.57,2.38,1
Struff J.L.,21,369,170,199,Tsitsipas S.,5,390,264,126,2023-05-04,Madrid,Mutua Madrid Open,Clay,4.5,1.2,1
Alcaraz C.,1,164,130,34,Coric B.,15,343,185,158,2023-05-05,Madrid,Mutua Madrid Open,Clay,1.06,10.0,1
Karatsev A.,75,136,66,70,Struff J.L.,21,369,170,199,2023-05-05,Madrid,Mutua Madrid Open,Clay,1.8,2.0,0
Struff J.L.,21,369,170,199,Alcaraz C.,1,164,130,34,2023-05-07,Madrid,Mutua Madrid Open,Clay,10.0,1.06,0
Rinderknech A.,67,96,46,50,Cobolli F.,148,14,5,9,2023-05-10,Rome,Internazionali BNL d'Italia,Clay,3.0,1.4,1
Murray A.,44,932,687,245,Fognini F.,128,742,383,359,2023-05-10,Rome,Internazionali BNL d'Italia,Clay,1.5,2.63,0
Giron M.,69,150,68,82,Safiullin R.,92,42,20,22,2023-05-10,Rome,Internazionali BNL d'Italia,Clay,2.38,1.57,0
Popyrin A.,90,140,59,81,O Connell C.,74,65,26,39,2023-05-10,Rome,Internazionali BNL d'Italia,Clay,1.8,2.0,1
Kokkinakis T.,86,124,55,69,Munar J.,104,178,75,103,2023-05-10,Rome,Internazionali BNL d'Italia,Clay,1.73,2.1,1
Nakashima B.,70,106,57,49,Barrere G.,59,79,31,48,2023-05-10,Rome,Internazionali BNL d'Italia,Clay,1.73,2.1,0
Bublik A.,25,219,110,109,Martinez P.,135,118,50,68,2023-05-10,Rome,Internazionali BNL d'Italia,Clay,2.2,1.67,1
Fils A.,71,24,15,9,Cerundolo J.M.,106,29,12,17,2023-05-10,Rome,Internazionali BNL d'Italia,Clay,1.8,2.0,1
Gasquet R.,48,948,581,367,Wu Y.,90,36,15,21,2023-05-10,Rome,Internazionali BNL d'Italia,Clay,1.4,3.0,0
Garin C.,101,190,103,87,Cachin P.,54,52,23,29,2023-05-10,Rome,Internazionali BNL d'Italia,Clay,1.57,2.38,1
Lestienne C.,109,40,13,27,Djere L.,38,243,120,123,2023-05-10,Rome,Internazionali BNL d'Italia,Clay,6.0,1.13,0
Baez S.,72,95,47,48,Varillas J.P.,77,22,10,12,2023-05-10,Rome,Internazionali BNL d'Italia,Clay,1.4,3.0,1
Etcheverry T.,34,60,26,34,Van Assche L.,68,20,7,13,2023-05-10,Rome,Internazionali BNL d'Italia,Clay,1.67,2.2,1
Fucsovics M.,67,249,121,128,Krajinovic F.,93,240,115,125,2023-05-10,Rome,Internazionali BNL d'Italia,Clay,1.8,2.0,1
Wawrinka S.,72,854,535,319,Ivashka I.,113,159,78,81,2023-05-10,Rome,Internazionali BNL d'Italia,Clay,1.5,2.63,1
Edmund K.,473,233,113,120,Muller A.,81,22,9,13,2023-05-10,Rome,Internazionali BNL d'Italia,Clay,4.0,1.25,0
Schwartzman D.,95,428,233,195,Arnaldi M.,76,18,9,9,2023-05-11,Rome,Internazionali BNL d'Italia,Clay,2.38,1.57,0
Molcan A.,120,86,45,41,Napolitano S.,555,4,1,3,2023-05-11,Rome,Internazionali BNL d'Italia,Clay,1.17,5.0,1
Grenier H.,122,16,5,11,Wolf J.J.,45,75,39,36,2023-05-11,Rome,Internazionali BNL d'Italia,Clay,2.2,1.67,0
Jarry N.,28,141,73,68,Hanfmann Y.,50,99,50,49,2023-05-11,Rome,Internazionali BNL d'Italia,Clay,1.8,2.0,0
Marozsan F.,87,7,4,3,Moutet C.,80,118,50,68,2023-05-11,Rome,Internazionali BNL d'Italia,Clay,1.57,2.38,1
Lajovic D.,66,378,163,215,Borges N.,69,28,10,18,2023-05-11,Rome,Internazionali BNL d'Italia,Clay,1.36,3.2,0
Sonego L.,43,221,107,114,Chardy J.,542,591,289,302,2023-05-11,Rome,Internazionali BNL d'Italia,Clay,1.08,8.0,1
Passaro F.,126,10,3,7,Ramos-Vinolas A.,82,437,204,233,2023-05-11,Rome,Internazionali BNL d'Italia,Clay,2.0,1.8,0
Cressy M.,96,96,42,54,Pella G.,199,260,118,142,2023-05-11,Rome,Internazionali BNL d'Italia,Clay,1.8,2.0,0
Ruusuvuori E.,55,158,79,79,Humbert U.,36,170,80,90,2023-05-11,Rome,Internazionali BNL d'Italia,Clay,1.62,2.3,1
Goffin D.,123,522,296,226,Nardi L.,151,11,2,9,2023-05-11,Rome,Internazionali BNL d'Italia,Clay,1.5,2.63,1
Monteiro T.,121,171,69,102,Mannarino A.,27,567,264,303,2023-05-11,Rome,Internazionali BNL d'Italia,Clay,1.44,2.75,1
Kubler J.,77,53,24,29,Huesler M.A.,88,58,21,37,2023-05-11,Rome,Internazionali BNL d'Italia,Clay,1.8,2.0,1
Carballes Baena R.,64,207,91,116,Dellien H.,164,70,22,48,2023-05-11,Rome,Internazionali BNL d'Italia,Clay,1.44,2.75,1
Altmaier D.,51,79,28,51,Zeppieri G.,129,13,4,9,2023-05-11,Rome,Internazionali BNL d'Italia,Clay,1.53,2.5,1
Mcdonald M.,60,190,87,103,Cecchinato M.,108,204,79,125,2023-05-11,Rome,Internazionali BNL d'Italia,Clay,2.38,1.57,0
Khachanov K.,11,378,217,161,Barrere G.,59,79,31,48,2023-05-12,Rome,Internazionali BNL d'Italia,Clay,1.14,5.5,0
Ruud C.,4,275,176,99,Rinderknech A.,67,96,46,50,2023-05-12,Rome,Internazionali BNL d'Italia,Clay,1.17,5.0,1
Rune H.,6,131,83,48,Fils A.,71,24,15,9,2023-05-12,Rome,Internazionali BNL d'Italia,Clay,1.14,5.5,1
Etcheverry T.,34,60,26,34,Djokovic N.,2,1207,1012,195,2023-05-12,Rome,Internazionali BNL d'Italia,Clay,6.5,1.11,0
Shelton B.,43,34,13,21,Bublik A.,25,219,110,109,2023-05-12,Rome,Internazionali BNL d'Italia,Clay,1.73,2.1,0
Kecmanovic M.,40,210,107,103,Fognini F.,128,742,383,359,2023-05-12,Rome,Internazionali BNL d'Italia,Clay,1.53,2.5,0
Van De Zandschulp B.,44,117,63,54,Djere L.,38,243,120,123,2023-05-12,Rome,Internazionali BNL d'Italia,Clay,1.91,1.91,0
Paul T.,14,204,111,93,Garin C.,101,190,103,87,2023-05-12,Rome,Internazionali BNL d'Italia,Clay,2.0,1.8,0
Wawrinka S.,72,854,535,319,Dimitrov G.,20,651,389,262,2023-05-12,Rome,Internazionali BNL d'Italia,Clay,2.0,1.8,0
Baez S.,72,95,47,48,Shevchenko A.,93,20,8,12,2023-05-12,Rome,Internazionali BNL d'Italia,Clay,1.5,2.63,0
Fucsovics M.,67,249,121,128,De Minaur A.,19,272,161,111,2023-05-12,Rome,Internazionali BNL d'Italia,Clay,2.3,1.62,1
Safiullin R.,92,42,20,22,Korda S.,26,126,75,51,2023-05-12,Rome,Internazionali BNL d'Italia,Clay,1.67,2.2,1
Sinner J.,8,224,153,71,Kokkinakis T.,86,124,55,69,2023-05-12,Rome,Internazionali BNL d'Italia,Clay,1.11,6.5,1
Cerundolo F.,21,104,58,46,Wu Y.,90,36,15,21,2023-05-12,Rome,Internazionali BNL d'Italia,Clay,1.36,3.2,1
Muller A.,81,22,9,13,Norrie C.,13,287,172,115,2023-05-12,Rome,Internazionali BNL d'Italia,Clay,3.4,1.33,0
Auger-Aliassime F.,12,268,163,105,Popyrin A.,90,140,59,81,2023-05-12,Rome,Internazionali BNL d'Italia,Clay,1.36,3.2,0
Pella G.,199,260,118,142,Davidovich Fokina A.,39,168,84,84,2023-05-13,Rome,Internazionali BNL d'Italia,Clay,5.0,1.17,0
Sonego L.,43,221,107,114,Nishioka Y.,31,215,99,116,2023-05-13,Rome,Internazionali BNL d'Italia,Clay,1.44,2.75,1
Wolf J.J.,45,75,39,36,Hurkacz H.,17,238,137,101,2023-05-13,Rome,Internazionali BNL d'Italia,Clay,3.75,1.29,1
Ramos-Vinolas A.,82,437,204,233,Alcaraz C.,1,164,130,34,2023-05-13,Rome,Internazionali BNL d'Italia,Clay,17.0,1.03,0
Kubler J.,77,53,24,29,Zapata Miralles B.,54,80,32,48,2023-05-13,Rome,Internazionali BNL d'Italia,Clay,2.38,1.57,0
Evans D.,30,251,124,127,Carballes Baena R.,64,207,91,116,2023-05-13,Rome,Internazionali BNL d'Italia,Clay,2.2,1.67,0
Monteiro T.,121,171,69,102,Coric B.,15,343,185,158,2023-05-13,Rome,Internazionali BNL d'Italia,Clay,3.2,1.36,0
Rublev A.,7,392,255,137,Molcan A.,120,86,45,41,2023-05-13,Rome,Internazionali BNL d'Italia,Clay,1.17,5.0,1
Sinner J.,8,224,153,71,Shevchenko A.,93,20,8,12,2023-05-14,Rome,Internazionali BNL d'Italia,Clay,1.08,8.0,1
Fucsovics M.,67,249,121,128,Norrie C.,13,287,172,115,2023-05-14,Rome,Internazionali BNL d'Italia,Clay,2.75,1.44,0
Bublik A.,25,219,110,109,Ruud C.,4,275,176,99,2023-05-14,Rome,Internazionali BNL d'Italia,Clay,5.0,1.17,0
Djokovic N.,2,1207,1012,195,Dimitrov G.,20,651,389,262,2023-05-14,Rome,Internazionali BNL d'Italia,Clay,1.14,5.5,1
Garin C.,101,190,103,87,Djere L.,38,243,120,123,2023-05-14,Rome,Internazionali BNL d'Italia,Clay,2.1,1.73,0
Rune H.,6,131,83,48,Fognini F.,128,742,383,359,2023-05-14,Rome,Internazionali BNL d'Italia,Clay,1.2,4.5,1
Cerundolo F.,21,104,58,46,Barrere G.,59,79,31,48,2023-05-14,Rome,Internazionali BNL d'Italia,Clay,1.36,3.2,1
Safiullin R.,92,42,20,22,Popyrin A.,90,140,59,81,2023-05-14,Rome,Internazionali BNL d'Italia,Clay,2.1,1.73,0
Bautista Agut R.,25,379,234,145,Cecchinato M.,108,204,79,125,2023-05-14,Rome,Internazionali BNL d'Italia,Clay,1.53,2.5,0
Tiafoe F.,10,303,158,145,Altmaier D.,51,79,28,51,2023-05-14,Rome,Internazionali BNL d'Italia,Clay,1.53,2.5,1
Lehecka J.,33,61,30,31,Marozsan F.,87,7,4,3,2023-05-14,Rome,Internazionali BNL d'Italia,Clay,1.44,2.75,0
Arnaldi M.,76,18,9,9,Musetti L.,18,143,79,64,2023-05-14,Rome,Internazionali BNL d'Italia,Clay,3.2,1.36,0
Tsitsipas S.,5,390,264,126,Borges N.,69,28,10,18,2023-05-14,Rome,Internazionali BNL d'Italia,Clay,1.11,6.5,1
Hanfmann Y.,50,99,50,49,Fritz T.,9,356,205,151,2023-05-14,Rome,Internazionali BNL d'Italia,Clay,2.75,1.44,1
Ruusuvuori E.,55,158,79,79,Medvedev D.,3,406,289,117,2023-05-14,Rome,Internazionali BNL d'Italia,Clay,3.0,1.4,0
Goffin D.,123,522,296,226,Zverev A.,19,500,346,154,2023-05-14,Rome,Internazionali BNL d'Italia,Clay,4.33,1.22,0
Medvedev D.,3,406,289,117,Zapata Miralles B.,54,80,32,48,2023-05-15,Rome,Internazionali BNL d'Italia,Clay,1.22,4.33,1
Davidovich Fokina A.,39,168,84,84,Rublev A.,7,392,255,137,2023-05-15,Rome,Internazionali BNL d'Italia,Clay,2.63,1.5,0
Coric B.,15,343,185,158,Carballes Baena R.,64,207,91,116,2023-05-15,Rome,Internazionali BNL d'Italia,Clay,1.44,2.75,1
Cecchinato M.,108,204,79,125,Hanfmann Y.,50,99,50,49,2023-05-15,Rome,Internazionali BNL d'Italia,Clay,2.1,1.73,0
Marozsan F.,87,7,4,3,Alcaraz C.,1,164,130,34,2023-05-15,Rome,Internazionali BNL d'Italia,Clay,23.0,1.01,1
Zverev A.,19,500,346,154,Wolf J.J.,45,75,39,36,2023-05-16,Rome,Internazionali BNL d'Italia,Clay,1.22,4.33,1
Tsitsipas S.,5,390,264,126,Sonego L.,43,221,107,114,2023-05-16,Rome,Internazionali BNL d'Italia,Clay,1.2,4.5,1
Tiafoe F.,10,303,158,145,Musetti L.,18,143,79,64,2023-05-16,Rome,Internazionali BNL d'Italia,Clay,2.75,1.44,0
Rune H.,6,131,83,48,Popyrin A.,90,140,59,81,2023-05-16,Rome,Internazionali BNL d'Italia,Clay,1.17,5.0,1
Djokovic N.,2,1207,1012,195,Norrie C.,13,287,172,115,2023-05-16,Rome,Internazionali BNL d'Italia,Clay,1.17,5.0,1
Ruud C.,4,275,176,99,Djere L.,38,243,120,123,2023-05-16,Rome,Internazionali BNL d'Italia,Clay,1.4,3.0,1
Cerundolo F.,21,104,58,46,Sinner J.,8,224,153,71,2023-05-16,Rome,Internazionali BNL d'Italia,Clay,6.0,1.13,1
Hanfmann Y.,50,99,50,49,Rublev A.,7,392,255,137,2023-05-16,Rome,Internazionali BNL d'Italia,Clay,3.4,1.33,1
Medvedev D.,3,406,289,117,Zverev A.,19,500,346,154,2023-05-16,Rome,Internazionali BNL d'Italia,Clay,1.67,2.2,1
Coric B.,15,343,185,158,Marozsan F.,87,7,4,3,2023-05-16,Rome,Internazionali BNL d'Italia,Clay,1.44,2.75,1
Tsitsipas S.,5,390,264,126,Musetti L.,18,143,79,64,2023-05-16,Rome,Internazionali BNL d'Italia,Clay,1.36,3.2,1
Djokovic N.,2,1207,1012,195,Rune H.,6,131,83,48,2023-05-17,Rome,Internazionali BNL d'Italia,Clay,1.33,3.4,0
Ruud C.,4,275,176,99,Cerundolo F.,21,104,58,46,2023-05-17,Rome,Internazionali BNL d'Italia,Clay,1.62,2.3,1
Coric B.,15,343,185,158,Tsitsipas S.,5,390,264,126,2023-05-18,Rome,Internazionali BNL d'Italia,Clay,3.75,1.29,0
Medvedev D.,3,406,289,117,Hanfmann Y.,50,99,50,49,2023-05-18,Rome,Internazionali BNL d'Italia,Clay,1.4,3.0,1
Ruud C.,4,275,176,99,Rune H.,6,131,83,48,2023-05-20,Rome,Internazionali BNL d'Italia,Clay,2.38,1.57,0
Medvedev D.,3,406,289,117,Tsitsipas S.,5,390,264,126,2023-05-20,Rome,Internazionali BNL d'Italia,Clay,2.3,1.62,1
Rune H.,6,131,83,48,Medvedev D.,3,406,289,117,2023-05-21,Rome,Internazionali BNL d'Italia,Clay,1.91,1.91,0
Cecchinato M.,108,204,79,125,Shelton B.,43,34,13,21,2023-05-21,Geneva,Geneva Open,Clay,1.91,1.91,1
Eubanks C.,29,64,28,36,Paire B.,149,527,237,290,2023-05-21,Geneva,Geneva Open,Clay,2.5,1.53,1
Muller A.,81,22,9,13,Draper J.,55,51,29,22,2023-05-21,Lyon,Lyon Open,Clay,2.1,1.73,0
Moutet C.,80,118,50,68,Barrere G.,59,79,31,48,2023-05-21,Lyon,Lyon Open,Clay,2.38,1.57,0
Varillas J. P.,1345,20,9,11,Ramos-Vinolas A.,82,437,204,233,2023-05-21,Lyon,Lyon Open,Clay,1.8,2.0,1
Ymer M.,59,130,58,72,Gasquet R.,48,948,581,367,2023-05-22,Lyon,Lyon Open,Clay,1.91,1.91,1
Zhang Zh.,53,44,20,24,Fils A.,71,24,15,9,2023-05-22,Lyon,Lyon Open,Clay,2.1,1.73,0
Lopez San Martin A.,550,1,0,1,Goffin D.,123,522,296,226,2023-05-22,Lyon,Lyon Open,Clay,3.5,1.3,0
Rinderknech A.,67,96,46,50,Harris L.,186,129,59,70,2023-05-22,Lyon,Lyon Open,Clay,1.67,2.2,1
Kecmanovic M.,40,210,107,103,Roca Batalla O.,1055,3,1,2,2023-05-22,Lyon,Lyon Open,Clay,1.1,7.0,1
Schwartzman D.,95,428,233,195,Nakashima B.,70,106,57,49,2023-05-22,Lyon,Lyon Open,Clay,1.67,2.2,0
Mannarino A.,27,567,264,303,Krajinovic F.,93,240,115,125,2023-05-22,Geneva,Geneva Open,Clay,3.2,1.36,1
Lajovic D.,66,378,163,215,Jarry N.,28,141,73,68,2023-05-22,Geneva,Geneva Open,Clay,1.91,1.91,0
Sachko V.,1041,3,0,3,Zapata Miralles B.,54,80,32,48,2023-05-22,Geneva,Geneva Open,Clay,3.5,1.3,0
Carballes Baena R.,64,207,91,116,Rincon D.,841,2,0,2,2023-05-22,Geneva,Geneva Open,Clay,1.29,3.75,1
Huesler M.A.,88,58,21,37,Wu Y.,90,36,15,21,2023-05-22,Geneva,Geneva Open,Clay,1.73,2.1,0
Bublik A.,25,219,110,109,Giron M.,69,150,68,82,2023-05-22,Geneva,Geneva Open,Clay,1.73,2.1,0
Zverev A.,19,500,346,154,Eubanks C.,29,64,28,36,2023-05-23,Geneva,Geneva Open,Clay,1.11,6.5,1
Rinderknech A.,67,96,46,50,Nakashima B.,70,106,57,49,2023-05-23,Lyon,Lyon Open,Clay,1.91,1.91,0
Kecmanovic M.,40,210,107,103,Draper J.,55,51,29,22,2023-05-23,Lyon,Lyon Open,Clay,1.8,2.0,0
Varillas J. P.,1345,20,9,11,Cerundolo F.,21,104,58,46,2023-05-23,Lyon,Lyon Open,Clay,3.2,1.36,0
Cachin P.,54,52,23,29,Monfils G.,323,816,510,306,2023-05-23,Lyon,Lyon Open,Clay,1.3,3.5,1
Dellien H.,164,70,22,48,Wolf J.J.,45,75,39,36,2023-05-23,Geneva,Geneva Open,Clay,2.2,1.67,0
Fucsovics M.,67,249,121,128,Baez S.,72,95,47,48,2023-05-23,Lyon,Lyon Open,Clay,2.2,1.67,0
O Connell C.,74,65,26,39,Serdarusic N.,702,9,1,8,2023-05-23,Geneva,Geneva Open,Clay,1.36,3.2,1
Pella G.,199,260,118,142,Ivashka I.,113,159,78,81,2023-05-23,Geneva,Geneva Open,Clay,2.38,1.57,0
Griekspoor T.,37,97,47,50,Travaglia S.,1024,81,27,54,2023-05-23,Geneva,Geneva Open,Clay,1.53,2.5,1
Llamas Ruiz P.,3065,2,1,1,Purcell M.,78,28,9,19,2023-05-23,Lyon,Lyon Open,Clay,1.5,2.63,1
Wu Y.,90,36,15,21,Cecchinato M.,108,204,79,125,2023-05-23,Geneva,Geneva Open,Clay,2.3,1.62,1
Ymer M.,59,130,58,72,Fils A.,71,24,15,9,2023-05-24,Lyon,Lyon Open,Clay,2.2,1.67,0
Llamas Ruiz P.,3065,2,1,1,Auger-Aliassime F.,12,268,163,105,2023-05-24,Lyon,Lyon Open,Clay,4.33,1.22,0
Norrie C.,13,287,172,115,Goffin D.,123,522,296,226,2023-05-24,Lyon,Lyon Open,Clay,1.33,3.4,1
Paul T.,14,204,111,93,Barrere G.,59,79,31,48,2023-05-24,Lyon,Lyon Open,Clay,1.5,2.63,1
Baez S.,72,95,47,48,Cachin P.,54,52,23,29,2023-05-24,Lyon,Lyon Open,Clay,1.36,3.2,1
Ivashka I.,113,159,78,81,Mannarino A.,27,567,264,303,2023-05-24,Geneva,Geneva Open,Clay,1.4,3.0,1
O Connell C.,74,65,26,39,Zapata Miralles B.,54,80,32,48,2023-05-24,Geneva,Geneva Open,Clay,2.38,1.57,1
Carballes Baena R.,64,207,91,116,Dimitrov G.,20,651,389,262,2023-05-24,Geneva,Geneva Open,Clay,3.0,1.4,0
Giron M.,69,150,68,82,Fritz T.,9,356,205,151,2023-05-24,Geneva,Geneva Open,Clay,3.4,1.33,0
Jarry N.,28,141,73,68,Griekspoor T.,37,97,47,50,2023-05-24,Geneva,Geneva Open,Clay,1.57,2.38,1
Ruud C.,4,275,176,99,Wolf J.J.,45,75,39,36,2023-05-24,Geneva,Geneva Open,Clay,1.2,4.5,1
Norrie C.,13,287,172,115,Baez S.,72,95,47,48,2023-05-25,Lyon,Lyon Open,Clay,1.44,2.75,1
Fritz T.,9,356,205,151,Ivashka I.,113,159,78,81,2023-05-25,Geneva,Geneva Open,Clay,1.2,4.5,1
Dimitrov G.,20,651,389,262,O Connell C.,74,65,26,39,2023-05-25,Geneva,Geneva Open,Clay,1.33,3.4,1
Wu Y.,90,36,15,21,Zverev A.,19,500,346,154,2023-05-25,Geneva,Geneva Open,Clay,4.5,1.2,0
Ruud C.,4,275,176,99,Jarry N.,28,141,73,68,2023-05-25,Geneva,Geneva Open,Clay,1.33,3.4,0
Fils A.,71,24,15,9,Auger-Aliassime F.,12,268,163,105,2023-05-25,Lyon,Lyon Open,Clay,2.75,1.44,1
Cerundolo F.,21,104,58,46,Draper J.,55,51,29,22,2023-05-25,Lyon,Lyon Open,Clay,1.5,2.63,1
Paul T.,14,204,111,93,Nakashima B.,70,106,57,49,2023-05-25,Lyon,Lyon Open,Clay,1.44,2.75,0
Norrie C.,13,287,172,115,Cerundolo F.,21,104,58,46,2023-05-26,Lyon,Lyon Open,Clay,1.67,2.2,0
Nakashima B.,70,106,57,49,Fils A.,71,24,15,9,2023-05-26,Lyon,Lyon Open,Clay,2.1,1.73,0
Zverev A.,19,500,346,154,Jarry N.,28,141,73,68,2023-05-26,Geneva,Geneva Open,Clay,1.44,2.75,0
Dimitrov G.,20,651,389,262,Fritz T.,9,356,205,151,2023-05-26,Geneva,Geneva Open,Clay,2.5,1.53,1
Cerundolo F.,21,104,58,46,Fils A.,71,24,15,9,2023-05-27,Lyon,Lyon Open,Clay,1.29,3.75,0
Dimitrov G.,20,651,389,262,Jarry N.,28,141,73,68,2023-05-27,Geneva,Geneva Open,Clay,2.1,1.73,0
Galan D.E.,76,78,33,45,Arnaldi M.,76,18,9,9,2023-05-28,Paris,French Open,Clay,2.75,1.44,0
Pouille L.,675,259,134,125,Rodionov J.,118,26,9,17,2023-05-28,Paris,French Open,Clay,1.73,2.1,1
Humbert U.,36,170,80,90,Mannarino A.,27,567,264,303,2023-05-28,Paris,French Open,Clay,1.22,4.33,1
Otte O.,233,78,33,45,Shevchenko A.,93,20,8,12,2023-05-28,Paris,French Open,Clay,3.0,1.4,0
Shelton B.,43,34,13,21,Sonego L.,43,221,107,114,2023-05-28,Paris,French Open,Clay,3.0,1.4,0
Moutet C.,80,118,50,68,Cazaux A.,190,4,1,3,2023-05-28,Paris,French Open,Clay,1.8,2.0,1
Rublev A.,7,392,255,137,Djere L.,38,243,120,123,2023-05-28,Paris,French Open,Clay,1.22,4.33,1
Musetti L.,18,143,79,64,Ymer M.,59,130,58,72,2023-05-28,Paris,French Open,Clay,1.2,4.5,1
Nava E.,242,13,2,11,Carballes Baena R.,64,207,91,116,2023-05-28,Paris,French Open,Clay,4.0,1.25,0
Korda S.,26,126,75,51,Mcdonald M.,60,190,87,103,2023-05-28,Paris,French Open,Clay,1.5,2.63,1
Hurkacz H.,17,238,137,101,Goffin D.,123,522,296,226,2023-05-28,Paris,French Open,Clay,1.36,3.2,1
Kubler J.,77,53,24,29,Diaz Acosta F.,137,5,1,4,2023-05-28,Paris,French Open,Clay,2.3,1.62,1
Khachanov K.,11,378,217,161,Lestienne C.,109,40,13,27,2023-05-28,Paris,French Open,Clay,1.02,21.0,1
Cressy M.,96,96,42,54,Ofner S.,61,34,16,18,2023-05-28,Paris,French Open,Clay,3.5,1.3,0
Griekspoor T.,37,97,47,50,Martinez P.,135,118,50,68,2023-05-28,Paris,French Open,Clay,2.1,1.73,1
Borges N.,69,28,10,18,Isner J.,114,755,465,290,2023-05-28,Paris,French Open,Clay,1.4,3.0,1
Kokkinakis T.,86,124,55,69,Evans D.,30,251,124,127,2023-05-28,Paris,French Open,Clay,2.0,1.8,1
Fucsovics M.,67,249,121,128,Grenier H.,122,16,5,11,2023-05-28,Paris,French Open,Clay,1.2,4.5,1
Kypson P.,329,2,0,2,Albot R.,97,215,86,129,2023-05-28,Paris,French Open,Clay,3.2,1.36,0
Tsitsipas S.,5,390,264,126,Vesely J.,528,288,130,158,2023-05-28,Paris,French Open,Clay,1.02,19.0,1
Van Assche L.,68,20,7,13,Cecchinato M.,108,204,79,125,2023-05-29,Paris,French Open,Clay,1.8,2.0,1
Zhang Zh.,53,44,20,24,Lajovic D.,66,378,163,215,2023-05-29,Paris,French Open,Clay,2.5,1.53,1
Krajinovic F.,93,240,115,125,Tiafoe F.,10,303,158,145,2023-05-29,Paris,French Open,Clay,4.5,1.2,0
Huesler M.A.,88,58,21,37,Altmaier D.,51,79,28,51,2023-05-29,Paris,French Open,Clay,3.2,1.36,0
Cobolli F.,148,14,5,9,Alcaraz C.,1,164,130,34,2023-05-29,Paris,French Open,Clay,21.0,1.02,0
Fils A.,71,24,15,9,Davidovich Fokina A.,39,168,84,84,2023-05-29,Paris,French Open,Clay,3.2,1.36,0
Struff J.L.,21,369,170,199,Lehecka J.,33,61,30,31,2023-05-29,Paris,French Open,Clay,1.62,2.3,0
Medjedovic H.,147,11,3,8,Giron M.,69,150,68,82,2023-05-29,Paris,French Open,Clay,1.73,2.1,0
Cachin P.,54,52,23,29,Thiem D.,116,517,327,190,2023-05-29,Paris,French Open,Clay,2.2,1.67,1
Coria F.,108,99,43,56,Coric B.,15,343,185,158,2023-05-29,Paris,French Open,Clay,6.0,1.13,0
Van De Zandschulp B.,44,117,63,54,Tirante T.A.,136,5,2,3,2023-05-29,Paris,French Open,Clay,1.2,4.5,0
Muller A.,81,22,9,13,Sinner J.,8,224,153,71,2023-05-29,Paris,French Open,Clay,15.0,1.03,0
Daniel T.,111,178,67,111,O Connell C.,74,65,26,39,2023-05-29,Paris,French Open,Clay,2.2,1.67,1
Kovacevic A.,129,14,6,8,Djokovic N.,2,1207,1012,195,2023-05-29,Paris,French Open,Clay,29.0,1.01,0
Norrie C.,13,287,172,115,Paire B.,149,527,237,290,2023-05-29,Paris,French Open,Clay,1.11,6.5,1
Schwartzman D.,95,428,233,195,Zapata Miralles B.,54,80,32,48,2023-05-29,Paris,French Open,Clay,2.1,1.73,1
Shang J.,149,12,4,8,Varillas J.P.,77,22,10,12,2023-05-29,Paris,French Open,Clay,2.38,1.57,0
De Minaur A.,19,272,161,111,Ivashka I.,113,159,78,81,2023-05-29,Paris,French Open,Clay,1.29,3.75,1
Nakashima B.,70,106,57,49,Shapovalov D.,29,298,166,132,2023-05-29,Paris,French Open,Clay,1.73,2.1,0
Popyrin A.,90,140,59,81,Karatsev A.,75,136,66,70,2023-05-29,Paris,French Open,Clay,2.2,1.67,0
Wu Y.,90,36,15,21,Bautista Agut R.,25,379,234,145,2023-05-29,Paris,French Open,Clay,3.0,1.4,0
Auger-Aliassime F.,12,268,163,105,Fognini F.,128,742,383,359,2023-05-29,Paris,French Open,Clay,1.36,3.2,0
Ramos-Vinolas A.,82,437,204,233,Wawrinka S.,72,854,535,319,2023-05-29,Paris,French Open,Clay,3.2,1.36,0
Etcheverry T.,34,60,26,34,Draper J.,55,51,29,22,2023-05-29,Paris,French Open,Clay,1.67,2.2,1
Ruusuvuori E.,55,158,79,79,Barrere G.,59,79,31,48,2023-05-30,Paris,French Open,Clay,1.53,2.5,1
Baez S.,72,95,47,48,Monfils G.,323,816,510,306,2023-05-30,Paris,French Open,Clay,1.33,3.4,0
Hanfmann Y.,50,99,50,49,Monteiro T.,121,171,69,102,2023-05-30,Paris,French Open,Clay,1.36,3.2,1
Skatov T.,147,5,1,4,Dimitrov G.,20,651,389,262,2023-05-30,Paris,French Open,Clay,7.0,1.1,0
Mmoh M.,112,55,20,35,Fritz T.,9,356,205,151,2023-05-30,Paris,French Open,Clay,19.0,1.02,0
Gasquet R.,48,948,581,367,Rinderknech A.,67,96,46,50,2023-05-30,Paris,French Open,Clay,1.67,2.2,0
Halys Q.,79,72,23,49,Pella G.,199,260,118,142,2023-05-30,Paris,French Open,Clay,1.36,3.2,0
Eubanks C.,29,64,28,36,Rune H.,6,131,83,48,2023-05-30,Paris,French Open,Clay,19.0,1.02,0
Cerundolo F.,21,104,58,46,Munar J.,104,178,75,103,2023-05-30,Paris,French Open,Clay,1.3,3.5,1
Seyboth Wild T.,117,28,12,16,Medvedev D.,3,406,289,117,2023-05-30,Paris,French Open,Clay,11.0,1.05,1
Molcan A.,120,86,45,41,Gaston H.,109,58,24,34,2023-05-30,Paris,French Open,Clay,1.57,2.38,1
Zverev A.,19,500,346,154,Harris L.,186,129,59,70,2023-05-30,Paris,French Open,Clay,1.05,11.0,1
Purcell M.,78,28,9,19,Thompson J.,71,221,96,125,2023-05-30,Paris,French Open,Clay,2.1,1.73,1
Kecmanovic M.,40,210,107,103,Vavassori A.,128,12,5,7,2023-05-30,Paris,French Open,Clay,1.4,3.0,0
Olivieri G.,231,3,2,1,Mpetshi G.,233,2,0,2,2023-05-30,Paris,French Open,Clay,1.67,2.2,1
Wolf J.J.,45,75,39,36,Nishioka Y.,31,215,99,116,2023-05-30,Paris,French Open,Clay,1.8,2.0,0
Ruud C.,4,275,176,99,Ymer E.,186,81,24,57,2023-05-30,Paris,French Open,Clay,1.06,10.0,1
Dellien H.,164,70,22,48,Jarry N.,28,141,73,68,2023-05-30,Paris,French Open,Clay,4.5,1.2,0
Stricker D.,106,20,10,10,Paul T.,14,204,111,93,2023-05-30,Paris,French Open,Clay,3.4,1.33,0
Zeppieri G.,129,13,4,9,Bublik A.,25,219,110,109,2023-05-30,Paris,French Open,Clay,1.73,2.1,1
Hurkacz H.,17,238,137,101,Griekspoor T.,37,97,47,50,2023-05-31,Paris,French Open,Clay,1.4,3.0,1
Van Assche L.,68,20,7,13,Davidovich Fokina A.,39,168,84,84,2023-05-31,Paris,French Open,Clay,3.2,1.36,0
Pouille L.,675,259,134,125,Norrie C.,13,287,172,115,2023-05-31,Paris,French Open,Clay,4.0,1.25,0
Albot R.,97,215,86,129,Khachanov K.,11,378,217,161,2023-05-31,Paris,French Open,Clay,5.0,1.17,0
Moutet C.,80,118,50,68,Rublev A.,7,392,255,137,2023-05-31,Paris,French Open,Clay,9.0,1.07,0
Musetti L.,18,143,79,64,Shevchenko A.,93,20,8,12,2023-05-31,Paris,French Open,Clay,1.29,3.75,1
Fucsovics M.,67,249,121,128,Djokovic N.,2,1207,1012,195,2023-05-31,Paris,French Open,Clay,11.0,1.05,0
Daniel T.,111,178,67,111,Alcaraz C.,1,164,130,34,2023-05-31,Paris,French Open,Clay,21.0,1.02,0
Tsitsipas S.,5,390,264,126,Carballes Baena R.,64,207,91,116,2023-05-31,Paris,French Open,Clay,1.08,8.0,1
Arnaldi M.,76,18,9,9,Shapovalov D.,29,298,166,132,2023-05-31,Paris,French Open,Clay,1.73,2.1,0
Varillas J.P.,77,22,10,12,Bautista Agut R.,25,379,234,145,2023-05-31,Paris,French Open,Clay,3.0,1.4,1
Ofner S.,61,34,16,18,Korda S.,26,126,75,51,2023-05-31,Paris,French Open,Clay,2.5,1.53,1
Fognini F.,128,742,383,359,Kubler J.,77,53,24,29,2023-05-31,Paris,French Open,Clay,1.5,2.63,1
Wawrinka S.,72,854,535,319,Kokkinakis T.,86,124,55,69,2023-05-31,Paris,French Open,Clay,1.8,2.0,0
Sonego L.,43,221,107,114,Humbert U.,36,170,80,90,2023-05-31,Paris,French Open,Clay,2.1,1.73,1
Schwartzman D.,95,428,233,195,Borges N.,69,28,10,18,2023-05-31,Paris,French Open,Clay,1.73,2.1,1
Fritz T.,9,356,205,151,Rinderknech A.,67,96,46,50,2023-06-01,Paris,French Open,Clay,1.11,6.5,1
Rune H.,6,131,83,48,Monfils G.,323,816,510,306,2023-06-01,Paris,French Open,Clay,1.07,9.0,1
Cerundolo F.,21,104,58,46,Hanfmann Y.,50,99,50,49,2023-06-01,Paris,French Open,Clay,1.44,2.75,1
Lehecka J.,33,61,30,31,Giron M.,69,150,68,82,2023-06-01,Paris,French Open,Clay,1.44,2.75,0
Jarry N.,28,141,73,68,Paul T.,14,204,111,93,2023-06-01,Paris,French Open,Clay,1.62,2.3,1
Vavassori A.,128,12,5,7,Olivieri G.,231,3,2,1,2023-06-01,Paris,French Open,Clay,1.36,3.2,0
Karatsev A.,75,136,66,70,Tiafoe F.,10,303,158,145,2023-06-01,Paris,French Open,Clay,1.91,1.91,0
Zverev A.,19,500,346,154,Molcan A.,120,86,45,41,2023-06-01,Paris,French Open,Clay,1.22,4.33,1
Pella G.,199,260,118,142,Seyboth Wild T.,117,28,12,16,2023-06-01,Paris,French Open,Clay,3.2,1.36,0
Ruusuvuori E.,55,158,79,79,Dimitrov G.,20,651,389,262,2023-06-01,Paris,French Open,Clay,2.75,1.44,0
Purcell M.,78,28,9,19,Nishioka Y.,31,215,99,116,2023-06-01,Paris,French Open,Clay,3.2,1.36,0
Altmaier D.,51,79,28,51,Sinner J.,8,224,153,71,2023-06-01,Paris,French Open,Clay,8.0,1.08,1
Ruud C.,4,275,176,99,Zeppieri G.,129,13,4,9,2023-06-01,Paris,French Open,Clay,1.08,8.0,1
Etcheverry T.,34,60,26,34,De Minaur A.,19,272,161,111,2023-06-01,Paris,French Open,Clay,2.0,1.8,1
Coric B.,15,343,185,158,Cachin P.,54,52,23,29,2023-06-01,Paris,French Open,Clay,1.36,3.2,1
Tirante T.A.,136,5,2,3,Zhang Zh.,53,44,20,24,2023-06-01,Paris,French Open,Clay,2.38,1.57,0
Alcaraz C.,1,164,130,34,Shapovalov D.,29,298,166,132,2023-06-02,Paris,French Open,Clay,1.04,13.0,1
Schwartzman D.,95,428,233,195,Tsitsipas S.,5,390,264,126,2023-06-02,Paris,French Open,Clay,7.0,1.1,0
Norrie C.,13,287,172,115,Musetti L.,18,143,79,64,2023-06-02,Paris,French Open,Clay,2.5,1.53,0
Varillas J.P.,77,22,10,12,Hurkacz H.,17,238,137,101,2023-06-02,Paris,French Open,Clay,3.0,1.4,1
Ofner S.,61,34,16,18,Fognini F.,128,742,383,359,2023-06-02,Paris,French Open,Clay,2.2,1.67,1
Djokovic N.,2,1207,1012,195,Davidovich Fokina A.,39,168,84,84,2023-06-02,Paris,French Open,Clay,1.13,6.0,1
Sonego L.,43,221,107,114,Rublev A.,7,392,255,137,2023-06-02,Paris,French Open,Clay,3.75,1.29,1
Khachanov K.,11,378,217,161,Kokkinakis T.,86,124,55,69,2023-06-02,Paris,French Open,Clay,1.29,3.75,1
Zhang Zh.,53,44,20,24,Ruud C.,4,275,176,99,2023-06-03,Paris,French Open,Clay,6.0,1.13,0
Seyboth Wild T.,117,28,12,16,Nishioka Y.,31,215,99,116,2023-06-03,Paris,French Open,Clay,1.5,2.63,0
Etcheverry T.,34,60,26,34,Coric B.,15,343,185,158,2023-06-03,Paris,French Open,Clay,1.67,2.2,1
Giron M.,69,150,68,82,Jarry N.,28,141,73,68,2023-06-03,Paris,French Open,Clay,3.4,1.33,0
Fritz T.,9,356,205,151,Cerundolo F.,21,104,58,46,2023-06-03,Paris,French Open,Clay,1.73,2.1,0
Dimitrov G.,20,651,389,262,Altmaier D.,51,79,28,51,2023-06-03,Paris,French Open,Clay,1.36,3.2,1
Zverev A.,19,500,346,154,Tiafoe F.,10,303,158,145,2023-06-03,Paris,French Open,Clay,1.4,3.0,1
Rune H.,6,131,83,48,Olivieri G.,231,3,2,1,2023-06-03,Paris,French Open,Clay,1.03,15.0,1
Khachanov K.,11,378,217,161,Sonego L.,43,221,107,114,2023-06-04,Paris,French Open,Clay,1.44,2.75,1
Djokovic N.,2,1207,1012,195,Varillas J.P.,77,22,10,12,2023-06-04,Paris,French Open,Clay,1.03,15.0,1
Alcaraz C.,1,164,130,34,Musetti L.,18,143,79,64,2023-06-04,Paris,French Open,Clay,1.17,5.0,1
Ofner S.,61,34,16,18,Tsitsipas S.,5,390,264,126,2023-06-04,Paris,French Open,Clay,10.0,1.06,0
Nishioka Y.,31,215,99,116,Etcheverry T.,34,60,26,34,2023-06-05,Paris,French Open,Clay,4.33,1.22,0
Zverev A.,19,500,346,154,Dimitrov G.,20,651,389,262,2023-06-05,Paris,French Open,Clay,1.44,2.75,1
Rune H.,6,131,83,48,Cerundolo F.,21,104,58,46,2023-06-05,Paris,French Open,Clay,1.33,3.4,1
Ruud C.,4,275,176,99,Jarry N.,28,141,73,68,2023-06-05,Paris,French Open,Clay,1.44,2.75,1
Djokovic N.,2,1207,1012,195,Khachanov K.,11,378,217,161,2023-06-06,Paris,French Open,Clay,1.08,8.0,1
Tsitsipas S.,5,390,264,126,Alcaraz C.,1,164,130,34,2023-06-06,Paris,French Open,Clay,4.5,1.2,0
Etcheverry T.,34,60,26,34,Zverev A.,19,500,346,154,2023-06-07,Paris,French Open,Clay,3.4,1.33,0
Rune H.,6,131,83,48,Ruud C.,4,275,176,99,2023-06-07,Paris,French Open,Clay,2.1,1.73,0
Djokovic N.,2,1207,1012,195,Alcaraz C.,1,164,130,34,2023-06-09,Paris,French Open,Clay,2.63,1.5,1
Ruud C.,4,275,176,99,Zverev A.,19,500,346,154,2023-06-09,Paris,French Open,Clay,1.91,1.91,1
Ruud C.,4,275,176,99,Djokovic N.,2,1207,1012,195,2023-06-11,Paris,French Open,Clay,4.8,1.2,0
Lehecka J.,33,61,30,31,Giron M.,69,150,68,82,2023-06-12,Stuttgart,Stuttgart Open,Grass,2.3,1.62,1
Gojo B.,115,14,3,11,Musetti L.,18,143,79,64,2023-06-12,Stuttgart,Stuttgart Open,Grass,2.2,1.67,0
Berrettini M.,38,217,142,75,Sonego L.,43,221,107,114,2023-06-12,Stuttgart,Stuttgart Open,Grass,1.57,2.38,0
Eubanks C.,29,64,28,36,Gasquet R.,48,948,581,367,2023-06-12,Stuttgart,Stuttgart Open,Grass,2.0,1.8,0
Lopez F.,634,863,441,422,Watanuki Y.,99,25,11,14,2023-06-12,Stuttgart,Stuttgart Open,Grass,3.5,1.3,0
Kecmanovic M.,40,210,107,103,Raonic M.,849,540,361,179,2023-06-12,'s-Hertogenbosch,Rosmalen Grass Court Championships,Grass,1.5,2.63,0
Brouwer G.,144,21,11,10,Hijikata R.,110,16,7,9,2023-06-12,'s-Hertogenbosch,Rosmalen Grass Court Championships,Grass,2.1,1.73,0
Kubler J.,77,53,24,29,Humbert U.,36,170,80,90,2023-06-12,'s-Hertogenbosch,Rosmalen Grass Court Championships,Grass,2.63,1.5,0
Cressy M.,96,96,42,54,Huesler M.A.,88,58,21,37,2023-06-12,'s-Hertogenbosch,Rosmalen Grass Court Championships,Grass,1.44,2.75,0
Paul T.,14,204,111,93,Bonzi B.,107,83,37,46,2023-06-13,Stuttgart,Stuttgart Open,Grass,1.36,3.2,1
Shapovalov D.,29,298,166,132,Fucsovics M.,67,249,121,128,2023-06-13,Stuttgart,Stuttgart Open,Grass,1.8,2.0,0
Kyrgios N.,25,303,195,108,Wu Y.,90,36,15,21,2023-06-13,Stuttgart,Stuttgart Open,Grass,1.29,3.75,0
Zhang Zh.,53,44,20,24,Struff J.L.,21,369,170,199,2023-06-13,Stuttgart,Stuttgart Open,Grass,3.0,1.4,0
Otte O.,233,78,33,45,Barrere G.,59,79,31,48,2023-06-13,Stuttgart,Stuttgart Open,Grass,1.67,2.2,0
O Connell C.,74,65,26,39,Altmaier D.,51,79,28,51,2023-06-13,Stuttgart,Stuttgart Open,Grass,1.73,2.1,1
Thompson J.,71,221,96,125,Mpetshi G.,233,2,0,2,2023-06-13,'s-Hertogenbosch,Rosmalen Grass Court Championships,Grass,1.2,4.5,1
Goffin D.,123,522,296,226,Bublik A.,25,219,110,109,2023-06-13,'s-Hertogenbosch,Rosmalen Grass Court Championships,Grass,2.1,1.73,0
Karatsev A.,75,136,66,70,Moutet C.,80,118,50,68,2023-06-13,Stuttgart,Stuttgart Open,Grass,1.67,2.2,1
Ruusuvuori E.,55,158,79,79,Nakashima B.,70,106,57,49,2023-06-13,'s-Hertogenbosch,Rosmalen Grass Court Championships,Grass,2.0,1.8,1
Ymer M.,59,130,58,72,Griekspoor T.,37,97,47,50,2023-06-13,'s-Hertogenbosch,Rosmalen Grass Court Championships,Grass,2.5,1.53,0
Popyrin A.,90,140,59,81,Rinderknech A.,67,96,46,50,2023-06-13,'s-Hertogenbosch,Rosmalen Grass Court Championships,Grass,1.67,2.2,1
Ivashka I.,113,159,78,81,Mcdonald M.,60,190,87,103,2023-06-13,'s-Hertogenbosch,Rosmalen Grass Court Championships,Grass,1.67,2.2,0
Fils A.,71,24,15,9,Mannarino A.,27,567,264,303,2023-06-13,'s-Hertogenbosch,Rosmalen Grass Court Championships,Grass,2.2,1.67,0
Berankis R.,212,249,104,145,Djere L.,38,243,120,123,2023-06-13,'s-Hertogenbosch,Rosmalen Grass Court Championships,Grass,1.73,2.1,0
Coric B.,15,343,185,158,Mcdonald M.,60,190,87,103,2023-06-14,'s-Hertogenbosch,Rosmalen Grass Court Championships,Grass,1.62,2.3,0
Humbert U.,36,170,80,90,Ruusuvuori E.,55,158,79,79,2023-06-14,'s-Hertogenbosch,Rosmalen Grass Court Championships,Grass,1.73,2.1,0
O Connell C.,74,65,26,39,Sonego L.,43,221,107,114,2023-06-14,Stuttgart,Stuttgart Open,Grass,3.0,1.4,1
Hurkacz H.,17,238,137,101,Watanuki Y.,99,25,11,14,2023-06-14,Stuttgart,Stuttgart Open,Grass,1.25,4.0,1
Barrere G.,59,79,31,48,Musetti L.,18,143,79,64,2023-06-14,Stuttgart,Stuttgart Open,Grass,2.0,1.8,0
Lehecka J.,33,61,30,31,Tiafoe F.,10,303,158,145,2023-06-14,Stuttgart,Stuttgart Open,Grass,2.75,1.44,0
Sinner J.,8,224,153,71,Bublik A.,25,219,110,109,2023-06-14,'s-Hertogenbosch,Rosmalen Grass Court Championships,Grass,1.29,3.75,1
Hijikata R.,110,16,7,9,Huesler M.A.,88,58,21,37,2023-06-14,'s-Hertogenbosch,Rosmalen Grass Court Championships,Grass,2.1,1.73,1
Fucsovics M.,67,249,121,128,Wu Y.,90,36,15,21,2023-06-15,Stuttgart,Stuttgart Open,Grass,1.53,2.5,1
Paul T.,14,204,111,93,Struff J.L.,21,369,170,199,2023-06-15,Stuttgart,Stuttgart Open,Grass,1.62,2.3,0
Tsitsipas S.,5,390,264,126,Gasquet R.,48,948,581,367,2023-06-15,Stuttgart,Stuttgart Open,Grass,1.25,4.0,0
Fritz T.,9,356,205,151,Karatsev A.,75,136,66,70,2023-06-15,Stuttgart,Stuttgart Open,Grass,1.2,4.5,1
De Minaur A.,19,272,161,111,Djere L.,38,243,120,123,2023-06-15,'s-Hertogenbosch,Rosmalen Grass Court Championships,Grass,1.25,4.0,1
Griekspoor T.,37,97,47,50,Popyrin A.,90,140,59,81,2023-06-15,'s-Hertogenbosch,Rosmalen Grass Court Championships,Grass,1.73,2.1,1
Mannarino A.,27,567,264,303,Medvedev D.,3,406,289,117,2023-06-15,'s-Hertogenbosch,Rosmalen Grass Court Championships,Grass,4.5,1.2,1
Raonic M.,849,540,361,179,Thompson J.,71,221,96,125,2023-06-15,'s-Hertogenbosch,Rosmalen Grass Court Championships,Grass,1.67,2.2,0
Gasquet R.,48,948,581,367,Struff J.L.,21,369,170,199,2023-06-16,Stuttgart,Stuttgart Open,Grass,2.75,1.44,0
Hurkacz H.,17,238,137,101,O Connell C.,74,65,26,39,2023-06-16,Stuttgart,Stuttgart Open,Grass,1.4,3.0,1
Tiafoe F.,10,303,158,145,Musetti L.,18,143,79,64,2023-06-16,Stuttgart,Stuttgart Open,Grass,1.44,2.75,1
Fucsovics M.,67,249,121,128,Fritz T.,9,356,205,151,2023-06-16,Stuttgart,Stuttgart Open,Grass,4.0,1.25,1
Mannarino A.,27,567,264,303,Thompson J.,71,221,96,125,2023-06-16,'s-Hertogenbosch,Rosmalen Grass Court Championships,Grass,1.67,2.2,0
Griekspoor T.,37,97,47,50,De Minaur A.,19,272,161,111,2023-06-16,'s-Hertogenbosch,Rosmalen Grass Court Championships,Grass,2.3,1.62,1
Sinner J.,8,224,153,71,Ruusuvuori E.,55,158,79,79,2023-06-16,'s-Hertogenbosch,Rosmalen Grass Court Championships,Grass,1.25,4.0,0
Mcdonald M.,60,190,87,103,Hijikata R.,110,16,7,9,2023-06-16,'s-Hertogenbosch,Rosmalen Grass Court Championships,Grass,1.4,3.0,0
Fucsovics M.,67,249,121,128,Tiafoe F.,10,303,158,145,2023-06-17,Stuttgart,Stuttgart Open,Grass,2.38,1.57,0
Hijikata R.,110,16,7,9,Thompson J.,71,221,96,125,2023-06-17,'s-Hertogenbosch,Rosmalen Grass Court Championships,Grass,2.75,1.44,0
Ruusuvuori E.,55,158,79,79,Griekspoor T.,37,97,47,50,2023-06-17,'s-Hertogenbosch,Rosmalen Grass Court Championships,Grass,1.62,2.3,0
Struff J.L.,21,369,170,199,Hurkacz H.,17,238,137,101,2023-06-17,Stuttgart,Stuttgart Open,Grass,2.2,1.67,1
Struff J.L.,21,369,170,199,Tiafoe F.,10,303,158,145,2023-06-18,Stuttgart,Stuttgart Open,Grass,2.0,1.8,0
Griekspoor T.,37,97,47,50,Thompson J.,71,221,96,125,2023-06-18,'s-Hertogenbosch,Rosmalen Grass Court Championships,Grass,1.62,2.3,1
Peniston R.,268,13,6,7,Humbert U.,36,170,80,90,2023-06-19,Queens Club,Queen's Club Championships,Grass,4.5,1.2,1
Kecmanovic M.,40,210,107,103,Norrie C.,13,287,172,115,2023-06-19,Queens Club,Queen's Club Championships,Grass,3.4,1.33,0
Wolf J.J.,45,75,39,36,Shelton B.,43,34,13,21,2023-06-19,Queens Club,Queen's Club Championships,Grass,1.73,2.1,0
Korda S.,26,126,75,51,Evans D.,30,251,124,127,2023-06-19,Queens Club,Queen's Club Championships,Grass,1.8,2.0,1
Mcdonald M.,60,190,87,103,Schwartzman D.,95,428,233,195,2023-06-19,Queens Club,Queen's Club Championships,Grass,1.25,4.0,0
Choinski J.,151,6,1,5,Musetti L.,18,143,79,64,2023-06-19,Queens Club,Queen's Club Championships,Grass,8.0,1.08,0
Cerundolo F.,21,104,58,46,Paul T.,14,204,111,93,2023-06-19,Queens Club,Queen's Club Championships,Grass,3.4,1.33,1
Otte O.,233,78,33,45,Djere L.,38,243,120,123,2023-06-19,Halle,Halle Open,Grass,1.8,2.0,0
Medvedev D.,3,406,289,117,Giron M.,69,150,68,82,2023-06-19,Halle,Halle Open,Grass,1.13,6.0,1
Barrere G.,59,79,31,48,Tsitsipas S.,5,390,264,126,2023-06-19,Halle,Halle Open,Grass,4.5,1.2,0
Moutet C.,80,118,50,68,Jarry N.,28,141,73,68,2023-06-19,Halle,Halle Open,Grass,2.3,1.62,0
Shapovalov D.,29,298,166,132,Harris L.,186,129,59,70,2023-06-19,Halle,Halle Open,Grass,1.4,3.0,1
Nakashima B.,70,106,57,49,Ymer M.,59,130,58,72,2023-06-19,Halle,Halle Open,Grass,1.36,3.2,1
Rune H.,6,131,83,48,Cressy M.,96,96,42,54,2023-06-20,Queens Club,Queen's Club Championships,Grass,1.5,2.63,1
Lehecka J.,33,61,30,31,Davidovich Fokina A.,39,168,84,84,2023-06-20,Queens Club,Queen's Club Championships,Grass,2.2,1.67,1
Murray A.,44,932,687,245,De Minaur A.,19,272,161,111,2023-06-20,Queens Club,Queen's Club Championships,Grass,1.67,2.2,0
Tiafoe F.,10,303,158,145,Van De Zandschulp B.,44,117,63,54,2023-06-20,Queens Club,Queen's Club Championships,Grass,1.44,2.75,1
Dimitrov G.,20,651,389,262,Ruusuvuori E.,55,158,79,79,2023-06-20,Queens Club,Queen's Club Championships,Grass,1.67,2.2,1
Mannarino A.,27,567,264,303,Broady L.,125,47,18,29,2023-06-20,Queens Club,Queen's Club Championships,Grass,1.4,3.0,1
Zapata Miralles B.,54,80,32,48,Fritz T.,9,356,205,151,2023-06-20,Queens Club,Queen's Club Championships,Grass,10.0,1.06,0
Alcaraz C.,1,164,130,34,Rinderknech A.,67,96,46,50,2023-06-20,Queens Club,Queen's Club Championships,Grass,1.1,7.0,1
Thompson J.,71,221,96,125,Popyrin A.,90,140,59,81,2023-06-20,Queens Club,Queen's Club Championships,Grass,1.5,2.63,1
Vavassori A.,128,12,5,7,Bautista Agut R.,25,379,234,145,2023-06-20,Halle,Halle Open,Grass,4.5,1.2,0
Karatsev A.,75,136,66,70,Sonego L.,43,221,107,114,2023-06-20,Halle,Halle Open,Grass,3.0,1.4,0
Sinner J.,8,224,153,71,Gasquet R.,48,948,581,367,2023-06-20,Halle,Halle Open,Grass,1.2,4.5,1
Hanfmann Y.,50,99,50,49,Wessels L.,347,3,1,2,2023-06-20,Halle,Halle Open,Grass,1.22,4.33,1
Rublev A.,7,392,255,137,Wu Y.,90,36,15,21,2023-06-20,Halle,Halle Open,Grass,1.3,3.5,1
Carballes Baena R.,64,207,91,116,Griekspoor T.,37,97,47,50,2023-06-20,Halle,Halle Open,Grass,4.33,1.22,0
Thiem D.,116,517,327,190,Zverev A.,19,500,346,154,2023-06-20,Halle,Halle Open,Grass,6.0,1.13,0
Bublik A.,25,219,110,109,Coric B.,15,343,185,158,2023-06-20,Halle,Halle Open,Grass,1.8,2.0,1
Hurkacz H.,17,238,137,101,Eubanks C.,29,64,28,36,2023-06-20,Halle,Halle Open,Grass,1.3,3.5,1
Struff J.L.,21,369,170,199,Safiullin R.,92,42,20,22,2023-06-21,Halle,Halle Open,Grass,1.44,2.75,1
Bautista Agut R.,25,379,234,145,Nakashima B.,70,106,57,49,2023-06-21,Halle,Halle Open,Grass,1.67,2.2,1
Djere L.,38,243,120,123,Medvedev D.,3,406,289,117,2023-06-21,Halle,Halle Open,Grass,8.0,1.08,0
Tsitsipas S.,5,390,264,126,Jarry N.,28,141,73,68,2023-06-21,Halle,Halle Open,Grass,1.4,3.0,0
Shapovalov D.,29,298,166,132,Zverev A.,19,500,346,154,2023-06-21,Halle,Halle Open,Grass,3.0,1.4,0
Musetti L.,18,143,79,64,Shelton B.,43,34,13,21,2023-06-21,Queens Club,Queen's Club Championships,Grass,1.62,2.3,1
Norrie C.,13,287,172,115,Thompson J.,71,221,96,125,2023-06-21,Queens Club,Queen's Club Championships,Grass,1.5,2.63,1
Peniston R.,268,13,6,7,Rune H.,6,131,83,48,2023-06-21,Queens Club,Queen's Club Championships,Grass,3.5,1.3,0
Tiafoe F.,10,303,158,145,Korda S.,26,126,75,51,2023-06-21,Queens Club,Queen's Club Championships,Grass,1.62,2.3,0
De Minaur A.,19,272,161,111,Schwartzman D.,95,428,233,195,2023-06-22,Queens Club,Queen's Club Championships,Grass,1.14,5.5,1
Alcaraz C.,1,164,130,34,Lehecka J.,33,61,30,31,2023-06-22,Queens Club,Queen's Club Championships,Grass,1.2,4.5,1
Fritz T.,9,356,205,151,Mannarino A.,27,567,264,303,2023-06-22,Queens Club,Queen's Club Championships,Grass,1.29,3.75,0
Cerundolo F.,21,104,58,46,Dimitrov G.,20,651,389,262,2023-06-22,Queens Club,Queen's Club Championships,Grass,3.2,1.36,0
Bublik A.,25,219,110,109,Struff J.L.,21,369,170,199,2023-06-22,Halle,Halle Open,Grass,2.38,1.57,1
Griekspoor T.,37,97,47,50,Hurkacz H.,17,238,137,101,2023-06-22,Halle,Halle Open,Grass,2.5,1.53,1
Hanfmann Y.,50,99,50,49,Rublev A.,7,392,255,137,2023-06-22,Halle,Halle Open,Grass,4.5,1.2,0
Sonego L.,43,221,107,114,Sinner J.,8,224,153,71,2023-06-22,Halle,Halle Open,Grass,3.75,1.29,0
Dimitrov G.,20,651,389,262,Alcaraz C.,1,164,130,34,2023-06-23,Queens Club,Queen's Club Championships,Grass,3.2,1.36,0
Griekspoor T.,37,97,47,50,Rublev A.,7,392,255,137,2023-06-23,Halle,Halle Open,Grass,2.5,1.53,0
Medvedev D.,3,406,289,117,Bautista Agut R.,25,379,234,145,2023-06-23,Halle,Halle Open,Grass,1.33,3.4,0
Zverev A.,19,500,346,154,Jarry N.,28,141,73,68,2023-06-23,Halle,Halle Open,Grass,1.36,3.2,1
Bublik A.,25,219,110,109,Sinner J.,8,224,153,71,2023-06-23,Halle,Halle Open,Grass,3.4,1.33,1
Norrie C.,13,287,172,115,Korda S.,26,126,75,51,2023-06-23,Queens Club,Queen's Club Championships,Grass,2.0,1.8,0
Musetti L.,18,143,79,64,Rune H.,6,131,83,48,2023-06-23,Queens Club,Queen's Club Championships,Grass,2.38,1.57,0
Mannarino A.,27,567,264,303,De Minaur A.,19,272,161,111,2023-06-23,Queens Club,Queen's Club Championships,Grass,2.63,1.5,0
Rublev A.,7,392,255,137,Bautista Agut R.,25,379,234,145,2023-06-24,Halle,Halle Open,Grass,1.8,2.0,1
De Minaur A.,19,272,161,111,Rune H.,6,131,83,48,2023-06-24,Queens Club,Queen's Club Championships,Grass,1.91,1.91,1
Zverev A.,19,500,346,154,Bublik A.,25,219,110,109,2023-06-24,Halle,Halle Open,Grass,1.44,2.75,0
Korda S.,26,126,75,51,Alcaraz C.,1,164,130,34,2023-06-24,Queens Club,Queen's Club Championships,Grass,3.4,1.33,0
Giron M.,69,150,68,82,Pella G.,199,260,118,142,2023-06-25,Mallorca,Mallorca Championships,Grass,1.17,5.0,0
O Connell C.,74,65,26,39,Moutet C.,80,118,50,68,2023-06-25,Mallorca,Mallorca Championships,Grass,1.44,2.75,0
Bublik A.,25,219,110,109,Rublev A.,7,392,255,137,2023-06-25,Halle,Halle Open,Grass,2.2,1.67,1
Alcaraz C.,1,164,130,34,De Minaur A.,19,272,161,111,2023-06-25,Queens Club,Queen's Club Championships,Grass,1.29,3.75,1
Ruusuvuori E.,55,158,79,79,Barrere G.,59,79,31,48,2023-06-26,Eastbourne,Eastbourne International,Grass,1.4,3.0,0
Kotov P.,89,25,10,15,Tu L.,252,5,1,4,2023-06-26,Mallorca,Mallorca Championships,Grass,1.67,2.2,1
Safiullin R.,92,42,20,22,Shelbayh A.,240,6,1,5,2023-06-26,Mallorca,Mallorca Championships,Grass,1.4,3.0,1
Ivashka I.,113,159,78,81,Carballes Baena R.,64,207,91,116,2023-06-26,Mallorca,Mallorca Championships,Grass,1.25,4.0,0
Eubanks C.,29,64,28,36,Michelsen A.,140,7,4,3,2023-06-26,Mallorca,Mallorca Championships,Grass,1.5,2.63,1
Zapata Miralles B.,54,80,32,48,Harris L.,186,129,59,70,2023-06-26,Mallorca,Mallorca Championships,Grass,2.63,1.5,0
Cachin P.,54,52,23,29,Hanfmann Y.,50,99,50,49,2023-06-26,Mallorca,Mallorca Championships,Grass,2.75,1.44,0
Gasquet R.,48,948,581,367,Thompson J.,71,221,96,125,2023-06-26,Mallorca,Mallorca Championships,Grass,2.5,1.53,0
Borges N.,69,28,10,18,Baez S.,72,95,47,48,2023-06-26,Eastbourne,Eastbourne International,Grass,1.5,2.63,0
Huesler M.A.,88,58,21,37,Peniston R.,268,13,6,7,2023-06-26,Eastbourne,Eastbourne International,Grass,1.8,2.0,1
Vukic A.,62,36,15,21,Nakashima B.,70,106,57,49,2023-06-26,Eastbourne,Eastbourne International,Grass,3.2,1.36,1
Van Assche L.,68,20,7,13,Loffhagen G.,371,2,0,2,2023-06-26,Eastbourne,Eastbourne International,Grass,1.44,2.75,1
Wu Y.,90,36,15,21,Kecmanovic M.,40,210,107,103,2023-06-26,Eastbourne,Eastbourne International,Grass,1.73,2.1,0
Etcheverry T.,34,60,26,34,Wolf J.J.,45,75,39,36,2023-06-26,Eastbourne,Eastbourne International,Grass,2.2,1.67,0
Ramos-Vinolas A.,82,437,204,233,Rinderknech A.,67,96,46,50,2023-06-27,Mallorca,Mallorca Championships,Grass,4.0,1.25,0
Kubler J.,77,53,24,29,Lestienne C.,109,40,13,27,2023-06-27,Mallorca,Mallorca Championships,Grass,1.36,3.2,0
Moutet C.,80,118,50,68,Carballes Baena R.,64,207,91,116,2023-06-27,Mallorca,Mallorca Championships,Grass,1.4,3.0,1
Davidovich Fokina A.,39,168,84,84,Kotov P.,89,25,10,15,2023-06-27,Mallorca,Mallorca Championships,Grass,1.29,3.75,0
Safiullin R.,92,42,20,22,Harris L.,186,129,59,70,2023-06-27,Mallorca,Mallorca Championships,Grass,1.8,2.0,0
Mannarino A.,27,567,264,303,Pella G.,199,260,118,142,2023-06-27,Mallorca,Mallorca Championships,Grass,1.25,4.0,1
Lopez F.,634,863,441,422,Purcell M.,78,28,9,19,2023-06-27,Mallorca,Mallorca Championships,Grass,2.5,1.53,1
Mcdonald M.,60,190,87,103,Cecchinato M.,108,204,79,125,2023-06-27,Eastbourne,Eastbourne International,Grass,1.14,5.5,1
Choinski J.,151,6,1,5,Broady L.,125,47,18,29,2023-06-27,Eastbourne,Eastbourne International,Grass,3.2,1.36,0
Ymer M.,59,130,58,72,Van De Zandschulp B.,44,117,63,54,2023-06-27,Eastbourne,Eastbourne International,Grass,2.2,1.67,1
Galan D.E.,76,78,33,45,Cressy M.,96,96,42,54,2023-06-27,Eastbourne,Eastbourne International,Grass,3.0,1.4,0
Zhang Zh.,53,44,20,24,Sonego L.,43,221,107,114,2023-06-27,Eastbourne,Eastbourne International,Grass,4.5,1.2,1
Eubanks C.,29,64,28,36,Shelton B.,43,34,13,21,2023-06-28,Mallorca,Mallorca Championships,Grass,2.2,1.67,1
Lopez F.,634,863,441,422,Thompson J.,71,221,96,125,2023-06-28,Mallorca,Mallorca Championships,Grass,5.0,1.17,1
Kecmanovic M.,40,210,107,103,Vukic A.,62,36,15,21,2023-06-28,Eastbourne,Eastbourne International,Grass,1.57,2.38,1
Barrere G.,59,79,31,48,Jarry N.,28,141,73,68,2023-06-28,Eastbourne,Eastbourne International,Grass,2.5,1.53,1
Mcdonald M.,60,190,87,103,Fritz T.,9,356,205,151,2023-06-28,Eastbourne,Eastbourne International,Grass,3.5,1.3,1
Ymer M.,59,130,58,72,Broady L.,125,47,18,29,2023-06-28,Eastbourne,Eastbourne International,Grass,1.53,2.5,1
Van Assche L.,68,20,7,13,Wolf J.J.,45,75,39,36,2023-06-28,Eastbourne,Eastbourne International,Grass,3.2,1.36,0
Zhang Zh.,53,44,20,24,Cressy M.,96,96,42,54,2023-06-28,Eastbourne,Eastbourne International,Grass,2.63,1.5,1
Huesler M.A.,88,58,21,37,Cerundolo F.,21,104,58,46,2023-06-28,Eastbourne,Eastbourne International,Grass,2.0,1.8,0
Paul T.,14,204,111,93,Baez S.,72,95,47,48,2023-06-28,Eastbourne,Eastbourne International,Grass,1.2,4.5,1
Rinderknech A.,67,96,46,50,Lestienne C.,109,40,13,27,2023-06-28,Mallorca,Mallorca Championships,Grass,1.5,2.63,1
Hanfmann Y.,50,99,50,49,Tsitsipas S.,5,390,264,126,2023-06-28,Mallorca,Mallorca Championships,Grass,3.5,1.3,1
Kotov P.,89,25,10,15,Harris L.,186,129,59,70,2023-06-29,Mallorca,Mallorca Championships,Grass,3.2,1.36,0
Rinderknech A.,67,96,46,50,Eubanks C.,29,64,28,36,2023-06-29,Mallorca,Mallorca Championships,Grass,1.73,2.1,0
Lopez F.,634,863,441,422,Hanfmann Y.,50,99,50,49,2023-06-29,Mallorca,Mallorca Championships,Grass,2.75,1.44,0
Moutet C.,80,118,50,68,Mannarino A.,27,567,264,303,2023-06-29,Mallorca,Mallorca Championships,Grass,2.75,1.44,0
Wolf J.J.,45,75,39,36,Paul T.,14,204,111,93,2023-06-29,Eastbourne,Eastbourne International,Grass,2.63,1.5,0
Kecmanovic M.,40,210,107,103,Barrere G.,59,79,31,48,2023-06-29,Eastbourne,Eastbourne International,Grass,1.91,1.91,0
Zhang Zh.,53,44,20,24,Cerundolo F.,21,104,58,46,2023-06-29,Eastbourne,Eastbourne International,Grass,2.1,1.73,0
Ymer M.,59,130,58,72,Mcdonald M.,60,190,87,103,2023-06-29,Eastbourne,Eastbourne International,Grass,2.2,1.67,0
Eubanks C.,29,64,28,36,Harris L.,186,129,59,70,2023-06-30,Mallorca,Mallorca Championships,Grass,2.1,1.73,1
Hanfmann Y.,50,99,50,49,Mannarino A.,27,567,264,303,2023-06-30,Mallorca,Mallorca Championships,Grass,1.91,1.91,0
Cerundolo F.,21,104,58,46,Paul T.,14,204,111,93,2023-07-01,Eastbourne,Eastbourne International,Grass,2.2,1.67,1
Paul T.,14,204,111,93,Barrere G.,59,79,31,48,2023-07-01,Eastbourne,Eastbourne International,Grass,1.44,2.75,1
Mannarino A.,27,567,264,303,Eubanks C.,29,64,28,36,2023-07-01,Mallorca,Mallorca Championships,Grass,1.5,2.63,0
Cerundolo F.,21,104,58,46,Mcdonald M.,60,190,87,103,2023-07-01,Eastbourne,Eastbourne International,Grass,1.67,2.2,1
Sinner J.,8,224,153,71,Cerundolo J.M.,106,29,12,17,2023-07-03,London,Wimbledon,Grass,1.02,19.0,1
Lokoli L.,199,8,0,8,Ruud C.,4,275,176,99,2023-07-03,London,Wimbledon,Grass,5.0,1.17,0
Lajovic D.,66,378,163,215,Choinski J.,151,6,1,5,2023-07-03,London,Wimbledon,Grass,1.5,2.63,0
Molcan A.,120,86,45,41,Ymer M.,59,130,58,72,2023-07-03,London,Wimbledon,Grass,2.75,1.44,0
Otte O.,233,78,33,45,Koepfer D.,84,86,38,48,2023-07-03,London,Wimbledon,Grass,1.62,2.3,1
Ruusuvuori E.,55,158,79,79,Wawrinka S.,72,854,535,319,2023-07-03,London,Wimbledon,Grass,1.4,3.0,0
Vukic A.,62,36,15,21,Altmaier D.,51,79,28,51,2023-07-03,London,Wimbledon,Grass,1.44,2.75,1
Kecmanovic M.,40,210,107,103,Schwartzman D.,95,428,233,195,2023-07-03,London,Wimbledon,Grass,1.44,2.75,0
Isner J.,114,755,465,290,Munar J.,104,178,75,103,2023-07-03,London,Wimbledon,Grass,1.36,3.2,0
Nishioka Y.,31,215,99,116,Galan D.E.,76,78,33,45,2023-07-03,London,Wimbledon,Grass,1.73,2.1,0
Mcdonald M.,60,190,87,103,Bublik A.,25,219,110,109,2023-07-03,London,Wimbledon,Grass,2.75,1.44,0
Wolf J.J.,45,75,39,36,Couacaud E.,158,9,2,7,2023-07-03,London,Wimbledon,Grass,1.22,4.33,1
Gojo B.,115,14,3,11,Marterer M.,144,91,31,60,2023-07-03,London,Wimbledon,Grass,1.8,2.0,0
Goffin D.,123,522,296,226,Marozsan F.,87,7,4,3,2023-07-03,London,Wimbledon,Grass,1.44,2.75,1
Gasquet R.,48,948,581,367,Moutet C.,80,118,50,68,2023-07-03,London,Wimbledon,Grass,1.57,2.38,0
Mmoh M.,112,55,20,35,Auger-Aliassime F.,12,268,163,105,2023-07-03,London,Wimbledon,Grass,6.5,1.11,1
Cachin P.,54,52,23,29,Djokovic N.,2,1207,1012,195,2023-07-03,London,Wimbledon,Grass,34.0,1.01,0
Ramos-Vinolas A.,82,437,204,233,Hurkacz H.,17,238,137,101,2023-07-03,London,Wimbledon,Grass,10.0,1.06,0
Purcell M.,78,28,9,19,Rublev A.,7,392,255,137,2023-07-03,London,Wimbledon,Grass,10.0,1.06,0
Nakashima B.,70,106,57,49,Thompson J.,71,221,96,125,2023-07-03,London,Wimbledon,Grass,1.91,1.91,0
Karatsev A.,75,136,66,70,Van Assche L.,68,20,7,13,2023-07-03,London,Wimbledon,Grass,1.73,2.1,1
Varillas J.P.,77,22,10,12,Musetti L.,18,143,79,64,2023-07-03,London,Wimbledon,Grass,10.0,1.06,0
Barrios M.,121,10,3,7,Baez S.,72,95,47,48,2023-07-03,London,Wimbledon,Grass,2.1,1.73,1
Lestienne C.,109,40,13,27,Broady L.,125,47,18,29,2023-07-03,London,Wimbledon,Grass,2.63,1.5,0
Etcheverry T.,34,60,26,34,Zapata Miralles B.,54,80,32,48,2023-07-04,London,Wimbledon,Grass,1.44,2.75,1
Norrie C.,13,287,172,115,Machac T.,108,18,6,12,2023-07-04,London,Wimbledon,Grass,1.22,4.33,1
Evans D.,30,251,124,127,Halys Q.,79,72,23,49,2023-07-04,London,Wimbledon,Grass,1.8,2.0,0
Chardy J.,542,591,289,302,Alcaraz C.,1,164,130,34,2023-07-04,London,Wimbledon,Grass,29.0,1.01,0
Murray A.,44,932,687,245,Peniston R.,268,13,6,7,2023-07-04,London,Wimbledon,Grass,1.1,7.0,1
Tsitsipas S.,5,390,264,126,Thiem D.,116,517,327,190,2023-07-05,London,Wimbledon,Grass,1.17,5.0,1
Schwartzman D.,95,428,233,195,Sinner J.,8,224,153,71,2023-07-05,London,Wimbledon,Grass,11.0,1.05,0
Thompson J.,71,221,96,125,Djokovic N.,2,1207,1012,195,2023-07-05,London,Wimbledon,Grass,15.0,1.03,0
Fucsovics M.,67,249,121,128,Griekspoor T.,37,97,47,50,2023-07-05,London,Wimbledon,Grass,2.0,1.8,1
Djere L.,38,243,120,123,Cressy M.,96,96,42,54,2023-07-05,London,Wimbledon,Grass,2.2,1.67,1
Shevchenko A.,93,20,8,12,Mannarino A.,27,567,264,303,2023-07-05,London,Wimbledon,Grass,4.5,1.2,0
Shelton B.,43,34,13,21,Daniel T.,111,178,67,111,2023-07-05,London,Wimbledon,Grass,1.36,3.2,1
Ivashka I.,113,159,78,81,Coria F.,108,99,43,56,2023-07-05,London,Wimbledon,Grass,1.08,8.0,1
Giron M.,69,150,68,82,Dellien H.,164,70,22,48,2023-07-05,London,Wimbledon,Grass,1.03,15.0,1
Eubanks C.,29,64,28,36,Monteiro T.,121,171,69,102,2023-07-05,London,Wimbledon,Grass,1.25,4.0,1
Korda S.,26,126,75,51,Vesely J.,528,288,130,158,2023-07-05,London,Wimbledon,Grass,1.1,7.0,0
Loffhagen G.,371,2,0,2,Rune H.,6,131,83,48,2023-07-05,London,Wimbledon,Grass,11.0,1.05,0
Albot R.,97,215,86,129,Shapovalov D.,29,298,166,132,2023-07-05,London,Wimbledon,Grass,4.5,1.2,0
Safiullin R.,92,42,20,22,Bautista Agut R.,25,379,234,145,2023-07-05,London,Wimbledon,Grass,3.5,1.3,1
Paul T.,14,204,111,93,Mochizuki S.,200,8,0,8,2023-07-05,London,Wimbledon,Grass,1.11,6.5,1
Cerundolo F.,21,104,58,46,Borges N.,69,28,10,18,2023-07-05,London,Wimbledon,Grass,1.22,4.33,1
Stricker D.,106,20,10,10,Popyrin A.,90,140,59,81,2023-07-05,London,Wimbledon,Grass,1.62,2.3,1
Novak D.,166,58,15,43,Raonic M.,849,540,361,179,2023-07-05,London,Wimbledon,Grass,1.91,1.91,0
Lehecka J.,33,61,30,31,Ofner S.,61,34,16,18,2023-07-05,London,Wimbledon,Grass,1.57,2.38,1
Dimitrov G.,20,651,389,262,Shimabukuro S.,161,4,1,3,2023-07-05,London,Wimbledon,Grass,1.05,11.0,1
Wu Y.,90,36,15,21,Tiafoe F.,10,303,158,145,2023-07-05,London,Wimbledon,Grass,5.5,1.14,0
Medvedev D.,3,406,289,117,Fery A.,391,1,0,1,2023-07-05,London,Wimbledon,Grass,1.01,29.0,1
Pella G.,199,260,118,142,Coric B.,15,343,185,158,2023-07-05,London,Wimbledon,Grass,3.2,1.36,1
Rinderknech A.,67,96,46,50,Muller A.,81,22,9,13,2023-07-05,London,Wimbledon,Grass,1.22,4.33,0
Hanfmann Y.,50,99,50,49,Fritz T.,9,356,205,151,2023-07-05,London,Wimbledon,Grass,4.33,1.22,0
Mayot H.,181,4,1,3,Bonzi B.,107,83,37,46,2023-07-05,London,Wimbledon,Grass,1.62,2.3,1
Harris L.,186,129,59,70,Barrere G.,59,79,31,48,2023-07-05,London,Wimbledon,Grass,1.73,2.1,0
Moutet C.,80,118,50,68,Safiullin R.,92,42,20,22,2023-07-06,London,Wimbledon,Grass,2.2,1.67,0
Rublev A.,7,392,255,137,Karatsev A.,75,136,66,70,2023-07-06,London,Wimbledon,Grass,1.2,4.5,1
Ruud C.,4,275,176,99,Broady L.,125,47,18,29,2023-07-06,London,Wimbledon,Grass,1.2,4.5,0
Otte O.,233,78,33,45,Galan D.E.,76,78,33,45,2023-07-06,London,Wimbledon,Grass,1.44,2.75,0
Paul T.,14,204,111,93,Raonic M.,849,540,361,179,2023-07-06,London,Wimbledon,Grass,1.44,2.75,1
Tiafoe F.,10,303,158,145,Stricker D.,106,20,10,10,2023-07-06,London,Wimbledon,Grass,1.2,4.5,1
Cerundolo F.,21,104,58,46,Lehecka J.,33,61,30,31,2023-07-06,London,Wimbledon,Grass,1.8,2.0,0
Pella G.,199,260,118,142,Mayot H.,181,4,1,3,2023-07-06,London,Wimbledon,Grass,2.2,1.67,1
Ymer M.,59,130,58,72,Fritz T.,9,356,205,151,2023-07-06,London,Wimbledon,Grass,4.5,1.2,1
Barrere G.,59,79,31,48,Shapovalov D.,29,298,166,132,2023-07-06,London,Wimbledon,Grass,2.38,1.57,0
Shelton B.,43,34,13,21,Djere L.,38,243,120,123,2023-07-06,London,Wimbledon,Grass,1.53,2.5,0
Dimitrov G.,20,651,389,262,Ivashka I.,113,159,78,81,2023-07-06,London,Wimbledon,Grass,1.17,5.0,1
Goffin D.,123,522,296,226,Barrios M.,121,10,3,7,2023-07-06,London,Wimbledon,Grass,1.36,3.2,1
Wolf J.J.,45,75,39,36,Bublik A.,25,219,110,109,2023-07-06,London,Wimbledon,Grass,2.75,1.44,0
Musetti L.,18,143,79,64,Munar J.,104,178,75,103,2023-07-06,London,Wimbledon,Grass,1.14,5.5,1
Hurkacz H.,17,238,137,101,Choinski J.,151,6,1,5,2023-07-06,London,Wimbledon,Grass,1.07,9.0,1
Fils A.,71,24,15,9,Davidovich Fokina A.,39,168,84,84,2023-07-06,London,Wimbledon,Grass,2.2,1.67,0
Van De Zandschulp B.,44,117,63,54,Zhang Zh.,53,44,20,24,2023-07-06,London,Wimbledon,Grass,1.67,2.2,1
Mmoh M.,112,55,20,35,Marterer M.,144,91,31,60,2023-07-06,London,Wimbledon,Grass,2.0,1.8,0
Watanuki Y.,99,25,11,14,Huesler M.A.,88,58,21,37,2023-07-06,London,Wimbledon,Grass,1.8,2.0,1
Brouwer G.,144,21,11,10,Zverev A.,19,500,346,154,2023-07-06,London,Wimbledon,Grass,9.0,1.07,0
Medjedovic H.,147,11,3,8,O Connell C.,74,65,26,39,2023-07-06,London,Wimbledon,Grass,2.3,1.62,0
Arnaldi M.,76,18,9,9,Carballes Baena R.,64,207,91,116,2023-07-06,London,Wimbledon,Grass,1.44,2.75,0
Kubler J.,77,53,24,29,Humbert U.,36,170,80,90,2023-07-06,London,Wimbledon,Grass,2.3,1.62,1
Cecchinato M.,108,204,79,125,Jarry N.,28,141,73,68,2023-07-06,London,Wimbledon,Grass,11.0,1.05,0
Berrettini M.,38,217,142,75,Sonego L.,43,221,107,114,2023-07-06,London,Wimbledon,Grass,2.5,1.53,1
Wawrinka S.,72,854,535,319,Etcheverry T.,34,60,26,34,2023-07-06,London,Wimbledon,Grass,1.5,2.63,1
Halys Q.,79,72,23,49,Vukic A.,62,36,15,21,2023-07-06,London,Wimbledon,Grass,1.67,2.2,1
De Minaur A.,19,272,161,111,Coppejans K.,188,11,0,11,2023-07-06,London,Wimbledon,Grass,1.03,17.0,1
Tsitsipas S.,5,390,264,126,Murray A.,44,932,687,245,2023-07-07,London,Wimbledon,Grass,2.1,1.73,1
Goffin D.,123,522,296,226,Rublev A.,7,392,255,137,2023-07-07,London,Wimbledon,Grass,4.5,1.2,0
Safiullin R.,92,42,20,22,Pella G.,199,260,118,142,2023-07-07,London,Wimbledon,Grass,1.44,2.75,1
Broady L.,125,47,18,29,Shapovalov D.,29,298,166,132,2023-07-07,London,Wimbledon,Grass,3.75,1.29,0
Ymer M.,59,130,58,72,Galan D.E.,76,78,33,45,2023-07-07,London,Wimbledon,Grass,1.4,3.0,0
Marterer M.,144,91,31,60,Bublik A.,25,219,110,109,2023-07-07,London,Wimbledon,Grass,5.5,1.14,0
Wawrinka S.,72,854,535,319,Djokovic N.,2,1207,1012,195,2023-07-07,London,Wimbledon,Grass,15.0,1.04,0
Musetti L.,18,143,79,64,Hurkacz H.,17,238,137,101,2023-07-07,London,Wimbledon,Grass,2.3,1.62,0
Eubanks C.,29,64,28,36,Norrie C.,13,287,172,115,2023-07-07,London,Wimbledon,Grass,3.5,1.3,1
Halys Q.,79,72,23,49,Sinner J.,8,224,153,71,2023-07-07,London,Wimbledon,Grass,5.5,1.14,0
Muller A.,81,22,9,13,Alcaraz C.,1,164,130,34,2023-07-07,London,Wimbledon,Grass,21.0,1.02,0
Watanuki Y.,99,25,11,14,Zverev A.,19,500,346,154,2023-07-07,London,Wimbledon,Grass,6.0,1.13,0
Van De Zandschulp B.,44,117,63,54,Davidovich Fokina A.,39,168,84,84,2023-07-07,London,Wimbledon,Grass,2.5,1.53,0
Medvedev D.,3,406,289,117,Mannarino A.,27,567,264,303,2023-07-07,London,Wimbledon,Grass,1.22,4.33,1
Giron M.,69,150,68,82,Fucsovics M.,67,249,121,128,2023-07-07,London,Wimbledon,Grass,3.2,1.36,0
Berrettini M.,38,217,142,75,De Minaur A.,19,272,161,111,2023-07-07,London,Wimbledon,Grass,2.38,1.57,1
Vesely J.,528,288,130,158,O Connell C.,74,65,26,39,2023-07-07,London,Wimbledon,Grass,1.91,1.91,0
Rune H.,6,131,83,48,Carballes Baena R.,64,207,91,116,2023-07-07,London,Wimbledon,Grass,1.06,10.0,1
Jarry N.,28,141,73,68,Kubler J.,77,53,24,29,2023-07-07,London,Wimbledon,Grass,1.57,2.38,1
Berrettini M.,38,217,142,75,Zverev A.,19,500,346,154,2023-07-08,London,Wimbledon,Grass,2.0,1.8,1
Djere L.,38,243,120,123,Tsitsipas S.,5,390,264,126,2023-07-08,London,Wimbledon,Grass,4.5,1.2,0
Jarry N.,28,141,73,68,Alcaraz C.,1,164,130,34,2023-07-08,London,Wimbledon,Grass,8.0,1.08,0
Rune H.,6,131,83,48,Davidovich Fokina A.,39,168,84,84,2023-07-08,London,Wimbledon,Grass,1.4,3.0,1
O Connell C.,74,65,26,39,Eubanks C.,29,64,28,36,2023-07-08,London,Wimbledon,Grass,2.5,1.53,0
Lehecka J.,33,61,30,31,Paul T.,14,204,111,93,2023-07-08,London,Wimbledon,Grass,2.0,1.8,1
Medvedev D.,3,406,289,117,Fucsovics M.,67,249,121,128,2023-07-08,London,Wimbledon,Grass,1.22,4.33,1
Tiafoe F.,10,303,158,145,Dimitrov G.,20,651,389,262,2023-07-09,London,Wimbledon,Grass,1.8,2.0,0
Rublev A.,7,392,255,137,Bublik A.,25,219,110,109,2023-07-09,London,Wimbledon,Grass,1.8,2.0,1
Shapovalov D.,29,298,166,132,Safiullin R.,92,42,20,22,2023-07-09,London,Wimbledon,Grass,1.57,2.38,0
Galan D.E.,76,78,33,45,Sinner J.,8,224,153,71,2023-07-09,London,Wimbledon,Grass,13.0,1.04,0
Lehecka J.,33,61,30,31,Medvedev D.,3,406,289,117,2023-07-10,London,Wimbledon,Grass,4.0,1.25,0
Eubanks C.,29,64,28,36,Tsitsipas S.,5,390,264,126,2023-07-10,London,Wimbledon,Grass,3.2,1.36,1
Hurkacz H.,17,238,137,101,Djokovic N.,2,1207,1012,195,2023-07-10,London,Wimbledon,Grass,11.0,1.05,0
Dimitrov G.,20,651,389,262,Rune H.,6,131,83,48,2023-07-10,London,Wimbledon,Grass,1.57,2.38,0
Alcaraz C.,1,164,130,34,Berrettini M.,38,217,142,75,2023-07-10,London,Wimbledon,Grass,1.4,3.0,1
Sinner J.,8,224,153,71,Safiullin R.,92,42,20,22,2023-07-11,London,Wimbledon,Grass,1.14,5.5,1
Djokovic N.,2,1207,1012,195,Rublev A.,7,392,255,137,2023-07-11,London,Wimbledon,Grass,1.07,9.0,1
Alcaraz C.,1,164,130,34,Rune H.,6,131,83,48,2023-07-12,London,Wimbledon,Grass,1.22,4.33,1
Eubanks C.,29,64,28,36,Medvedev D.,3,406,289,117,2023-07-12,London,Wimbledon,Grass,5.0,1.17,0
Djokovic N.,2,1207,1012,195,Sinner J.,8,224,153,71,2023-07-14,London,Wimbledon,Grass,1.2,4.5,1
Alcaraz C.,1,164,130,34,Medvedev D.,3,406,289,117,2023-07-14,London,Wimbledon,Grass,1.36,3.2,1
Alcaraz C.,1,164,130,34,Djokovic N.,2,1207,1012,195,2023-07-16,London,Wimbledon,Grass,2.63,1.53,1
Bergs Z.,175,15,4,11,Djere L.,38,243,120,123,2023-07-17,Gstaad,Suisse Open Gstaad,Clay,3.2,1.36,1
Munar J.,104,178,75,103,Ritschard A.,163,9,3,6,2023-07-17,Gstaad,Suisse Open Gstaad,Clay,1.44,2.75,1
Medjedovic H.,147,11,3,8,Zhang Zh.,53,44,20,24,2023-07-17,Gstaad,Suisse Open Gstaad,Clay,1.73,2.1,1
Muller A.,81,22,9,13,Thiem D.,116,517,327,190,2023-07-17,Gstaad,Suisse Open Gstaad,Clay,2.1,1.73,0
Huesler M.A.,88,58,21,37,Rodionov J.,118,26,9,17,2023-07-17,Gstaad,Suisse Open Gstaad,Clay,1.73,2.1,0
Mochizuki S.,200,8,0,8,Broady L.,125,47,18,29,2023-07-17,Newport,Hall of Fame Championships,Grass,2.75,1.44,0
Kovacevic A.,129,14,6,8,Thompson J.,71,221,96,125,2023-07-17,Newport,Hall of Fame Championships,Grass,3.5,1.3,0
Moutet C.,80,118,50,68,Spizzirri E.,0,1,0,1,2023-07-17,Newport,Hall of Fame Championships,Grass,1.1,7.0,1
Hijikata R.,110,16,7,9,Shelbayh A.,240,6,1,5,2023-07-17,Newport,Hall of Fame Championships,Grass,1.44,2.75,1
Galan D.E.,76,78,33,45,Monteiro T.,121,171,69,102,2023-07-17,Bastad,Nordea Open,Clay,1.73,2.1,0
Madaras D.,191,2,0,2,Van Assche L.,68,20,7,13,2023-07-17,Bastad,Nordea Open,Clay,3.2,1.36,0
Bonzi B.,107,83,37,46,Altmaier D.,51,79,28,51,2023-07-17,Gstaad,Suisse Open Gstaad,Clay,3.0,1.4,0
Bolt A.,345,40,13,27,Isner J.,114,755,465,290,2023-07-18,Newport,Hall of Fame Championships,Grass,2.3,1.62,0
Brouwer G.,144,21,11,10,Purcell M.,78,28,9,19,2023-07-18,Newport,Hall of Fame Championships,Grass,2.0,1.8,1
Lestienne C.,109,40,13,27,Duckworth J.,123,143,55,88,2023-07-18,Newport,Hall of Fame Championships,Grass,2.1,1.73,0
Mukund S.,356,3,0,3,Quinn E.,394,3,1,2,2023-07-18,Newport,Hall of Fame Championships,Grass,1.91,1.91,0
Wawrinka S.,72,854,535,319,Carballes Baena R.,64,207,91,116,2023-07-18,Gstaad,Suisse Open Gstaad,Clay,1.44,2.75,1
Fognini F.,128,742,383,359,Ramos-Vinolas A.,82,437,204,233,2023-07-18,Gstaad,Suisse Open Gstaad,Clay,2.1,1.73,0
Stricker D.,106,20,10,10,Fils A.,71,24,15,9,2023-07-18,Gstaad,Suisse Open Gstaad,Clay,2.2,1.67,1
Virtanen O.,127,2,0,2,Varillas J.P.,77,22,10,12,2023-07-18,Gstaad,Suisse Open Gstaad,Clay,3.5,1.3,0
Daniel T.,111,178,67,111,Cachin P.,54,52,23,29,2023-07-18,Gstaad,Suisse Open Gstaad,Clay,2.2,1.67,0
Johnson S.,197,395,196,199,Chung Y.,322,2,0,2,2023-07-18,Newport,Hall of Fame Championships,Grass,1.4,3.0,1
Diallo G.,140,3,0,3,Anderson K.,652,598,347,251,2023-07-18,Newport,Hall of Fame Championships,Grass,1.53,2.5,0
Vukic A.,62,36,15,21,Tu L.,252,5,1,4,2023-07-18,Newport,Hall of Fame Championships,Grass,1.29,3.75,0
Michelsen A.,140,7,4,3,Cressy M.,96,96,42,54,2023-07-18,Newport,Hall of Fame Championships,Grass,2.75,1.44,1
Rinderknech A.,67,96,46,50,Bagnis F.,135,121,39,82,2023-07-18,Gstaad,Suisse Open Gstaad,Clay,1.62,2.3,0
Etcheverry T.,34,60,26,34,Ofner S.,61,34,16,18,2023-07-18,Bastad,Nordea Open,Clay,1.4,3.0,0
Shevchenko A.,93,20,8,12,Cerundolo J.M.,106,29,12,17,2023-07-18,Bastad,Nordea Open,Clay,2.1,1.73,1
Zverev A.,19,500,346,154,Molcan A.,120,86,45,41,2023-07-18,Bastad,Nordea Open,Clay,1.14,5.5,1
Dellien H.,164,70,22,48,Zapata Miralles B.,54,80,32,48,2023-07-18,Bastad,Nordea Open,Clay,2.3,1.62,0
Cecchinato M.,108,204,79,125,Kotov P.,89,25,10,15,2023-07-18,Bastad,Nordea Open,Clay,1.62,2.3,0
Misolic F.,158,11,6,5,Lajovic D.,66,378,163,215,2023-07-18,Bastad,Nordea Open,Clay,2.3,1.62,1
Kovalik J.,172,68,24,44,Davidovich Fokina A.,39,168,84,84,2023-07-18,Bastad,Nordea Open,Clay,6.5,1.11,1
Ymer E.,186,81,24,57,Borg L.,437,4,1,3,2023-07-18,Bastad,Nordea Open,Clay,1.08,8.0,0
Baez S.,72,95,47,48,Coria F.,108,99,43,56,2023-07-18,Bastad,Nordea Open,Clay,1.33,3.4,0
Arnaldi M.,76,18,9,9,Ruusuvuori E.,55,158,79,79,2023-07-18,Bastad,Nordea Open,Clay,1.91,1.91,1
Johnson S.,197,395,196,199,Humbert U.,36,170,80,90,2023-07-19,Newport,Hall of Fame Championships,Grass,3.2,1.36,0
Tu L.,252,5,1,4,Mcdonald M.,60,190,87,103,2023-07-19,Newport,Hall of Fame Championships,Grass,4.5,1.2,0
Stricker D.,106,20,10,10,Kecmanovic M.,40,210,107,103,2023-07-19,Gstaad,Suisse Open Gstaad,Clay,1.73,2.1,0
Altmaier D.,51,79,28,51,Hanfmann Y.,50,99,50,49,2023-07-19,Gstaad,Suisse Open Gstaad,Clay,2.38,1.57,0
Cerundolo F.,21,104,58,46,Van Assche L.,68,20,7,13,2023-07-19,Bastad,Nordea Open,Clay,1.36,3.2,1
Bergs Z.,175,15,4,11,Rodionov J.,118,26,9,17,2023-07-19,Gstaad,Suisse Open Gstaad,Clay,1.73,2.1,1
Arnaldi M.,76,18,9,9,Musetti L.,18,143,79,64,2023-07-19,Bastad,Nordea Open,Clay,3.2,1.36,0
Borg L.,437,4,1,3,Coria F.,108,99,43,56,2023-07-19,Bastad,Nordea Open,Clay,5.0,1.17,0
Moutet C.,80,118,50,68,Isner J.,114,755,465,290,2023-07-19,Newport,Hall of Fame Championships,Grass,1.91,1.91,0
Broady L.,125,47,18,29,Thompson J.,71,221,96,125,2023-07-19,Newport,Hall of Fame Championships,Grass,2.63,1.5,0
Mannarino A.,27,567,264,303,Hijikata R.,110,16,7,9,2023-07-19,Newport,Hall of Fame Championships,Grass,1.5,2.63,1
Brouwer G.,144,21,11,10,Anderson K.,652,598,347,251,2023-07-19,Newport,Hall of Fame Championships,Grass,2.1,1.73,0
Paul T.,14,204,111,93,Quinn E.,394,3,1,2,2023-07-19,Newport,Hall of Fame Championships,Grass,1.06,10.0,1
Duckworth J.,123,143,55,88,Michelsen A.,140,7,4,3,2023-07-19,Newport,Hall of Fame Championships,Grass,2.38,1.57,0
Medjedovic H.,147,11,3,8,Thiem D.,116,517,327,190,2023-07-19,Gstaad,Suisse Open Gstaad,Clay,2.5,1.53,1
Kovalik J.,172,68,24,44,Misolic F.,158,11,6,5,2023-07-19,Bastad,Nordea Open,Clay,2.0,1.8,0
Thompson J.,71,221,96,125,Mannarino A.,27,567,264,303,2023-07-20,Newport,Hall of Fame Championships,Grass,1.67,2.2,0
Ofner S.,61,34,16,18,Zapata Miralles B.,54,80,32,48,2023-07-20,Bastad,Nordea Open,Clay,1.67,2.2,1
Humbert U.,36,170,80,90,Anderson K.,652,598,347,251,2023-07-20,Newport,Hall of Fame Championships,Grass,1.67,2.2,1
Wawrinka S.,72,854,535,319,Munar J.,104,178,75,103,2023-07-20,Gstaad,Suisse Open Gstaad,Clay,1.4,3.0,0
Bautista Agut R.,25,379,234,145,Cachin P.,54,52,23,29,2023-07-20,Gstaad,Suisse Open Gstaad,Clay,1.67,2.2,0
Sonego L.,43,221,107,114,Ramos-Vinolas A.,82,437,204,233,2023-07-20,Gstaad,Suisse Open Gstaad,Clay,1.4,3.0,0
Bagnis F.,135,121,39,82,Varillas J.P.,77,22,10,12,2023-07-20,Gstaad,Suisse Open Gstaad,Clay,2.75,1.44,0
Ruud C.,4,275,176,99,Shevchenko A.,93,20,8,12,2023-07-20,Bastad,Nordea Open,Clay,1.14,5.5,1
Monteiro T.,121,171,69,102,Zverev A.,19,500,346,154,2023-07-20,Bastad,Nordea Open,Clay,5.5,1.14,0
Rublev A.,7,392,255,137,Kotov P.,89,25,10,15,2023-07-20,Bastad,Nordea Open,Clay,1.17,5.0,1
Michelsen A.,140,7,4,3,Mcdonald M.,60,190,87,103,2023-07-21,Newport,Hall of Fame Championships,Grass,2.5,1.53,1
Cerundolo F.,21,104,58,46,Coria F.,108,99,43,56,2023-07-21,Bastad,Nordea Open,Clay,1.29,3.75,1
Rublev A.,7,392,255,137,Zverev A.,19,500,346,154,2023-07-21,Bastad,Nordea Open,Clay,2.1,1.73,1
Ruud C.,4,275,176,99,Ofner S.,61,34,16,18,2023-07-21,Bastad,Nordea Open,Clay,1.17,5.0,1
Cachin P.,54,52,23,29,Munar J.,104,178,75,103,2023-07-21,Gstaad,Suisse Open Gstaad,Clay,2.0,1.8,1
Isner J.,114,755,465,290,Paul T.,14,204,111,93,2023-07-21,Newport,Hall of Fame Championships,Grass,2.75,1.44,1
Kecmanovic M.,40,210,107,103,Bergs Z.,175,15,4,11,2023-07-21,Gstaad,Suisse Open Gstaad,Clay,1.44,2.75,1
Varillas J.P.,77,22,10,12,Ramos-Vinolas A.,82,437,204,233,2023-07-21,Gstaad,Suisse Open Gstaad,Clay,1.57,2.38,0
Medjedovic H.,147,11,3,8,Hanfmann Y.,50,99,50,49,2023-07-21,Gstaad,Suisse Open Gstaad,Clay,2.5,1.53,1
Misolic F.,158,11,6,5,Musetti L.,18,143,79,64,2023-07-21,Bastad,Nordea Open,Clay,6.0,1.13,0
Michelsen A.,140,7,4,3,Isner J.,114,755,465,290,2023-07-22,Newport,Hall of Fame Championships,Grass,2.0,1.8,1
Cachin P.,54,52,23,29,Medjedovic H.,147,11,3,8,2023-07-22,Gstaad,Suisse Open Gstaad,Clay,1.73,2.1,1
Cerundolo F.,21,104,58,46,Rublev A.,7,392,255,137,2023-07-22,Bastad,Nordea Open,Clay,2.38,1.57,0
Ramos-Vinolas A.,82,437,204,233,Kecmanovic M.,40,210,107,103,2023-07-22,Gstaad,Suisse Open Gstaad,Clay,2.2,1.67,1
Ruud C.,4,275,176,99,Musetti L.,18,143,79,64,2023-07-22,Bastad,Nordea Open,Clay,1.44,2.75,1
Humbert U.,36,170,80,90,Mannarino A.,27,567,264,303,2023-07-22,Newport,Hall of Fame Championships,Grass,2.0,1.8,0
Michelsen A.,140,7,4,3,Mannarino A.,27,567,264,303,2023-07-23,Newport,Hall of Fame Championships,Grass,2.2,1.67,0
Rublev A.,7,392,255,137,Ruud C.,4,275,176,99,2023-07-23,Bastad,Nordea Open,Clay,2.5,1.53,1
Ramos-Vinolas A.,82,437,204,233,Cachin P.,54,52,23,29,2023-07-23,Gstaad,Suisse Open Gstaad,Clay,2.2,1.67,0
Landaluce M.,720,3,0,3,Daniel T.,111,178,67,111,2023-07-24,Umag,Croatia Open,Clay,4.33,1.22,0
Djere L.,38,243,120,123,Etcheverry T.,34,60,26,34,2023-07-24,Hamburg,European Open,Clay,2.3,1.62,1
Van Assche L.,68,20,7,13,Muller A.,81,22,9,13,2023-07-24,Hamburg,European Open,Clay,1.67,2.2,1
Prizmic D.,287,5,2,3,Ajdukovic D.,299,4,1,3,2023-07-24,Umag,Croatia Open,Clay,1.53,2.5,1
Bonzi B.,107,83,37,46,Popyrin A.,90,140,59,81,2023-07-24,Umag,Croatia Open,Clay,2.3,1.62,0
Thiem D.,116,517,327,190,Bagnis F.,135,121,39,82,2023-07-24,Umag,Croatia Open,Clay,1.53,2.5,1
Cobolli F.,148,14,5,9,Cilic M.,100,853,543,310,2023-07-24,Umag,Croatia Open,Clay,1.57,2.38,1
Pella G.,199,260,118,142,Monteiro T.,121,171,69,102,2023-07-24,Hamburg,European Open,Clay,2.0,1.8,1
Gasquet R.,48,948,581,367,Altmaier D.,51,79,28,51,2023-07-24,Hamburg,European Open,Clay,2.3,1.62,0
Vukic A.,62,36,15,21,Quinn E.,394,3,1,2,2023-07-24,Atlanta,Atlanta Open,Hard,1.36,3.2,1
Duckworth J.,123,143,55,88,Harris L.,186,129,59,70,2023-07-24,Atlanta,Atlanta Open,Hard,3.0,1.4,0
Michelsen A.,140,7,4,3,Cressy M.,96,96,42,54,2023-07-25,Atlanta,Atlanta Open,Hard,2.0,1.8,0
Ymer E.,186,81,24,57,Musetti L.,18,143,79,64,2023-07-25,Hamburg,European Open,Clay,6.0,1.13,0
Marterer M.,144,91,31,60,Molleker R.,251,15,4,11,2023-07-25,Hamburg,European Open,Clay,1.57,2.38,1
Dellien H.,164,70,22,48,Garin C.,101,190,103,87,2023-07-25,Hamburg,European Open,Clay,3.2,1.36,0
Kokkinakis T.,86,124,55,69,Monfils G.,323,816,510,306,2023-07-25,Atlanta,Atlanta Open,Hard,1.53,2.5,1
Wolf J.J.,45,75,39,36,Jung J.,276,32,10,22,2023-07-25,Atlanta,Atlanta Open,Hard,1.17,5.0,1
Purcell M.,78,28,9,19,Nakashima B.,70,106,57,49,2023-07-25,Atlanta,Atlanta Open,Hard,4.0,1.25,0
Lajovic D.,66,378,163,215,Kecmanovic M.,40,210,107,103,2023-07-25,Hamburg,European Open,Clay,2.2,1.67,1
Thompson J.,71,221,96,125,Nishikori K.,439,617,408,209,2023-07-25,Atlanta,Atlanta Open,Hard,1.8,2.0,0
Piros Z.,124,3,1,2,O Connell C.,74,65,26,39,2023-07-25,Umag,Croatia Open,Clay,2.1,1.73,1
Arnaldi M.,76,18,9,9,De Jong J.,180,3,0,3,2023-07-25,Umag,Croatia Open,Clay,1.44,2.75,1
Lestienne C.,109,40,13,27,Humbert U.,36,170,80,90,2023-07-25,Atlanta,Atlanta Open,Hard,3.0,1.4,0
Kovalik J.,172,68,24,44,Seyboth Wild T.,117,28,12,16,2023-07-25,Hamburg,European Open,Clay,,,1
Wu Y.,90,36,15,21,Moutet C.,80,118,50,68,2023-07-25,Atlanta,Atlanta Open,Hard,1.44,2.75,1
Galan D.E.,76,78,33,45,Fils A.,71,24,15,9,2023-07-25,Hamburg,European Open,Clay,2.63,1.5,0
Davidovich Fokina A.,39,168,84,84,Cachin P.,54,52,23,29,2023-07-25,Hamburg,European Open,Clay,1.5,2.63,1
Zhang Zh.,53,44,20,24,Choinski J.,151,6,1,5,2023-07-25,Hamburg,European Open,Clay,1.53,2.5,1
Hanfmann Y.,50,99,50,49,Cerundolo F.,21,104,58,46,2023-07-25,Hamburg,European Open,Clay,2.63,1.5,1
Koepfer D.,84,86,38,48,Isner J.,114,755,465,290,2023-07-25,Atlanta,Atlanta Open,Hard,2.38,1.57,1
Zverev A.,19,500,346,154,Molcan A.,120,86,45,41,2023-07-25,Hamburg,European Open,Clay,1.14,5.5,1
Prizmic D.,287,5,2,3,Piros Z.,124,3,1,2,2023-07-26,Umag,Croatia Open,Clay,1.8,2.0,1
Van Assche L.,68,20,7,13,Davidovich Fokina A.,39,168,84,84,2023-07-26,Hamburg,European Open,Clay,3.0,1.4,1
Marterer M.,144,91,31,60,Zverev A.,19,500,346,154,2023-07-26,Hamburg,European Open,Clay,8.0,1.08,0
Marozsan F.,87,7,4,3,Cerundolo J.M.,106,29,12,17,2023-07-26,Umag,Croatia Open,Clay,1.57,2.38,1
Munar J.,104,178,75,103,Ramos-Vinolas A.,82,437,204,233,2023-07-26,Umag,Croatia Open,Clay,1.57,2.38,1
Wawrinka S.,72,854,535,319,Misolic F.,158,11,6,5,2023-07-26,Umag,Croatia Open,Clay,1.44,2.75,1
Coria F.,108,99,43,56,Huesler M.A.,88,58,21,37,2023-07-26,Umag,Croatia Open,Clay,1.67,2.2,1
Ofner S.,61,34,16,18,Popyrin A.,90,140,59,81,2023-07-26,Umag,Croatia Open,Clay,1.57,2.38,0
Cobolli F.,148,14,5,9,Arnaldi M.,76,18,9,9,2023-07-26,Umag,Croatia Open,Clay,2.75,1.44,0
Djere L.,38,243,120,123,Pella G.,199,260,118,142,2023-07-26,Hamburg,European Open,Clay,1.36,3.2,1
Baez S.,72,95,47,48,Ruud C.,4,275,176,99,2023-07-26,Hamburg,European Open,Clay,5.0,1.17,0
Cecchinato M.,108,204,79,125,Shevchenko A.,93,20,8,12,2023-07-26,Umag,Croatia Open,Clay,2.63,1.5,1
Zapata Miralles B.,54,80,32,48,Rublev A.,7,392,255,137,2023-07-26,Hamburg,European Open,Clay,6.0,1.13,0
Martin A.,723,258,107,151,Eubanks C.,29,64,28,36,2023-07-26,Atlanta,Atlanta Open,Hard,10.0,1.06,0
Shelton B.,43,34,13,21,Shang J.,149,12,4,8,2023-07-26,Atlanta,Atlanta Open,Hard,1.44,2.75,0
Humbert U.,36,170,80,90,Harris L.,186,129,59,70,2023-07-26,Atlanta,Atlanta Open,Hard,2.2,1.67,1
Nishioka Y.,31,215,99,116,Vukic A.,62,36,15,21,2023-07-26,Atlanta,Atlanta Open,Hard,1.73,2.1,0
Marozsan F.,87,7,4,3,Munar J.,104,178,75,103,2023-07-27,Umag,Croatia Open,Clay,1.91,1.91,0
Wawrinka S.,72,854,535,319,Coria F.,108,99,43,56,2023-07-27,Umag,Croatia Open,Clay,1.5,2.63,1
Thiem D.,116,517,327,190,Lehecka J.,33,61,30,31,2023-07-27,Umag,Croatia Open,Clay,2.0,1.8,0
Daniel T.,111,178,67,111,Carballes Baena R.,64,207,91,116,2023-07-27,Umag,Croatia Open,Clay,2.0,1.8,0
Kokkinakis T.,86,124,55,69,De Minaur A.,19,272,161,111,2023-07-27,Atlanta,Atlanta Open,Hard,3.5,1.3,0
Nakashima B.,70,106,57,49,Eubanks C.,29,64,28,36,2023-07-27,Atlanta,Atlanta Open,Hard,1.8,2.0,0
Evans D.,30,251,124,127,Koepfer D.,84,86,38,48,2023-07-27,Atlanta,Atlanta Open,Hard,1.91,1.91,0
Wolf J.J.,45,75,39,36,Cressy M.,96,96,42,54,2023-07-27,Atlanta,Atlanta Open,Hard,1.57,2.38,1
Sonego L.,43,221,107,114,Cecchinato M.,108,204,79,125,2023-07-27,Umag,Croatia Open,Clay,1.36,3.2,1
Hanfmann Y.,50,99,50,49,Zhang Zh.,53,44,20,24,2023-07-27,Hamburg,European Open,Clay,1.44,2.75,0
Lajovic D.,66,378,163,215,Fils A.,71,24,15,9,2023-07-27,Hamburg,European Open,Clay,2.0,1.8,0
Musetti L.,18,143,79,64,Kovalik J.,172,68,24,44,2023-07-27,Hamburg,European Open,Clay,1.1,7.0,1
Garin C.,101,190,103,87,Ruud C.,4,275,176,99,2023-07-27,Hamburg,European Open,Clay,4.33,1.22,0
Altmaier D.,51,79,28,51,Rublev A.,7,392,255,137,2023-07-27,Hamburg,European Open,Clay,4.0,1.25,1
Prizmic D.,287,5,2,3,Popyrin A.,90,140,59,81,2023-07-28,Umag,Croatia Open,Clay,2.0,1.8,0
Lehecka J.,33,61,30,31,Arnaldi M.,76,18,9,9,2023-07-28,Umag,Croatia Open,Clay,1.67,2.2,0
Sonego L.,43,221,107,114,Munar J.,104,178,75,103,2023-07-28,Umag,Croatia Open,Clay,1.8,2.0,1
Musetti L.,18,143,79,64,Djere L.,38,243,120,123,2023-07-28,Hamburg,European Open,Clay,1.5,2.63,0
Zhang Zh.,53,44,20,24,Altmaier D.,51,79,28,51,2023-07-28,Hamburg,European Open,Clay,2.75,1.44,1
Carballes Baena R.,64,207,91,116,Wawrinka S.,72,854,535,319,2023-07-28,Umag,Croatia Open,Clay,2.75,1.44,0
Fils A.,71,24,15,9,Ruud C.,4,275,176,99,2023-07-28,Hamburg,European Open,Clay,4.0,1.25,1
Fritz T.,9,356,205,151,Wu Y.,90,36,15,21,2023-07-28,Atlanta,Atlanta Open,Hard,1.3,3.5,1
Shang J.,149,12,4,8,Nishikori K.,439,617,408,209,2023-07-28,Atlanta,Atlanta Open,Hard,2.5,1.53,0
Wolf J.J.,45,75,39,36,Koepfer D.,84,86,38,48,2023-07-28,Atlanta,Atlanta Open,Hard,1.44,2.75,1
Fritz T.,9,356,205,151,Nishikori K.,439,617,408,209,2023-07-28,Atlanta,Atlanta Open,Hard,1.36,3.2,1
Zverev A.,19,500,346,154,Van Assche L.,68,20,7,13,2023-07-28,Hamburg,European Open,Clay,1.17,5.0,1
Djere L.,38,243,120,123,Zhang Zh.,53,44,20,24,2023-07-29,Hamburg,European Open,Clay,1.53,2.5,1
Fils A.,71,24,15,9,Zverev A.,19,500,346,154,2023-07-29,Hamburg,European Open,Clay,3.5,1.3,0
Wolf J.J.,45,75,39,36,Fritz T.,9,356,205,151,2023-07-29,Atlanta,Atlanta Open,Hard,3.2,1.36,0
Wawrinka S.,72,854,535,319,Sonego L.,43,221,107,114,2023-07-29,Umag,Croatia Open,Clay,1.8,2.0,1
Arnaldi M.,76,18,9,9,Popyrin A.,90,140,59,81,2023-07-29,Umag,Croatia Open,Clay,1.62,2.3,0
Eubanks C.,29,64,28,36,Vukic A.,62,36,15,21,2023-07-29,Atlanta,Atlanta Open,Hard,1.53,2.5,0
Humbert U.,36,170,80,90,De Minaur A.,19,272,161,111,2023-07-29,Atlanta,Atlanta Open,Hard,3.2,1.36,1
Zverev A.,19,500,346,154,Djere L.,38,243,120,123,2023-07-30,Hamburg,European Open,Clay,1.22,4.33,1
Wawrinka S.,72,854,535,319,Popyrin A.,90,140,59,81,2023-07-30,Umag,Croatia Open,Clay,1.44,2.75,0
Vukic A.,62,36,15,21,Humbert U.,36,170,80,90,2023-07-30,Atlanta,Atlanta Open,Hard,2.63,1.5,1
Fritz T.,9,356,205,151,Vukic A.,62,36,15,21,2023-07-30,Atlanta,Atlanta Open,Hard,1.17,5.0,1
Van Assche L.,68,20,7,13,Molcan A.,120,86,45,41,2023-07-31,Kitzbuhel,Generali Open,Clay,1.73,2.1,0
Schwartzman D.,95,428,233,195,Mcdonald M.,60,190,87,103,2023-07-31,Washington,Citi Open,Hard,2.5,1.53,0
Moutet C.,80,118,50,68,Broady L.,125,47,18,29,2023-07-31,Washington,Citi Open,Hard,2.0,1.8,0
Karatsev A.,75,136,66,70,Pannu K.,717,2,0,2,2023-07-31,Washington,Citi Open,Hard,1.07,9.0,1
Mmoh M.,112,55,20,35,Klahn B.,797,56,13,43,2023-07-31,Washington,Citi Open,Hard,1.3,3.5,1
Watanuki Y.,99,25,11,14,Wu Y.,90,36,15,21,2023-07-31,Washington,Citi Open,Hard,2.3,1.62,1
Shevchenko A.,93,20,8,12,Cressy M.,96,96,42,54,2023-07-31,Washington,Citi Open,Hard,2.75,1.44,1
Albot R.,97,215,86,129,Giron M.,69,150,68,82,2023-07-31,Washington,Citi Open,Hard,3.2,1.36,1
Lestienne C.,109,40,13,27,Ruusuvuori E.,55,158,79,79,2023-07-31,Washington,Citi Open,Hard,3.2,1.36,0
Carballes Baena R.,64,207,91,116,Pella G.,199,260,118,142,2023-07-31,Kitzbuhel,Generali Open,Clay,1.8,2.0,1
Medjedovic H.,147,11,3,8,Baez S.,72,95,47,48,2023-07-31,Kitzbuhel,Generali Open,Clay,2.2,1.67,0
Andreozzi G.,240,39,12,27,Misolic F.,158,11,6,5,2023-07-31,Kitzbuhel,Generali Open,Clay,2.38,1.57,1
Varillas J.P.,77,22,10,12,Ramos-Vinolas A.,82,437,204,233,2023-07-31,Kitzbuhel,Generali Open,Clay,1.8,2.0,0
Cecchinato M.,108,204,79,125,Galan D.E.,76,78,33,45,2023-07-31,Kitzbuhel,Generali Open,Clay,2.3,1.62,0
Gomez E.,155,26,7,19,Shang J.,149,12,4,8,2023-07-31,Washington,Citi Open,Hard,4.0,1.25,0
Barrere G.,59,79,31,48,Mochizuki S.,200,8,0,8,2023-07-31,Washington,Citi Open,Hard,1.44,2.75,1
Kovacevic A.,129,14,6,8,Kumar O.,403,1,0,1,2023-08-01,Los Cabos,Los Cabos Open,Hard,1.22,4.33,1
Daniel T.,111,178,67,111,Kokkinakis T.,86,124,55,69,2023-08-01,Washington,Citi Open,Hard,2.38,1.57,0
Ruusuvuori E.,55,158,79,79,Nishioka Y.,31,215,99,116,2023-08-01,Washington,Citi Open,Hard,1.44,2.75,1
Tirante T.A.,136,5,2,3,Lama G.,410,4,0,4,2023-08-01,Los Cabos,Los Cabos Open,Hard,1.17,5.0,1
Svajda Z.,233,8,2,6,Purcell M.,78,28,9,19,2023-08-01,Washington,Citi Open,Hard,2.0,1.8,1
Nakashima B.,70,106,57,49,Vukic A.,62,36,15,21,2023-08-01,Washington,Citi Open,Hard,1.4,3.0,1
Anderson K.,652,598,347,251,Thompson J.,71,221,96,125,2023-08-01,Washington,Citi Open,Hard,2.63,1.5,0
Shelton B.,43,34,13,21,Shang J.,149,12,4,8,2023-08-01,Washington,Citi Open,Hard,1.67,2.2,0
Dimitrov G.,20,651,389,262,Mcdonald M.,60,190,87,103,2023-08-01,Washington,Citi Open,Hard,1.5,2.63,1
Mmoh M.,112,55,20,35,Hurkacz H.,17,238,137,101,2023-08-01,Washington,Citi Open,Hard,4.5,1.2,1
Monfils G.,323,816,510,306,Fratangelo B.,695,62,22,40,2023-08-01,Washington,Citi Open,Hard,1.3,3.5,1
Harris L.,186,129,59,70,Shimabukuro S.,161,4,1,3,2023-08-01,Washington,Citi Open,Hard,1.29,3.75,0
Hijikata R.,110,16,7,9,Isner J.,114,755,465,290,2023-08-01,Los Cabos,Los Cabos Open,Hard,2.63,1.5,0
Meligeni Alves F.,177,3,1,2,Tabilo A.,122,44,21,23,2023-08-01,Los Cabos,Los Cabos Open,Hard,3.2,1.36,1
Brouwer G.,144,21,11,10,Diallo G.,140,3,0,3,2023-08-01,Los Cabos,Los Cabos Open,Hard,2.0,1.8,1
Zhang Zh.,53,44,20,24,Lajovic D.,66,378,163,215,2023-08-01,Kitzbuhel,Generali Open,Clay,1.8,2.0,1
Bagnis F.,135,121,39,82,Thiem D.,116,517,327,190,2023-08-01,Kitzbuhel,Generali Open,Clay,3.5,1.3,0
Cerundolo J.M.,106,29,12,17,Rinderknech A.,67,96,46,50,2023-08-01,Kitzbuhel,Generali Open,Clay,2.38,1.57,0
Novak D.,166,58,15,43,Seyboth Wild T.,117,28,12,16,2023-08-01,Kitzbuhel,Generali Open,Clay,2.38,1.57,0
Altmaier D.,51,79,28,51,Huesler M.A.,88,58,21,37,2023-08-01,Kitzbuhel,Generali Open,Clay,1.33,3.4,1
O Connell C.,74,65,26,39,Djere L.,38,243,120,123,2023-08-01,Kitzbuhel,Generali Open,Clay,2.75,1.44,0
Albot R.,97,215,86,129,Wolf J.J.,45,75,39,36,2023-08-02,Washington,Citi Open,Hard,3.5,1.3,0
Seyboth Wild T.,117,28,12,16,Djere L.,38,243,120,123,2023-08-02,Kitzbuhel,Generali Open,Clay,2.3,1.62,0
Ramos-Vinolas A.,82,437,204,233,Cachin P.,54,52,23,29,2023-08-02,Kitzbuhel,Generali Open,Clay,2.2,1.67,0
Altmaier D.,51,79,28,51,Galan D.E.,76,78,33,45,2023-08-02,Kitzbuhel,Generali Open,Clay,1.5,2.63,0
Griekspoor T.,37,97,47,50,Broady L.,125,47,18,29,2023-08-02,Washington,Citi Open,Hard,1.57,2.38,1
Andreozzi G.,240,39,12,27,Etcheverry T.,34,60,26,34,2023-08-02,Kitzbuhel,Generali Open,Clay,3.2,1.36,0
Carballes Baena R.,64,207,91,116,Baez S.,72,95,47,48,2023-08-02,Kitzbuhel,Generali Open,Clay,2.38,1.57,0
Humbert U.,36,170,80,90,Kokkinakis T.,86,124,55,69,2023-08-02,Washington,Citi Open,Hard,1.53,2.5,1
Nakashima B.,70,106,57,49,Murray A.,44,932,687,245,2023-08-02,Washington,Citi Open,Hard,1.73,2.1,0
Barrere G.,59,79,31,48,Evans D.,30,251,124,127,2023-08-02,Washington,Citi Open,Hard,2.0,1.8,0
Mannarino A.,27,567,264,303,Thompson J.,71,221,96,125,2023-08-02,Washington,Citi Open,Hard,2.0,1.8,0
Rinderknech A.,67,96,46,50,Hanfmann Y.,50,99,50,49,2023-08-02,Kitzbuhel,Generali Open,Clay,2.3,1.62,1
Eubanks C.,29,64,28,36,Shimabukuro S.,161,4,1,3,2023-08-02,Washington,Citi Open,Hard,1.3,3.5,1
Tiafoe F.,10,303,158,145,Karatsev A.,75,136,66,70,2023-08-02,Washington,Citi Open,Hard,1.3,3.5,1
Korda S.,26,126,75,51,Shevchenko A.,93,20,8,12,2023-08-02,Washington,Citi Open,Hard,1.2,4.5,0
Watanuki Y.,99,25,11,14,Auger-Aliassime F.,12,268,163,105,2023-08-02,Washington,Citi Open,Hard,2.38,1.57,1
Zhang Zh.,53,44,20,24,Thiem D.,116,517,327,190,2023-08-02,Kitzbuhel,Generali Open,Clay,2.0,1.8,0
Ofner S.,61,34,16,18,Molcan A.,120,86,45,41,2023-08-02,Kitzbuhel,Generali Open,Clay,1.73,2.1,0
Pacheco Mendez R.,817,3,0,3,Jarry N.,28,141,73,68,2023-08-02,Los Cabos,Los Cabos Open,Hard,11.0,1.05,0
Koepfer D.,84,86,38,48,Barrios M.,121,10,3,7,2023-08-02,Los Cabos,Los Cabos Open,Hard,1.4,3.0,1
Escobedo E.,377,57,20,37,Jung J.,276,32,10,22,2023-08-02,Los Cabos,Los Cabos Open,Hard,1.8,2.0,0
Mansouri S.,296,1,0,1,De Minaur A.,19,272,161,111,2023-08-02,Los Cabos,Los Cabos Open,Hard,11.0,1.05,0
Virtanen O.,127,2,0,2,Duckworth J.,123,143,55,88,2023-08-02,Los Cabos,Los Cabos Open,Hard,2.2,1.67,0
Ivashka I.,113,159,78,81,Zhukayev B.,258,2,0,2,2023-08-02,Los Cabos,Los Cabos Open,Hard,1.25,4.0,1
Garin C.,101,190,103,87,Gojo B.,115,14,3,11,2023-08-02,Los Cabos,Los Cabos Open,Hard,1.67,2.2,0
Watanuki Y.,99,25,11,14,Humbert U.,36,170,80,90,2023-08-03,Washington,Citi Open,Hard,2.75,1.44,0
Mmoh M.,112,55,20,35,Wolf J.J.,45,75,39,36,2023-08-03,Washington,Citi Open,Hard,3.4,1.33,0
Ruusuvuori E.,55,158,79,79,Dimitrov G.,20,651,389,262,2023-08-03,Washington,Citi Open,Hard,3.0,1.4,0
Fritz T.,9,356,205,151,Svajda Z.,233,8,2,6,2023-08-03,Washington,Citi Open,Hard,1.08,8.0,1
Monfils G.,323,816,510,306,Bublik A.,25,219,110,109,2023-08-03,Washington,Citi Open,Hard,2.3,1.62,1
Koepfer D.,84,86,38,48,Duckworth J.,123,143,55,88,2023-08-03,Los Cabos,Los Cabos Open,Hard,1.57,2.38,1
Tirante T.A.,136,5,2,3,De Minaur A.,19,272,161,111,2023-08-03,Los Cabos,Los Cabos Open,Hard,8.0,1.08,0
Meligeni Alves F.,177,3,1,2,Paul T.,14,204,111,93,2023-08-03,Los Cabos,Los Cabos Open,Hard,6.5,1.11,0
Thiem D.,116,517,327,190,Rinderknech A.,67,96,46,50,2023-08-03,Kitzbuhel,Generali Open,Clay,1.73,2.1,1
Ivashka I.,113,159,78,81,Gojo B.,115,14,3,11,2023-08-03,Los Cabos,Los Cabos Open,Hard,2.1,1.73,1
Brouwer G.,144,21,11,10,Jarry N.,28,141,73,68,2023-08-03,Los Cabos,Los Cabos Open,Hard,3.75,1.29,0
Kovacevic A.,129,14,6,8,Norrie C.,13,287,172,115,2023-08-03,Los Cabos,Los Cabos Open,Hard,4.0,1.25,1
Isner J.,114,755,465,290,Tsitsipas S.,5,390,264,126,2023-08-03,Los Cabos,Los Cabos Open,Hard,4.0,1.25,0
Djere L.,38,243,120,123,Cachin P.,54,52,23,29,2023-08-03,Kitzbuhel,Generali Open,Clay,1.8,2.0,1
Etcheverry T.,34,60,26,34,Galan D.E.,76,78,33,45,2023-08-03,Kitzbuhel,Generali Open,Clay,1.36,3.2,1
Molcan A.,120,86,45,41,Baez S.,72,95,47,48,2023-08-03,Kitzbuhel,Generali Open,Clay,2.75,1.44,0
Coric B.,15,343,185,158,Jung J.,276,32,10,22,2023-08-03,Los Cabos,Los Cabos Open,Hard,1.14,5.5,1
Eubanks C.,29,64,28,36,Thompson J.,71,221,96,125,2023-08-04,Washington,Citi Open,Hard,2.0,1.8,0
Shevchenko A.,93,20,8,12,Evans D.,30,251,124,127,2023-08-04,Washington,Citi Open,Hard,2.38,1.57,0
Shang J.,149,12,4,8,Tiafoe F.,10,303,158,145,2023-08-04,Washington,Citi Open,Hard,4.33,1.22,0
Humbert U.,36,170,80,90,Dimitrov G.,20,651,389,262,2023-08-04,Washington,Citi Open,Hard,2.75,1.44,0
Monfils G.,323,816,510,306,Griekspoor T.,37,97,47,50,2023-08-04,Washington,Citi Open,Hard,2.1,1.73,0
Coric B.,15,343,185,158,Ivashka I.,113,159,78,81,2023-08-04,Los Cabos,Los Cabos Open,Hard,1.33,3.4,1
Tsitsipas S.,5,390,264,126,Jarry N.,28,141,73,68,2023-08-04,Los Cabos,Los Cabos Open,Hard,1.3,3.5,1
Paul T.,14,204,111,93,De Minaur A.,19,272,161,111,2023-08-04,Los Cabos,Los Cabos Open,Hard,2.2,1.67,0
Etcheverry T.,34,60,26,34,Baez S.,72,95,47,48,2023-08-04,Kitzbuhel,Generali Open,Clay,1.91,1.91,0
Koepfer D.,84,86,38,48,Kovacevic A.,129,14,6,8,2023-08-04,Los Cabos,Los Cabos Open,Hard,1.44,2.75,1
Griekspoor T.,37,97,47,50,Wolf J.J.,45,75,39,36,2023-08-04,Washington,Citi Open,Hard,2.2,1.67,1
Djere L.,38,243,120,123,Thiem D.,116,517,327,190,2023-08-04,Kitzbuhel,Generali Open,Clay,1.62,2.3,0
Fritz T.,9,356,205,151,Murray A.,44,932,687,245,2023-08-04,Washington,Citi Open,Hard,1.36,3.2,1
Coric B.,15,343,185,158,Tsitsipas S.,5,390,264,126,2023-08-05,Los Cabos,Los Cabos Open,Hard,3.0,1.4,0
Thiem D.,116,517,327,190,Baez S.,72,95,47,48,2023-08-05,Kitzbuhel,Generali Open,Clay,2.0,1.8,0
Koepfer D.,84,86,38,48,De Minaur A.,19,272,161,111,2023-08-05,Los Cabos,Los Cabos Open,Hard,4.0,1.25,0
Thompson J.,71,221,96,125,Fritz T.,9,356,205,151,2023-08-05,Washington,Citi Open,Hard,2.75,1.44,0
Evans D.,30,251,124,127,Tiafoe F.,10,303,158,145,2023-08-05,Washington,Citi Open,Hard,3.75,1.29,1
Griekspoor T.,37,97,47,50,Fritz T.,9,356,205,151,2023-08-06,Washington,Citi Open,Hard,3.5,1.3,1
De Minaur A.,19,272,161,111,Tsitsipas S.,5,390,264,126,2023-08-06,Los Cabos,Los Cabos Open,Hard,3.2,1.36,0
Evans D.,30,251,124,127,Dimitrov G.,20,651,389,262,2023-08-06,Washington,Citi Open,Hard,3.2,1.36,1
Evans D.,30,251,124,127,Griekspoor T.,37,97,47,50,2023-08-06,Washington,Citi Open,Hard,2.0,1.8,1
